阿巴斯革命	aa[ek ba[ku si[qj ge[nk mk[rh
阿巴斯派	aa[ek ba[ku si[qj pd[dp
阿巴斯全集	aa[ek ba[ku si[qj qr[rw ji[va
阿巴斯王朝	aa[ek ba[ku si[qj wh[su ic[uo
阿拔斯王朝	aa[ek ba[fu si[qj wh[su ic[uo
阿布達爾	aa[ek bu[uj da[dz er[dx
阿布代思	aa[ek bu[uj dd[rq si[tx
阿卜代斯臺	aa[ek bu[ud dd[rq si[qj td[sk
阿布德斯	aa[ek bu[uj de[ru si[qj
阿布杜拉	aa[ek bu[uj du[at la[fl
阿布費達史	aa[ek bu[uj fw[fb da[dz ui[ki
阿布拉爾	aa[ek bu[uj la[fl er[dx
阿布穆斯林派	aa[ek bu[uj mu[hb si[qj lb[aa pd[dp
阿迪納清真寺	aa[ek di[yz na[sk qk[df vf[uj si[tc
阿甸園	aa[ek dm[bt yr[we
阿爾巴特會晤	aa[ek er[dx ba[ku te[nt hv[re wu[ow
阿爾卡賴	aa[ek er[dx ka[ub ld[hd
阿爾卡利	aa[ek er[dx ka[ub li[hd
阿爾馬米	aa[ek er[dx ma[vv mi[ba
阿而實	aa[ek er[ek ui[gd
阿夫塔赫派	aa[ek fu[er ta[tc he[tt pd[dp
阿格拉布王朝	aa[ek ge[aw la[fl bu[uj wh[su ic[uo
阿格勒	aa[ek ge[aw le[gl
阿海勒主麻	aa[ek hd[dr le[gl vu[dw ma[ga
阿赫巴爾學派	aa[ek he[tt ba[ku er[dx xt[xz pd[dp
阿赫裡哈克派	aa[ek he[tt li[ot ha[kr ke[ge pd[dp
阿赫默德	aa[ek he[tt mo[hq de[ru
阿赫默德教團	aa[ek he[tt mo[hq de[ru jn[tw tr[wc
阿赫默德派	aa[ek he[tt mo[hq de[ru pd[dp
阿赫亞爾	aa[ek he[tt ya[hy er[dx
阿黑來提	aa[ek hw[sd ld[hm ti[fo
阿吉拉	aa[ek ji[uk la[fl
阿克巴誓約	aa[ek ke[ge ba[ku ui[fy yt[sb
阿克科雍魯	aa[ek ke[ge ke[hd ys[ws lu[yo
阿克薩清真寺	aa[ek ke[ge sa[ce qk[df vf[uj si[tc
阿拉伯書法	aa[ek la[fl bo[rb uu[vv fa[dt
阿拉伯字母	aa[ek la[fl bo[rb zi[gz mu[vv
阿拉姆陵墓	aa[ek la[fl mu[nm lk[et mu[ct
阿拉穆特教義	aa[ek la[fl mu[hb te[nt jn[tw yi[di
阿拉維派	aa[ek la[fl ww[sv pd[dp
阿勒法	aa[ek le[gl fa[dt
阿里迦運動	aa[ek li[ot jx[lz yy[ez ds[el
阿里劍	aa[ek li[ot jm[rd
阿里葉	aa[ek li[ot ye[ku
阿里伊拉希派	aa[ek li[ot yi[rx la[fl xi[iu pd[dp
阿林	aa[ek lb[aa
阿魯法	aa[ek lu[yo fa[dt
阿邁勒運動	aa[ek md[wz le[gl yy[ez ds[el
阿米乃	aa[ek mi[ba nd[vp
阿帕克和卓傳	aa[ek pa[jb ke[ge he[hk vo[bo ir[re
阿皮孜	aa[ek pi[vp zi[zw
阿薩辛派	aa[ek sa[ce xb[lu pd[dp
阿舒拉	aa[ek uu[ry la[fl
阿術拉	aa[ek uu[ad la[fl
阿術拉節	aa[ek uu[ad la[fl jp[ce
阿刷	aa[ek ux[ud
阿斯基亞王朝	aa[ek si[qj ji[qt ya[hy wh[su ic[uo
阿西葉	aa[ek xi[hk ye[ku
阿亞圖拉	aa[ek ya[hy tu[ww la[fl
阿耶哈	aa[ek ye[ee ha[kr
阿宜臺	aa[ek yi[gq td[sk
阿尤布王朝	aa[ek yz[yd bu[uj wh[su ic[uo
阿宰爾	aa[ek zd[gl er[dx
阿札德	aa[ek va[av de[ru
阿札里加派	aa[ek va[av li[ot jx[lk pd[dp
阿茲拉伊來	aa[ek zi[by la[fl yi[rx ld[hm
艾巴德派	ai[ci ba[ku de[ru pd[dp
艾布拜克爾	ai[ci bu[uj bd[fh ke[ge er[dx
艾布伯舍爾	ai[ci bu[uj bo[rb ue[rg er[dx
哀哈格夫	ai[wk ha[kr ge[aw fu[er
艾哈戛弗	ai[ci ha[kr jx[eg fu[gp
艾哈默德	ai[ci ha[kr mo[hq de[ru
艾哈札布	ai[ci ha[kr va[av bu[uj
艾海勒齊麥	ai[ci hd[dr le[gl qi[wp md[fw
艾海里遜乃	ai[ci hd[dr li[ot xy[zz nd[vp
艾赫	ai[ci he[tt
埃及繼承法	ai[ts ji[pv ji[sm ig[lu fa[dt
埃及九年	ai[ts ji[pv jq[pv nm[rn
埃及民法典	ai[ts ji[pv mb[kv fa[dt dm[kb
埃及瓦剋夫法	ai[ts ji[pv wa[hv ke[ge fu[er fa[dt
埃及烏瑪黨	ai[ts ji[pv wu[bv ma[wm dh[xk
哀凱	ai[wk kd[uj
艾勒葉賽爾	ai[ci le[gl ye[ku sd[gb er[dx
艾裡畢之書	ai[ci li[ot bi[bu vi[dv uu[vv
埃米爾穆民	ai[ts mi[ba er[dx mu[hb mb[kv
哀歐足	ai[wk ou[kd zu[kv
愛群道清真寺	ai[au qy[xy dc[bz qk[df vf[uj si[tc
艾什爾裡派	ai[ci uf[ru er[dx li[ot pd[dp
哀詩吟唱師	ai[wk ui[yt yb[kr ih[ko ui[uh
艾思裡	ai[ci si[tx li[ot
艾依提卡	ai[ci yi[ry ti[fo ka[ub
艾則孜木麻札	ai[ci ze[bd zi[zw mu[ub ma[ga va[av
愛資哈爾長老	ai[au zi[db ha[kr er[dx vh[ph lc[tb
艾茲賴格派	ai[ci zi[by ld[hd ge[aw pd[dp
安集延起義	an[gn ji[va yj[pj qi[zk yi[di
安康清真古寺	an[gn kh[gx qk[df vf[uj gu[uk si[tc
安拉	an[gn la[fl
按拉胡	an[fg la[fl hu[go
安拉至大	an[gn la[fl vi[ht da[hr
安拉之劍	an[gn la[fl vi[dv jm[rd
安拉至知	an[gn la[fl vi[ht vi[uk
安薩爾	an[gn sa[ce er[dx
安優卜	an[gn yz[ry bu[ud
凹壁	ao[uv bi[ut
奧格巴清真寺	ao[pd ge[aw ba[ku qk[df vf[uj si[tc
奧斯曼民法典	ao[pd si[qj mj[os mb[kv fa[dt dm[kb
奧斯曼商法典	ao[pd si[qj mj[os uh[lk fa[dt dm[kb
奧斯曼刑法典	ao[pd si[qj mj[os xk[kd fa[dt dm[kb
奧塔德	ao[pd ta[tc de[ru
奧札儀學派	ao[pd va[av yi[rd xt[xz pd[dp
巴貝克起義	ba[ku bw[kr ke[ge qi[zk yi[di
巴布教派	ba[ku bu[uj jn[tw pd[dp
巴布派運動	ba[ku bu[uj pd[dp yy[ez ds[el
巴達維教團	ba[ku da[dz ww[sv jn[tw tr[wc
巴達維清真寺	ba[ku da[dz ww[sv qk[df vf[uj si[tc
巴德利運動	ba[ku de[ru li[hd yy[ez ds[el
巴爾阿米史	ba[ku er[dx aa[ek mi[ba ui[ki
巴爾庫克派	ba[ku er[dx ku[gi ke[ge pd[dp
巴哈教派	ba[ku ha[kr jn[tw pd[dp
巴赫曼王朝	ba[ku he[tt mj[os wh[su ic[uo
巴基亞安拉	ba[ku ji[qt ya[hy an[gn la[fl
巴克利教團	ba[ku ke[ge li[hd jn[tw tr[wc
巴拉韋法特	ba[ku la[fl ww[hh fa[dt te[nt
巴雷利學派	ba[ku lw[yt li[hd xt[xz pd[dp
八品天堂	ba[pd pb[kk tm[hd th[xt
巴士拉清真寺	ba[ku ui[uh la[fl qk[df vf[uj si[tc
巴頹尼葉派	ba[ku tv[hy ni[ub ye[ku pd[dp
巴希爾派	ba[ku xi[iu er[dx pd[dp
巴彥派	ba[ku yj[lp pd[dp
巴伊賴姆	ba[ku yi[rx ld[hd mu[nm
把齋	ba[fb vd[we
白德爾之戰	bd[po de[ru er[dx vi[dv vj[bg
白爾蒂黨	bd[po er[dx di[cl dh[xk
白耳利	bd[po er[hu li[hd
拜而思	bd[fh er[ek si[tx
拜功	bd[fh gs[gl
拜哈格史	bd[fh ha[kr ge[aw ui[ki
白拉姆教團	bd[po la[fl mu[nm jn[tw tr[wc
白拉提夜	bd[po la[fl ti[fo ye[wr
百雷凱提	bd[eo lw[yt kd[[ ti[fo
白倆	bd[po lx[rh
白山派	bd[po uj[uk pd[dp
拜吐拉大寺	bd[fh tu[kt la[fl da[hr si[tc
拜星教徒	bd[fh xk[op jn[tw tu[rz
白衣大食	bd[po yi[wy da[hr ui[rl
白益王朝	bd[po yi[bm wh[su ic[uo
白優姆教團	bd[po yz[ry mu[nm jn[tw tr[wc
搬阿訇	bj[fv aa[ek hs[by
板得	bj[ap de[ro
板橋道堂	bj[ap qn[ap dc[bz th[xt
板橋門宦	bj[ap qn[ap mf[du hr[gk
保定清真西寺	bc[rk dk[gp qk[df vf[uj xi[hk si[tc
保護民	bc[rk hu[fh mb[kv
保留休妻	bc[rk lq[pt xq[ra qi[hn
寶命真經	bc[gw mk[rh vf[uj jk[ss
包頭清真大寺	bc[bk tz[dd qk[df vf[uj da[hr si[tc
北山門宦	bw[ub uj[uk mf[du hr[gk
北塢清真寺	bw[ub wu[tw qk[df vf[uj si[tc
北莊門宦	bw[ub vl[gt mf[du hr[gk
本體一元論	bf[ah ti[ra yi[hh yr[ee ly[yr
本質之園	bf[ah vi[pu vi[dv yr[we
比達阿	bi[bb da[dz aa[ek
畢家場門宦	bi[bu jx[gu ih[tv mf[du hr[gk
比克塔西教團	bi[bb ke[ge ta[tc xi[hk jn[tw tr[wc
比勒基斯	bi[bb le[gl ji[qt si[qj
比論	bi[bb ly[yr
比一士	bi[bb yi[hh ui[uh
表義學派	bn[fy yi[di xt[xz pd[dp
別哈里	bp[kd ha[kr li[ot
別瑪爾	bp[kd ma[wm er[dx
別字經	bp[kd zi[gz jk[ss
殯禮	bb[hg li[uv
波哈拉派	bo[dp ha[kr la[fl pd[dp
波斯體	bo[dp si[qj ti[ra
泊頭市清真寺	bo[db tz[dd ui[wj qk[df vf[uj si[tc
駁自然主義者	bo[mi zi[pm rj[xd vu[dw yi[di ve[to
布哈拉汗國	bu[uj ha[kr la[fl hj[dg go[ww
不可分割財產	bu[eu ke[dk ff[bd ge[gd cd[bc ij[lp
卜拉格	bu[ud la[fl ge[aw
晡禮	bu[of li[uv
不謬性	bu[eu mq[yx xk[xp
布維	bu[uj ww[sv
布維希王朝	bu[uj ww[sv xi[iu wh[su ic[uo
不信表徵者	bu[eu xb[ry bn[fy vg[rh ve[to
布牙麻札	bu[uj ya[hv ma[ga va[av
財產監護	cd[bc ij[lp jm[um hu[fh
裁決派	cd[ty jt[dv pd[dp
查魯特	ia[ao lu[yo te[nt
纏回	ij[sg hv[wk
懺悔者運動	ij[xq hv[xr ve[to yy[ez ds[el
昌吉本地寺	ih[oo ji[uk bf[ah di[ty si[tc
常惺性	ih[xk xk[xo xk[xp
長治清真大寺	ih[ph vi[ds qk[df vf[uj da[hr si[tc
常州清真寺	ih[xk vz[dp qk[df vf[uj si[tc
超乘	ic[zd ig[qb
朝功	ic[uo gs[gl
朝覲	ic[uo jb[nj
朝覲途記	ic[uo jb[nj tu[rz ji[yk
朝堂	ic[uo th[xt
晨禮	if[oi li[uv
成丁禮	ig[wv dk[hu li[uv
成吉思汗傳	ig[wv ji[uk si[tx hj[dg ir[re
重建懷聖寺記	is[ph jm[yj hk[xb ug[yt si[tc ji[yk
重修清淨寺記	is[ph xq[ru qk[df jk[dd si[tc ji[yk
崇真派	is[ug vf[uj pd[dp
楚拉斯史	iu[ap la[fl si[qj ui[ki
出散	iu[ck sj[gw
傳教師	ir[re jn[tw ui[uh
傳述世系	ir[re uu[az ui[nv xi[py
傳述線索	ir[re uu[az xm[sj so[uy
傳統學科	ir[re ts[sw xt[xz ke[hd
傳統主義註釋	ir[re ts[sw vu[dw yi[di vu[dd ui[py
穿頭	ir[xy tz[dd
傳聞註釋	ir[re wf[me vu[dd ui[py
傳賢制	ir[re xm[ub vi[nd
純凱桑派	iy[st kd[uj sh[ya pd[dp
純穆爾吉亞派	iy[st mu[hb er[dx ji[uk ya[hy pd[dp
辭朝	ci[ql ic[uo
刺馬丹墓碑	ci[cd ma[vv dj[kw mu[ct bw[eb
存在單一論	cy[uz zd[ut dj[bo yi[hh ly[yr
存在論	cy[uz zd[ut ly[yr
錯拜	co[jg bd[fh
大阿亞圖拉	da[hr aa[ek ya[hy tu[ww la[fl
達爾阿赫德	da[dz er[dx aa[ek he[tt de[ru
達爾哈爾白	da[dz er[dx ha[kr er[dx bd[po
達爾卡維教團	da[dz er[dx ka[ub ww[sv jn[tw tr[wc
達爾蘇勒赫	da[dz er[dx su[cl le[gl he[tt
達爾伊斯蘭	da[dz er[dx yi[rx si[qj lj[bs
大拱北門宦	da[hr gs[fg bw[ub mf[du hr[gk
大拱北清規	da[hr gs[fg bw[ub qk[df gv[ej
達哈佈教團	da[dz ha[kr bu[uj jn[tw tr[wc
大和卓傳	da[hr he[hk vo[bo ir[re
達加勒	da[dz jx[lk le[gl
大教長	da[hr jn[tw ih[ph
怛羅斯戰役	da[xo lo[sx si[qj vj[bg yi[rj
大毛拉	da[hr mc[sv la[fl
大能主	da[hr ng[sb vu[dw
大歐特	da[hr ou[kd te[nt
大赦之夜	da[hr ue[tw vi[dv ye[wr
大食法	da[hr ui[rl fa[dt
大食教度	da[hr ui[rl jn[tw du[gn
答失蠻	da[vr ui[pe mj[yi
大食遣使通唐	da[hr ui[rl qm[vz ui[rh ts[sz th[gx
大同清真大寺	da[hr ts[kh qk[df vf[uj da[hr si[tc
達伍德	da[dz wu[rw de[ru
達伍德派	da[dz wu[rw de[ru pd[dp
大西海里排	da[hr xi[hk hd[dr li[ot pd[ff
大象之家判例	da[hr xl[dk vi[dv jx[gu pj[bd li[rh
達伊	da[dz yi[rx
大隱遁	da[hr yb[ed dy[pz
大傳教師	da[hr vr[re jn[tw ui[uh
待婚期	dd[rt hy[nu qi[qo
代淨	dd[rq jk[dd
代思塔雷	dd[rq si[tx ta[tc lw[yt
代言者	dd[rq yj[we ve[to
擔保契約	dj[fo bc[rk qi[fd yt[sb
單傳聖訓	dj[bo ir[re ug[yt xy[yi
單一教坊制	dj[bo yi[hh jn[tw fh[tf vi[nd
道乘	dc[bz ig[qb
刀兒師傅	dc[vp er[pv ui[uh fu[rf
道行究竟	dc[bz hg[rh jq[xj jk[lo
悼念堂	dc[xb nm[rx th[xt
道堂	dc[bz th[xt
德爾維希	de[ru er[dx ww[sv xi[iu
德加維教團	de[ru jx[lk ww[sv jn[tw tr[wc
德里大清真寺	de[ru li[ot da[hr qk[df vf[uj si[tc
德里蘇丹國	de[ru li[ot su[cl dj[kw go[ww
德魯茲派	de[ru lu[yo zi[by pd[dp
德歐班德運動	de[ru ou[kd bj[wd de[ru yy[ez ds[el
德性學	de[ru xk[xp xt[xz
德性之美名	de[ru xk[xp vi[dv mw[bw mk[xk
登霄	dg[dd xn[yx
登霄節	dg[dd xn[yx jp[ce
第巴爾之戰	di[vg ba[ku er[dx vi[dv vj[bg
迪拉爾派	di[yz la[fl er[dx pd[dp
地名辭典	di[ty mk[xk ci[ql dm[kb
底尼	di[gu ni[ub
低念	di[ru nm[rx
低聲派	di[ru ug[um pd[dp
迪瓦尼體	di[yz wa[hv ni[ub ti[ra
迪萬尼	di[yz wj[hv ni[ub
諦言	di[yl yj[we
第一理智	di[vg yi[hh li[wo vi[uo
點燈節	dm[bd dg[hd jp[ce
吊罐	dn[kj gr[wc
定州禮拜寺	dk[gp vz[dp li[uv bd[fh si[tc
東方五族史	ds[qx fh[dw wu[hu zu[fr ui[ki
東亞清真總會	ds[qx ya[hy qk[df vf[uj zs[bx hv[re
都阿	dz[te aa[ek
都瓦日	dz[te wa[hv ri[wh
杜阿宜	du[at aa[ek yi[gq
獨班	du[qi bj[wd
督教	du[um jn[tw
渡瀘之役	du[dg lu[db vi[dv yi[rj
堵什曼	du[tt uf[ru mj[os
斷肢刑	dr[mj vi[ou xk[kd
短作	dr[ud zo[rv
頓押	dy[ty ya[fo
躉雅四部真經	dy[wz ya[yv si[we bu[le vf[uj jk[ss
多斯梯	do[xx si[qj ti[ab
垛子海	do[tj zi[lh hd[dr
朵子海	do[ja zi[lh hd[dr
訛答剌事變	ee[yr da[vr la[hd ui[hk bm[yy
鄂依庫爾會晤	ee[ke yi[ry ku[gi er[dx hv[re wu[ow
恩典	en[wx dm[kb
恩霖陰	en[wx lb[ya yb[eo
二阿訇	er[hh aa[ek hs[by
爾德	er[dx de[ru
爾德艾祖哈	er[dx de[ru ai[ci zu[uq ha[kr
爾德費圖爾	er[dx de[ru fw[fb tu[ww er[dx
爾德節	er[dx de[ru jp[ce
爾林	er[dx lb[aa
爾麥來	er[dx md[fw ld[hm
爾埋裡	er[dx md[to li[ot
爾母蘭	er[dx mu[vv lj[bs
爾撒	er[dx sa[fg
爾撒之死	er[dx sa[fg vi[dv si[hx
二氏	er[hh ui[pq
法版	fa[dt bj[pp
法德里教團	fa[dt de[ru li[ot jn[tw tr[wc
法蒂哈	fa[dt di[cl ha[kr
法諦哈	fa[dt di[yl ha[kr
法蒂瑪王朝	fa[dt di[cl ma[wm wh[su ic[uo
法基爾	fa[dt ji[qt er[dx
法令修正篇	fa[dt lk[rd xq[ru vg[hv pm[vh
法律擬製	fa[dt lv[ry ni[fs vi[nd
法斯赫	fa[dt si[qj he[tt
法特瓦	fa[dt te[nt wa[hv
法提哈	fa[dt ti[fo ha[kr
法土買	fa[dt tu[uh md[vd
凡雷咀	fj[jd lw[yt ju[kq
反宿命論派	fj[py su[gr mk[rh ly[yr pd[dp
泛伊斯蘭運動	fj[dp yi[rx si[qj lj[bs yy[ez ds[el
泛伊斯蘭主義	fj[dp yi[rx si[qj lj[bs vu[dw yi[di
翻譯運動	fj[px yi[yy yy[ez ds[el
斐達儀	fw[fw da[dz yi[rd
菲達因組織	fw[cf da[dz yb[wd zu[sq vi[sk
斐爾道司	fw[fw er[dx dc[bz si[vh
斐格海	fw[fw ge[aw hd[dr
費基	fw[fb ji[qt
匪喇傲	fw[kf la[kh ao[rf
費他耶	fw[fb ta[ry ye[ee
菲特彥	fw[cf te[nt yj[lp
菲特彥兄弟會	fw[cf te[nt yj[lp xs[ke di[bg hv[re
費隱經	fw[fb yb[ed jk[ss
非約定聘禮	fw[su yt[sb dk[gp pb[ey li[uv
非遵法派	fw[su zy[bz fa[dt pd[dp
分別境	ff[bd bp[kd jk[tl
芬吉王國	ff[cf ji[uk wh[su go[ww
分信	ff[bd xb[ry
鳳凰山拱北	fg[jy hl[jb uj[uk gs[fg bw[ub
封經	fg[tc jk[ss
封印	fg[tc yb[pe
封印先知	fg[tc yb[pe xm[ne vi[uk
封齋	fg[tc vd[we
副朝	fu[hd ic[uo
福爾剛	fu[uh er[dx gh[kd
副功	fu[hd gs[gl
副功拜	fu[hd gs[gl bd[fh
副教	fu[hd jn[tw
復臨	fu[ro lb[uv
福魯阿	fu[uh lu[yo aa[ek
復生教義	fu[ro ug[pf jn[tw yi[di
輔士	fu[if ui[uh
撫石	fu[fe ui[ek
富圖瓦	fu[gh tu[ww wa[hv
父系繼承人	fu[bi xi[py ji[sm ig[lu rf[pd
福州清真寺	fu[uh vz[dp qk[df vf[uj si[tc
嘎比勒	ga[ke bi[bb le[gl
嘎迪西葉之戰	ga[ke di[yz xi[hk ye[ku vi[dv vj[bg
蓋德爾派	gd[bm de[ru er[dx pd[dp
蓋德爾夜	gd[bm de[ru er[dx ye[wr
蓋德里葉派	gd[bm de[ru li[ot ye[ku pd[dp
蓋迪爾胡木	gd[bm di[yz er[dx hu[go mu[ub
蓋迪爾節	gd[bm di[yz er[dx jp[ce
岡志	gh[ki vi[ux
高加索戰爭	gc[wk jx[lk so[uy vj[bg vg[dx
高念	gc[wk nm[rx
高聲派	gc[wk ug[um pd[dp
高趙家門宦	gc[wk vc[zi jx[gu mf[du hr[gk
格底林耶	ge[aw di[gu lb[aa ye[ee
格底木	ge[aw di[gu mu[ub
哥疾寧王朝	ge[kk ji[bu nk[gd wh[su ic[uo
革爛得	ge[nk lj[hb de[ro
葛倫	ge[co ly[rr
戈倫	ge[qp ly[rr
格亞斯	ge[aw ya[hy si[qj
攻克麥加之戰	gs[gw ke[ge md[fw jx[lk vi[dv vj[bg
公一派	gs[bs yi[hh pd[dp
公益瓦剋夫	gs[bs yi[bm wa[hv ke[ge fu[er
古巴義清真寺	gu[uk ba[ku yi[di qk[df vf[uj si[tc
古代遺蹟	gu[uk dd[rq yi[vz ji[yz
固定刑	gu[wg dk[gp xk[kd
古爾埃米爾	gu[uk er[dx ai[ts mi[ba er[dx
古爾邦	gu[uk er[dx bh[fe
古蘭	gu[uk lj[bs
古蘭經	gu[uk lj[bs jk[ss
古蘭經初解	gu[uk lj[bs jk[ss iu[yd jp[dd
古蘭經繼承人	gu[uk lj[bs jk[ss ji[sm ig[lu rf[pd
古蘭經解總彙	gu[uk lj[bs jk[ss jp[dd zs[bx hv[dk
古蘭經律例	gu[uk lj[bs jk[ss lv[ry li[rh
古蘭經受造說	gu[uk lj[bs jk[ss uz[ay zc[nz uo[yb
古蘭經無始說	gu[uk lj[bs jk[ss wu[ee ui[ns uo[yb
古蘭經譯解	gu[uk lj[bs jk[ss yi[yy jp[dd
古那亥	gu[uk na[ve hd[wp
古努臺	gu[uk nu[nl td[sk
古潤禮拜寺記	gu[uk ry[dm li[uv bd[fh si[tc ji[yk
古太白東征	gu[uk td[dd bd[po ds[qx vg[rh
姑太節	gu[ng td[dd jp[ce
固特卜	gu[wg te[nt bu[ud
固土布	gu[wg tu[uh bu[uj
古行	gu[uk xk[rh
寡婦留置權	gx[gf fu[nx lq[pt vi[su qr[ay
光節	gl[xe jp[ce
光明之園	gl[xe mk[oo vi[dv yr[we
光塔派	gl[xe ta[tc pd[dp
光陰派	gl[xe yb[eo pd[dp
廣元清真寺	gl[di yr[ee qk[df vf[uj si[tc
廣州之劫	gl[di vz[dp vi[dv jp[tl
貴陽清真寺	gv[vb yh[eo qk[df vf[uj si[tc
歸真	gv[ux vf[uj
歸真要道	gv[ux vf[uj yc[xn dc[bz
歸真總義	gv[ux vf[uj zs[bx yi[di
歸正儀	gv[ux vg[hv yi[rd
國家繼承人	go[ww jx[gu ji[sm ig[lu rf[pd
國王清真大寺	go[ww wh[su qk[df vf[uj da[hr si[tc
果園十條	go[oa yr[we ui[hu tn[wa
哈比勒	ha[kr bi[bb le[gl
哈伯斯	ha[kr bo[rb si[qj
哈底斯	ha[kr di[gu si[qj
哈爾瓦提教團	ha[kr er[dx wa[hv ti[fo jn[tw tr[wc
哈菲茲派	ha[kr fw[cf zi[by pd[dp
哈夫斯王朝	ha[kr fu[er si[qj wh[su ic[uo
哈吉	ha[kr ji[uk
哈吉布	ha[kr ji[uk bu[uj
哈卡姆	ha[kr ka[ub mu[nm
哈拉吉	ha[kr la[fl ji[uk
哈拉吉王朝	ha[kr la[fl ji[uk wh[su ic[uo
哈拉姆	ha[kr la[fl mu[nm
哈拉目	ha[kr la[fl mu[we
哈里	ha[kr li[ot
哈里發學說	ha[kr li[ot fa[vy xt[xz uo[yb
哈里發運動	ha[kr li[ot fa[vy yy[ez ds[el
哈倆裡	ha[kr lx[rh li[ot
哈魯拉派	ha[kr lu[yo la[fl pd[dp
哈錄乃	ha[kr lu[xu nd[vp
哈姆丹王朝	ha[kr mu[nm dj[kw wh[su ic[uo
哈乃斐學派	ha[kr nd[vp fw[fw xt[xz pd[dp
哈尼夫	ha[kr ni[ub fu[er
哈尼卡	ha[kr ni[ub ka[ub
哈日哈那	ha[kr ri[wh ha[kr na[ve
哈桑清真寺	ha[kr sh[ya qk[df vf[uj si[tc
哈塔布派	ha[kr ta[tc bu[uj pd[dp
哈特米教團	ha[kr te[nt mi[ba jn[tw tr[wc
哈瓦利吉派	ha[kr wa[hv li[hd ji[uk pd[dp
哈宛德	ha[kr wj[gx de[ru
哈希姆派	ha[kr xi[iu mu[nm pd[dp
哈哲爾	ha[kr ve[fk er[dx
哈最制	ha[kr zv[oe vi[nd
海巴爾之戰	hd[dr ba[ku er[dx vi[dv vj[bg
海必布	hd[dr bi[xp bu[uj
還補拜	hd[bz bu[yb bd[fh
海德葉	hd[dr de[ru ye[ku
海蒂撤	hd[dr di[cl ie[fw
海底也	hd[dr di[gu ye[vu
海富潤事件	hd[dr fu[gh ry[dm ui[hk jm[rn
海里排	hd[dr li[ot pd[ff
海特乃	hd[dr te[nt nd[vp
海提耶	hd[dr ti[fo ye[ee
亥亭	hd[wp tk[wd
亥聽	hd[wp tk[kj
海推布	hd[dr tv[fv bu[uj
海乙制	hd[dr yi[vv vi[nd
罕百里學派	hj[gg bd[eo li[ot xt[xz pd[dp
罕格	hj[gg ge[aw
罕卡	hj[gg ka[ub
罕立克教經堂	hj[gg li[lh ke[ge jn[tw jk[ss th[xt
漢學派	hj[dy xt[xz pd[dp
漢譯寶命真經	hj[dy yi[yy bc[gw mk[rh vf[uj jk[ss
漢譯耳木代	hj[dy yi[yy er[hu mu[ub dd[rq
漢依寺	hj[dy yi[ry si[tc
壕溝之戰	hc[tw gz[db vi[dv vj[bg
好媧	hc[nz wa[nk
號召黨	hc[kk vc[dk dh[xk
合法子女	he[rh fa[dt zi[lh nv[vp
和加	he[hk jx[lk
合門爭長	he[rh mf[du vg[dx ih[ph
和田宗教辯論	he[hk tm[wu zs[ge jn[tw bm[ly ly[yr
合一者	he[rh yi[hh ve[to
合一中寂滅	he[rh yi[hh vs[ku ji[gu mp[hh
和約地區	he[hk yt[sb di[ty qu[ki
和卓傳	he[hk vo[bo ir[re
和卓夏提麻札	he[hk vo[bo xx[ew ti[fo ma[ga va[av
赫資勒	he[tt zi[db le[gl
黑蚩拉	hw[sd ii[ci la[fl
黑汗王朝	hw[sd hj[dg wh[su ic[uo
黑穆斯林運動	hw[sd mu[hb si[qj lb[aa yy[ez ds[el
黑奴起義	hw[sd nu[ny qi[zk yi[di
黑山派	hw[sd uj[uk pd[dp
黑羊王朝	hw[sd yh[bs wh[su ic[uo
黑衣大食	hw[sd yi[wy da[hr ui[rl
黑秩爾	hw[sd vi[hp er[dx
黑孜爾	hw[sd zi[zw er[dx
洪門門宦	hs[dg mf[du mf[du hr[gk
洪門十戒	hs[dg mf[du ui[hu jp[gc
鴻樂府道堂	hs[dn yt[px fu[gr dc[bz th[xt
侯達比亞協議	hz[rv da[dz bi[bb ya[hy xp[ul yi[yd
侯杜德	hz[rv du[at de[ru
候昆	hz[ru ky[ob
侯魯非派	hz[rv lu[yo fw[su pd[dp
侯魯勒派	hz[rv lu[yo le[gl pd[dp
侯乃尼之戰	hz[rv nd[vp ni[ub vi[dv vj[bg
侯賽因寺	hz[rv sd[gb yb[wd si[tc
後倭馬亞王朝	hz[pk wo[rh ma[vv ya[hy wh[su ic[uo
後子河拱北	hz[pk zi[lh he[dk gs[fg bw[ub
胡伯勒	hu[go bo[rb le[gl
胡達	hu[go da[dz
胡達萬德	hu[go da[dz wj[hv de[ru
扈代	hu[hk dd[rq
虎非耶	hu[hj fw[su ye[ee
胡加	hu[go jx[lk
胡加特伊斯蘭	hu[go jx[lk te[nt yi[rx si[qj lj[bs
胡拉米派	hu[go la[fl mi[ba pd[dp
胡門門宦	hu[go mf[du mf[du hr[gk
呼圖白	hu[kp tu[ww bd[po
花刺子模王國	hx[cr ci[cd zi[lh mu[ac wh[su go[ww
化覺巷清真寺	hx[rq jt[xj xl[gk qk[df vf[uj si[tc
花市清真寺	hx[cr ui[wj qk[df vf[uj si[tc
華寺門宦	hx[ru si[tc mf[du hr[gk
壞拜	hk[tb bd[fh
懷聖寺	hk[xb ug[yt si[tc
幻我	hr[yv wo[pf
黃金草原	hl[gy jb[rw cc[co yr[ib
黃金傳系	hl[gy jb[rw ir[re xi[py
回賜	hv[wk ci[bo
回回大師	hv[wk hv[wk da[hr ui[uh
回輝登清真寺	hv[wk hv[xg dg[dd qk[df vf[uj si[tc
回回教	hv[wk hv[wk jn[tw
回回教門	hv[wk hv[wk jn[tw mf[du
回回曆法	hv[wk hv[wk li[il fa[dt
回回術	hv[wk hv[wk uu[ad
回輝說	hv[wk hv[xg uo[yb
回回說	hv[wk hv[wk uo[yb
回教考	hv[wk jn[tw kc[tk
會禮	hv[re li[uv
回賽倆目	hv[wk sd[gb lx[rh mu[we
悔悟性	hv[xr wu[xw xk[xp
混合境	hy[do he[rh jk[tl
昏禮	hy[uo li[uv
婚姻對等	hy[nu yb[nw dv[yc dg[vt
婚姻監護	hy[nu yb[nw jm[um hu[fh
婚姻障礙	hy[nu yb[nw vh[el ai[eo
獲得說	ho[cq de[ro uo[yb
霍加派	ho[yv jx[lk pd[dp
霍加派教義	ho[yv jx[lk pd[dp jn[tw yi[di
霍梅尼清真寺	ho[yv mw[ar ni[ub qk[df vf[uj si[tc
火獄	ho[dp yu[qy
吉卜利裡	ji[uk bu[ud li[hd li[ot
吉卜特	ji[uk bu[ud te[nt
繼承順序	ji[sm ig[lu uy[iy xu[gy
繼承障礙	ji[sm ig[lu vh[el ai[eo
極端派	ji[aj dr[lu pd[dp
基爾瓦王朝	ji[qt er[dx wa[hv wh[su ic[uo
吉哈德	ji[uk ha[kr de[ru
吉哈爾	ji[uk ha[kr er[dx
積極理智	ji[hk ji[aj li[wo vi[uo
基拉發運動	ji[qt la[fl fa[vy yy[ez ds[el
基沙斯	ji[qt ua[dx si[qj
基斯夫派	ji[qt si[qj fu[er pd[dp
吉茲亞	ji[uk zi[by ya[hy
賈布爾派	jx[xb bu[uj er[dx pd[dp
賈卜裡派	jx[xb bu[ud li[ot pd[dp
加德基陵墓	jx[lk de[ru ji[qt lk[et mu[ct
加法爾派	jx[lk fa[dt er[dx pd[dp
加法爾學派	jx[lk fa[dt er[dx xt[xz pd[dp
加赫姆派	jx[lk he[tt mu[nm pd[dp
賈黑利亞	jx[xb hw[sd li[hd ya[hy
假基督	jx[rk ji[qt du[um
賈拉利倫理書	jx[xb la[fl li[hd ly[rr li[wo uu[vv
加曼買吉提	jx[lk mj[os md[vd ji[uk ti[fo
加納王國	jx[lk na[sk wh[su go[ww
賈納西派	jx[xb na[sk xi[hk pd[dp
加日甫凱西	jx[lk ri[wh fu[uo kd[uj xi[hk
加桑派	jx[lk sh[ya pd[dp
伽色尼王朝	jx[rl se[db ni[ub wh[su ic[uo
加蘇里教團	jx[lk su[cl li[ot jn[tw tr[wc
家庭法	jx[gu tk[gq fa[dt
家庭瓦剋夫	jx[gu tk[gq wa[hv ke[ge fu[er
嘉興清真寺	jx[ul xk[xb qk[df vf[uj si[tc
家語	jx[gu yu[yw
加茲尼王朝	jx[lk zi[by ni[ub wh[su ic[uo
檢查官法庭	jm[ar ia[ao gr[gu fa[dt tk[gq
儉可養廉碑	jm[rr ke[dk yh[yp lm[gb bw[eb
見認	jm[ke rf[yr
建設團結黨	jm[yj ue[yj tr[wc jp[su dh[xk
建水清真古寺	jm[yj uv[uu qk[df vf[uj gu[uk si[tc
見證單一論	jm[ke vg[yh dj[bo yi[hh ly[yr
叫拜	jn[kv bd[fh
教乘	jn[tw ig[qb
教典詮釋	jn[tw dm[kb qr[yr ui[py
教法根源學	jn[tw fa[dt gf[ag yr[di xt[xz
教法官	jn[tw fa[dt gr[gu
教法護衛	jn[tw fa[dt hu[fh ww[eh
教法護衛詳解	jn[tw fa[dt hu[fh ww[eh xl[yy jp[dd
教法基礎	jn[tw fa[dt ji[qt iu[ei
教法學	jn[tw fa[dt xt[xz
教法淵源學	jn[tw fa[dt yr[dp yr[di xt[xz
教法擇要寶鑑	jn[tw fa[dt ze[fy yc[xn bc[gw jm[uj
教法指南	jn[tw fa[dt vi[fb nj[uk
教法自通	jn[tw fa[dt zi[pm ts[sz
教階	jn[tw jp[er
教款捷要	jn[tw kr[ud jp[fh yc[xn
教款微論	jn[tw kr[ud ww[ru ly[yr
教領	jn[tw lk[ry
教律學	jn[tw lv[ry xt[xz
教門八件原根	jn[tw mf[du ba[pd jm[rn yr[ib gf[ag
教統說	jn[tw ts[sw uo[yb
教心經注	jn[tw xb[dv jk[ss vu[dd
教義學	jn[tw yi[di xt[xz
教義學大綱	jn[tw yi[di xt[xz da[hr gh[sk
教義學基礎	jn[tw yi[di xt[xz ji[qt iu[ei
教義學家	jn[tw yi[di xt[xz jx[gu
教義與教派	jn[tw yi[di yu[hv jn[tw pd[dp
教與學原則	jn[tw yu[hv xt[xz yr[ib ze[bd
教長阿訇	jn[tw vh[ph aa[ek hs[by
接都阿	jp[fl dz[te aa[ek
揭示奧祕	jp[fo ui[ex ao[pd mi[hx
戒衣	jp[gc yi[wy
禁寺	jb[ae si[tc
錦州市清真寺	jb[jb vz[dp ui[wj qk[df vf[uj si[tc
精底格	jk[mf di[gu ge[aw
淨禮	jk[dd li[uv
經名	jk[ss mk[xk
經名子	jk[ss mk[xk zi[lh
精尼	jk[mf ni[ub
精神導師	jk[mf uf[uo dc[kc ui[uh
經堂語	jk[ss th[xt yu[yw
經學系傳譜	jk[ss xt[xz xi[py ir[re pu[yb
經訓不悖說	jk[ss xy[yi bu[eu bw[xu uo[yb
精英薈萃	jk[mf yk[ck hv[cr cv[cw
經注學	jk[ss vu[dd xt[xz
經注之冠	jk[ss vu[dd vi[dv gr[ge
經字畫	jk[ss zi[gz hx[ht
韭菜坪門宦	jq[fh cd[ca pk[tp mf[du hr[gk
救濟傳	jq[hw ji[dw ir[re
九龍清真寺	jq[pv ls[yp qk[df vf[uj si[tc
拒絕派	ju[fk jt[sd pd[dp
聚禮	ju[ep li[uv
舉意	ju[xf yi[lx
舉意乜貼	ju[xf yi[lx mp[vv tp[bb
絕對界	jt[sd dv[yc jp[tr
掘坑人	jt[fu kg[tw rf[pd
卡迪法庭	ka[ub di[yz fa[dt tk[gq
卡迪賈馬阿	ka[ub di[yz jx[xb ma[vv aa[ek
卡迪庫達	ka[ub di[yz ku[gi da[dz
卡迪裡教團	ka[ub di[yz li[ot jn[tw tr[wc
卡爾巴拉	ka[ub er[dx ba[ku la[fl
卡爾巴拉慘案	ka[ub er[dx ba[ku la[fl cj[xs an[ga
卡爾拉姆派	ka[ub er[dx la[fl mu[nm pd[dp
卡爾馬特派	ka[ub er[dx ma[vv te[nt pd[dp
卡爾馬特王朝	ka[ub er[dx ma[vv te[nt wh[su ic[uo
卡爾馬特運動	ka[ub er[dx ma[vv te[nt yy[ez ds[el
卡菲	ka[ub fw[cf
卡非爾	ka[ub fw[su er[dx
喀喇汗王朝	ka[kg la[kh hj[dg wh[su ic[uo
卡拉科雍魯	ka[ub la[fl ke[hd ys[ws lu[yo
卡拉曼王朝	ka[ub la[fl mj[os wh[su ic[uo
卡拉米特派	ka[ub la[fl mi[ba te[nt pd[dp
卡拉米葉派	ka[ub la[fl mi[ba ye[ku pd[dp
卡臘摩胡	ka[ub la[og mo[gf hu[go
卡蘭達爾	ka[ub lj[bs da[dz er[dx
卡蘭達爾教團	ka[ub lj[bs da[dz er[dx jn[tw tr[wc
喀裡	ka[kg li[ot
卡里布派	ka[ub li[ot bu[uj pd[dp
卡梁清真寺	ka[ub ll[da qk[df vf[uj si[tc
卡奇米蒙派	ka[ub qi[dk mi[ba mg[ch pd[dp
喀什噶爾傳	ka[kg ui[ru ga[kc er[dx ir[re
喀什噶利亞史	ka[kg ui[ru ga[kc li[hd ya[hy ui[ki
卡特伊派	ka[ub te[nt yi[rx pd[dp
卡扎爾王朝	ka[ub va[fv er[dx wh[su ic[uo
卡孜	ka[ub zi[zw
卡孜艾蘭木	ka[ub zi[zw ai[ci lj[bs mu[ub
卡孜卡朗	ka[ub zi[zw ka[ub lh[lo
卡孜庫札提	ka[ub zi[zw ku[gi va[av ti[fo
卡孜穆夫提	ka[ub zi[zw mu[hb fu[er ti[fo
卡孜穆特拉克	ka[ub zi[zw mu[hb te[nt la[fl ke[ge
卡孜熱衣斯	ka[ub zi[zw re[fd yi[wy si[qj
開端章	kd[hc dr[lu vh[lo
凱凡	kd[uj fj[jd
開番	kd[hc fj[pt
開經	kd[hc jk[ss
凱拉姆	kd[uj la[fl mu[nm
凱拉姆學	kd[uj la[fl mu[nm xt[xz
凱桑派	kd[uj sh[ya pd[dp
凱沙甫	kd[uj ua[dx fu[uo
開學阿訇	kd[hc xt[xz aa[ek hs[by
開齋	kd[hc vd[we
開齋節	kd[hc vd[we jp[ce
開齋捐	kd[hc vd[we jr[fk
考洛瓦剋夫地	kc[tk lo[dw wa[hv ke[ge fu[er di[ty
考證回教歷史	kc[tk vg[yh hv[wk jn[tw li[il ui[ki
克爾白	ke[ge er[dx bd[po
克爾白圖	ke[ge er[dx bd[po tu[ww
課功	ke[yo gs[gl
克理默解	ke[ge li[wo mo[hq jp[dd
科威特大寺	ke[hd ww[wh te[nt da[hr si[tc
肯定詞	kf[vo dk[gp ci[yv
口喚	kz[uv hr[kd
叩頭章	kz[ke tz[dd vh[lo
庫布拉維教團	ku[gi bu[uj la[fl ww[sv jn[tw tr[wc
庫不林耶	ku[gi bu[eu lb[aa ye[ee
庫德西聖訓	ku[gi de[ru xi[hk ug[yt xy[yi
庫而西	ku[gi er[ek xi[hk
庫法清真寺	ku[gi fa[dt qk[df vf[uj si[tc
庫法體	ku[gi fa[dt ti[ra
庫尼卡達爾	ku[gi ni[ub ka[ub da[dz er[dx
庫特卜塔	ku[gi te[nt bu[ud ta[tc
庫特布王朝	ku[gi te[nt bu[uj wh[su ic[uo
廓爾王朝	ko[gw er[dx wh[su ic[uo
拉比塔	la[fl bi[bb ta[tc
拉斐德派	la[fl fw[fw de[ru pd[dp
拉赫曼教團	la[fl he[tt mj[os jn[tw tr[wc
拉施德史	la[fl ui[fr de[ru ui[ki
拉旺德派	la[fl wh[ow de[ru pd[dp
來複銘	ld[hm fu[ro mk[jx
萊給布	ld[cl gw[sr bu[uj
賴吉姆	ld[hd ji[uk mu[nm
萊麥丹	ld[cl md[fw dj[kw
萊買丹	ld[cl md[vd dj[kw
來蘇裡	ld[hm su[cl li[ot
來蘇黎	ld[hm su[cl li[hr
蘭杆瓦剋夫地	lj[bs gj[ag wa[hv ke[ge fu[er di[ty
藍寺	lj[cu si[tc
濫斯	lj[du si[qj
閬中巴巴寺	lh[ml vs[ku ba[ku ba[ku si[tc
老官川	lc[tb gr[gu ir[pu
了夜	le[vu ye[wr
雷巴	lw[yt ba[ku
雷沙來	lw[yt ua[dx ld[hm
裡巴特	li[ot ba[ku te[nt
禮拜	li[uv bd[fh
禮拜殿	li[uv bd[fh dm[uj
禮拜帽	li[uv bd[fh mc[jo
利比亞天課法	li[hd bi[bb ya[hy tm[hd ke[yo fa[dt
裡查姆派	li[ot ia[ao mu[nm pd[dp
禮乘	li[uv ig[qb
裡達	li[ot da[dz
裡法伊教團	li[ot fa[dt yi[rx jn[tw tr[wc
禮法正宗	li[uv fa[dt vg[hv zs[ge
利曼	li[hd mj[os
歷史大全	li[il ui[ki da[hr qr[rw
歷史選本	li[il ui[ki xr[nz bf[ah
歷史之友	li[il ui[ki vi[dv yz[uy
歷史週期論	li[il ui[ki vz[kt qi[qo ly[yr
隸屬教坊制	li[xu uu[up jn[tw fh[tf vi[nd
利息禁令	li[hd xi[zx jb[ae lk[rd
理性學科	li[wo xk[xp xt[xz ke[hd
理學派	li[wo xt[xz pd[dp
離儀	li[wk yi[rd
兩大總綱	ll[hk da[hr zs[bx gh[sk
兩弓一弦	ll[hk gs[kv yi[hh xm[gw
兩海	ll[hk hd[dr
兩弧界合	ll[hk hu[gp jp[tr he[rh
兩聖地教長	ll[hk ug[yt di[ty jn[tw vh[ph
列班禮拜	lp[hd bj[wd li[uv bd[fh
列聖	lp[hd ug[yt
臨時婚姻	lb[uv ui[oc hy[nu yb[nw
臨潭西道堂	lb[uv tj[dx xi[hk dc[bz th[xt
臨夏八坊華寺	lb[uv xx[ew ba[pd fh[tf hx[ru si[tc
臨夏八坊王寺	lb[uv xx[ew ba[pd fh[tf wh[su si[tc
臨夏大拱北	lb[uv xx[ew da[hr gs[fg bw[ub
靈魂	lk[xh hy[eg
靈魂轉宿說	lk[xh hy[eg vr[ie su[gr uo[yb
靈明堂	lk[xh mk[oo th[xt
六大使者	lq[wb da[hr ui[rh ve[to
六大信仰	lq[wb da[hr xb[ry yh[rp
六奴隸判例	lq[wb nu[ny li[xu pj[bd li[rh
六牙帽	lq[wb ya[hv mc[jo
魯格曼	lu[yo ge[aw mj[os
盧格體	lu[bu ge[aw ti[ra
魯哈	lu[yo ha[kr
魯密	lu[yo mi[gu
魯脫	lu[yo to[ob
魯扎罕	lu[yo va[fv hj[gg
魯札罕	lu[yo va[av hj[gg
論辯學派	ly[yr bm[ly xt[xz pd[dp
洛迪王朝	lo[dw di[yz wh[su ic[uo
駱駝之戰	lo[mw to[mg vi[dv vj[bg
羅伍澤哈	lo[sx wu[rw ze[dy ha[kr
驢判例	lv[mh pj[bd li[rh
綠衣大食	lv[sx yi[wy da[hr ui[rl
瑪大	ma[wm da[hr
馬達爾教派	ma[vv da[dz er[dx jn[tw pd[dp
馬爾焉	ma[vv er[dx yj[hh
馬赫迪運動	ma[vv he[tt di[yz yy[ez ds[el
馬拉布特	ma[vv la[fl bu[uj te[nt
麻拉目	ma[ga la[fl mu[we
瑪利克	ma[wm li[hd ke[ge
馬立克學派	ma[vv li[lh ke[ge xt[xz pd[dp
馬裡王國	ma[vv li[ot wh[su go[ww
馬魯特	ma[vv lu[yo te[nt
馬木留克王朝	ma[vv mu[ub lq[pt ke[ge wh[su ic[uo
馬納特	ma[vv na[sk te[nt
馬啟西遺聯	ma[vv qi[hk xi[hk yi[vz lm[eb
馬薩拉契	ma[vv sa[ce la[fl qi[fd
馬沙比遜奈	ma[vv ua[dx bi[bb xy[zz nd[de
馬什哈德	ma[vv uf[ru ha[kr de[ru
瑪斯納維	ma[wm si[qj na[sk ww[sv
瑪斯友美黨	ma[wm si[qj yz[uy mw[bw dh[xk
馬圖裡迪派	ma[vv tu[ww li[ot di[yz pd[dp
馬瓦里	ma[vv wa[hv li[ot
馬瓦立德	ma[vv wa[hv li[lh de[ru
麻札	ma[ga va[av
麻札朝拜	ma[ga va[av ic[uo bd[fh
麻札買吉提	ma[ga va[av md[vd ji[uk ti[fo
馬朱斯	ma[vv vu[ph si[qj
馬朱者	ma[vv vu[ph ve[to
買大嚴	md[vd da[hr yj[hy
麥德力斯	md[fw de[ru li[vp si[qj
麥德彥	md[fw de[ru yj[lp
麥地那	md[fw di[ty na[ve
麥地那篇章	md[fw di[ty na[ve pm[vh vh[lo
麥地那聖寺圖	md[fw di[ty na[ve ug[yt si[tc tu[ww
麥爾臥	md[fw er[dx wo[kb
麥爾彥	md[fw er[dx yj[lp
麥夫利德	md[fw fu[er li[hd de[ru
買格蘇代	md[vd ge[aw su[cl dd[rq
買吉提	md[vd ji[uk ti[fo
麥加	md[fw jx[lk
麥加篇章	md[fw jx[lk pm[vh vh[lo
麥加聖寺事件	md[fw jx[lk ug[yt si[tc ui[hk jm[rn
麥克魯海	md[fw ke[ge lu[yo hd[dr
買克嚕亥	md[vd ke[ge lu[ky hd[wp
麥克圖巴提	md[fw ke[ge tu[ww ba[ku ti[fo
賣空權	md[ud ks[xg qr[ay
買拉提布	md[vd la[fl ti[fo bu[uj
買嘞歐尼	md[vd le[kg ou[kd ni[ub
買賣契約	md[vd md[ud qi[fd yt[sb
麥斯吉德	md[fw si[qj ji[uk de[ru
買斯賴	md[vd si[qj ld[hd
麥斯歐迪史	md[fw si[qj ou[kd di[yz ui[ki
買斯志代	md[vd si[qj vi[ux dd[rq
麥希哈	md[fw xi[iu ha[kr
埋西哈	md[to xi[hk ha[kr
麥西赫達加勒	md[fw xi[hk he[tt da[dz jx[lk le[gl
買宜臺	md[vd yi[gq td[sk
曼杜伯	mj[os du[at bo[rb
曼吉爾	mj[os ji[uk er[dx
滿拉	mj[dc la[fl
曼齊克特之戰	mj[os qi[wp ke[ge te[nt vi[dv vj[bg
曼蘇爾派	mj[os su[cl er[dx pd[dp
滿足性	mj[dc zu[kv xk[xp
毛拉	mc[sv la[fl
毛拉維	mc[sv la[fl ww[sv
毛拉維教團	mc[sv la[fl ww[sv jn[tw tr[wc
冒提	mc[om ti[fo
昧真	mw[oh vf[uj
門宦	mf[du hr[gk
門頭師傅	mf[du tz[dd ui[uh fu[rf
蒙卡爾	mg[ch ka[ub er[dx
米爾達斯王朝	mi[ba er[dx da[dz si[qj wh[su ic[uo
米哈拉布	mi[ba ha[kr la[fl bu[uj
米哈奈	mi[ba ha[kr nd[de
米卡里	mi[ba ka[ub li[ot
米卡伊來	mi[ba ka[ub yi[rx ld[hm
米列維	mi[ba lp[hd ww[sv
米蒙派	mi[ba mg[ch pd[dp
祕密寶庫	mi[hx mi[gu bc[gw ku[gi
祕密珍寶	mi[hx mi[gu vf[wr bc[gw
祕密之園	mi[hx mi[gu vi[dv yr[we
迷撒蓋	mi[mz sa[fg gd[bm
免罪性	mm[dk zv[sf xk[xp
妙界	mn[nx jp[tr
乜提	mp[vv ti[fo
乜貼	mp[vv tp[bb
乜帖	mp[vv tp[jb
敏拜爾	mb[rw bd[fh er[dx
明經	mk[oo jk[ss
命令之主	mk[rh lk[rd vi[dv vu[dw
明意	mk[oo yi[lx
繆傑萊特	mq[sx jp[ad ld[cl te[nt
默那	mo[hq na[ve
末世說	mo[ha ui[nv uo[yb
莫臥兒帝國	mo[co wo[kb er[pv di[lj go[ww
穆阿麥倆特	mu[hb aa[ek md[fw lx[rh te[nt
穆安津	mu[hb an[gn jb[dy
穆巴哈	mu[hb ba[ku ha[kr
穆巴拉	mu[hb ba[ku la[fl
穆巴拉克派	mu[hb ba[ku la[fl ke[ge pd[dp
木刺夷	mu[ub ci[cd yi[hg
穆代日斯	mu[hb dd[rq ri[wh si[qj
穆爾吉亞派	mu[hb er[dx ji[uk ya[hy pd[dp
穆爾塔之戰	mu[hb er[dx ta[tc vi[dv vj[bg
穆爾太齊賴派	mu[hb er[dx td[dd qi[wp ld[hd pd[dp
穆爾西德	mu[hb er[dx xi[hk de[ru
穆夫提	mu[hb fu[er ti[fo
穆夫提門宦	mu[hb fu[er ti[fo mf[du hr[gk
穆蓋納爾派	mu[hb gd[bm na[sk er[dx pd[dp
穆蓋奈爾起義	mu[hb gd[bm nd[de er[dx qi[zk yi[di
穆哈吉勒	mu[hb ha[kr ji[uk le[gl
穆哈臺斯布	mu[hb ha[kr td[sk si[qj bu[uj
穆罕默德	mu[hb hj[gg mo[hq de[ru
穆罕默德法	mu[hb hj[gg mo[hq de[ru fa[dt
穆罕默德教	mu[hb hj[gg mo[hq de[ru jn[tw
穆罕默德派	mu[hb hj[gg mo[hq de[ru pd[dp
穆罕默德無極	mu[hb hj[gg mo[hq de[ru wu[ee ji[aj
穆罕默德真理	mu[hb hj[gg mo[hq de[ru vf[uj li[wo
穆罕默德之光	mu[hb hj[gg mo[hq de[ru vi[dv gl[xe
穆罕默德之路	mu[hb hj[gg mo[hq de[ru vi[dv lu[zw
穆合凱姆	mu[hb he[rh kd[uj mu[nm
穆赫塔爾派	mu[hb he[tt ta[tc er[dx pd[dp
穆赫塔爾起義	mu[hb he[tt ta[tc er[dx qi[zk yi[di
穆基爾派	mu[hb ji[qt er[dx pd[dp
穆加迪德	mu[hb jx[lk di[yz de[ru
穆賈希德	mu[hb jx[xb xi[iu de[ru
穆卡利德	mu[hb ka[ub li[hd de[ru
穆拉比特	mu[hb la[fl bi[bb te[nt
穆拉比特王朝	mu[hb la[fl bi[bb te[nt wh[su ic[uo
穆勒師德	mu[hb le[gl ui[uh de[ru
穆裡德	mu[hb li[ot de[ru
穆裡德教團	mu[hb li[ot de[ru jn[tw tr[wc
穆民	mu[hb mb[kv
穆民勸善歌	mu[hb mb[kv qr[yl uj[yk ge[kd
穆納非格	mu[hb na[sk fw[su ge[aw
母撒	mu[vv sa[fg
穆薩	mu[hb sa[ce
穆沙派	mu[hb ua[dx pd[dp
穆聖	mu[hb ug[yt
穆士裡克	mu[hb ui[uh li[ot ke[ge
穆斯林	mu[hb si[qj lb[aa
穆斯林法	mu[hb si[qj lb[aa fa[dt
穆斯林公社	mu[hb si[qj lb[aa gs[bs ue[ut
穆斯林離婚法	mu[hb si[qj lb[aa li[wk hy[nu fa[dt
穆斯林在線	mu[hb si[qj lb[aa zd[ut xm[sj
穆斯塔裡派	mu[hb si[qj ta[tc li[ot pd[dp
木速蠻	mu[ub su[hz mj[yi
穆塔爾	mu[hb ta[tc er[dx
穆塔瓦利	mu[hb ta[tc wa[hv li[hd
穆臺凱里姆	mu[hb td[sk kd[uj li[ot mu[nm
穆太薩維夫	mu[hb td[dd sa[ce ww[sv fu[er
穆太沙比哈	mu[hb td[dd ua[dx bi[bb ha[kr
木提外力	mu[ub ti[fo wd[xb li[vp
穆瓦希德	mu[hb wa[hv xi[iu de[ru
穆瓦希德王朝	mu[hb wa[hv xi[iu de[ru wh[su ic[uo
木希普	mu[ub xi[iu pu[bo
穆札巴納	mu[hb va[av ba[ku na[sk
穆智臺希德	mu[hb vi[uo td[sk xi[iu de[ru
拿參悟	na[rf cj[sd wu[xw
拿赫魯宛之戰	na[rf he[tt lu[yo wj[gx vi[dv vj[bg
納基爾	na[sk ji[qt er[dx
納加爾派	na[sk jx[lk er[dx pd[dp
納賈夫	na[sk jx[xb fu[er
納家營清真寺	na[sk jx[gu yk[ck qk[df vf[uj si[tc
納薩斐宇宙論	na[sk sa[ce fw[fw yu[ge vz[gy ly[yr
納賽裡編年史	na[sk sd[gb li[ot bm[sh nm[rn ui[ki
納賽裡倫理書	na[sk sd[gb li[ot ly[rr li[wo uu[vv
拿手	na[rf uz[su
納斯赫體	na[sk si[qj he[tt ti[ra
納瓦維	na[sk wa[hv ww[sv
納烏斯派	na[sk wu[bv si[qj pd[dp
納伊布	na[sk yi[rx bu[uj
乃賓依	nd[vp bb[gq yi[ry
乃非伊思巴提	nd[vp fw[su yi[rx si[tx ba[ku ti[fo
奈赫萊之戰	nd[de he[tt ld[cl vi[dv vj[bg
乃瑪子	nd[vp ma[wm zi[lh
乃瑪孜	nd[vp ma[wm zi[zw
奈斯爾	nd[de si[qj er[dx
乃隨卜	nd[vp sv[eu bu[ud
乃索拉	nd[vp so[uy la[fl
奈伊萊	nd[de yi[rx ld[cl
南川門宦	nj[uk ir[pu mf[du hr[gk
南蕃回回	nj[uk fj[cp hv[wk hv[wk
內邦克	nw[kr bh[fe ke[ge
內德	nw[kr de[ru
內五常	nw[kr wu[hu ih[xk
內學派	nw[kr xt[xz pd[dp
尼查爾派	ni[ub ia[ao er[dx pd[dp
尼查爾派教義	ni[ub ia[ao er[dx pd[dp jn[tw yi[di
尼卡罕	ni[ub ka[ub hj[gg
擬人派	ni[fs rf[pd pd[dp
擬人說	ni[fs rf[pd uo[yb
尼札米亞法庭	ni[ub va[av mi[ba ya[hy fa[dt tk[gq
念功	nm[rx gs[gl
念夜	nm[rx ye[wr
寧波清真古寺	nk[gd bo[dp qk[df vf[uj gu[uk si[tc
奴阿洪拱北	nu[ny aa[ek hs[dg gs[fg bw[ub
奴爾	nu[ny er[dx
努爾王朝	nu[nl er[dx wh[su ic[uo
努海	nu[nl hd[dr
奴卡巴	nu[ny ka[ub ba[ku
努克塔維派	nu[nl ke[ge ta[tc ww[sv pd[dp
努賽裡派	nu[nl sd[gb li[ot pd[dp
女聖忌	nv[vp ug[yt ji[kx
女聖潔者	nv[vp ug[yt jp[du ve[to
女聖徒	nv[vp ug[yt tu[rz
歐杜爾	ou[kd du[at er[dx
歐爾大木麻札	ou[kd er[dx da[hr mu[ub ma[ga va[av
歐蓋伊勒王朝	ou[kd gd[bm yi[rx le[gl wh[su ic[uo
歐古巴特	ou[kd gu[uk ba[ku te[nt
歐萊瑪	ou[kd ld[cl ma[wm
歐魯安派	ou[kd lu[yo an[gn pd[dp
歐麥勒	ou[kd md[fw le[gl
歐薩	ou[kd sa[ce
歐舍爾	ou[kd ue[rg er[dx
歐宰爾	ou[kd zd[gl er[dx
排除原則	pd[ff iu[er yr[ib ze[bd
派罕巴爾	pd[dp hj[gg ba[ku er[dx
潘吉皮爾派	pj[dp ji[uk pi[vp er[dx pd[dp
叛教罪	pj[bp jn[tw zv[sf
旁格清真寺	ph[lf ge[aw qk[df vf[uj si[tc
配賢	pw[yk xm[ub
闢爾	pi[ul er[dx
闢爾穆岡	pi[ul er[dx mu[hb gh[ki
皮斯乃瑪茲	pi[vp si[qj nd[vp ma[wm zi[by
拼湊法	pb[fb cz[ds fa[dt
普慈	pu[bo ci[bx
普慈特慈	pu[bo ci[bx te[nt ci[bx
普哈丁墓	pu[bo ha[kr dk[hu mu[ct
七層寶礦	qi[hv cg[ue bc[gw kl[eg
七層地獄	qi[hv cg[ue di[ty yu[qy
七黨聯盟	qi[hv dh[xk lm[eb mg[om
祈禱詞	qi[uj dc[uf ci[yv
七段伊瑪尼	qi[hv dr[pj yi[rx ma[wm ni[ub
祁靜一遺訓	qi[ue jk[fd yi[hh yi[vz xy[yi
齊克爾	qi[wp ke[ge er[dx
齊勒坦傳	qi[wp le[gl tj[to ir[re
乞勒坦麻札	qi[rv le[gl tj[to ma[ga va[av
齊米	qi[wp mi[ba
祈求真主回賜	qi[uj qq[hu vf[uj vu[dw hv[wk ci[bo
七思懼	qi[hv si[tx ju[xj
契斯提教團	qi[fd si[qj ti[fo jn[tw tr[wc
齊亞尼教團	qi[wp ya[hy ni[ub jn[tw tr[wc
七伊瑪目派	qi[hv yi[rx ma[wm mu[we pd[dp
契約繼承人	qi[fd yt[sb ji[sm ig[lu rf[pd
七齋	qi[hv vd[we
起指	qi[zk vi[fb
遷士	qm[qz ui[uh
僉議	qm[rh yi[yd
譴責派	qm[yv ze[fb pd[dp
切萊比	qp[qd ld[cl bi[bb
親賜	qb[la ci[bo
勤煉人	qb[nl lm[hq rf[pd
欽聖	qb[jd ug[yt
清淨教運動	qk[df jk[dd jn[tw yy[ez ds[el
情人集	qk[xf rf[pd ji[va
情人篇	qk[xf rf[pd pm[vh
清真根源	qk[df vf[uj gf[ag yr[di
清真教考	qk[df vf[uj jn[tw kc[tk
清真教說	qk[df vf[uj jn[tw uo[yb
清真牌	qk[df vf[uj pd[pb
清真普壽寺	qk[df vf[uj pu[bo uz[fc si[tc
清真寺	qk[df vf[uj si[tc
清真寺判例	qk[df vf[uj si[tc pj[bd li[rh
清真通俗歌	qk[df vf[uj ts[sz su[rb ge[kd
清真香	qk[df vf[uj xl[ho
清真醒世篇	qk[df vf[uj xk[yo ui[nv pm[vh
清真學社	qk[df vf[uj xt[xz ue[ut
清真言	qk[df vf[uj yj[we
清真要義	qk[df vf[uj yc[xn yi[di
清真正學	qk[df vf[uj vg[hv xt[xz
清真至理	qk[df vf[uj vi[ht li[wo
區別教義	qu[ki bp[kd jn[tw yi[di
曲索麻	qu[ou so[uy ma[ga
曲學	qu[ou xt[xz
權威教義	qr[ay ww[wh jn[tw yi[di
泉州靈山聖墓	qr[bu vz[dp lk[xh uj[uk ug[yt mu[ct
群書彙輯釋疑	qy[xy uu[vv hv[dk ji[ik ui[py yi[bs
熱衣斯	re[fd yi[wy si[qj
熱衣斯制	re[fd yi[wy si[qj vi[nd
人極	rf[pd ji[aj
人類史綱要	rf[pd lw[md ui[ki gh[sk yc[xn
認親繼承人	rf[yr qb[la ji[sm ig[lu rf[pd
人身監護	rf[pd uf[pu jm[um hu[fh
人仙神鬼說	rf[pd xm[ru uf[uo gv[be uo[yb
認一學	rf[yr yi[hh xt[xz
人主合一	rf[pd vu[dw he[rh yi[hh
人主合一論	rf[pd vu[dw he[rh yi[hh ly[yr
認主學	rf[yr vu[dw xt[xz
肉身派	rz[kr uf[pu pd[dp
肉身說	rz[kr uf[pu uo[yb
肉孜節	rz[kr zi[zw jp[ce
薩班派	sa[ce bj[wd pd[dp
薩比教徒	sa[ce bi[bb jn[tw tu[rz
薩多查依王朝	sa[ce do[xx ia[ao yi[ry wh[su ic[uo
薩法爾	sa[ce fa[dt er[dx
薩法爾王朝	sa[ce fa[dt er[dx wh[su ic[uo
薩非王朝	sa[ce fw[su wh[su ic[uo
撒哈比	sa[fg ha[kr bi[bb
撒金豆	sa[fg jb[rw dz[hk
撒拉回	sa[fg la[fl hv[wk
撒拉教	sa[fg la[fl jn[tw
撒拉姆	sa[fg la[fl mu[nm
薩拉森帝國	sa[ce la[fl sf[aa di[lj go[ww
撒拉森人	sa[fg la[fl sf[aa rf[pd
撒拉特	sa[fg la[fl te[nt
撒立哈	sa[fg li[lh ha[kr
薩里姆派	sa[ce li[ot mu[nm pd[dp
薩里姆學派	sa[ce li[ot mu[nm xt[xz pd[dp
薩曼教團	sa[ce mj[os jn[tw tr[wc
薩曼王朝	sa[ce mj[os wh[su ic[uo
撒米里	sa[fg mi[ba li[ot
賽阿德判例	sd[gb aa[ek de[ru pj[bd li[rh
賽巴伊派	sd[gb ba[ku yi[rx pd[dp
塞白	sd[gt bd[po
賽拜布	sd[gb bd[fh bu[uj
賽百布	sd[gb bd[eo bu[uj
賽伯邑	sd[gb bo[rb yi[kb
賽爾德教團	sd[gb er[dx de[ru jn[tw tr[wc
塞爾柱帝國	sd[gt er[dx vu[ad di[lj go[ww
塞爾柱王朝	sd[gt er[dx vu[ad wh[su ic[uo
塞基發會議	sd[gt ji[qt fa[vy hv[re yi[yd
賽萊菲亞派	sd[gb ld[cl fw[cf ya[hy pd[dp
賽萊菲耶	sd[gb ld[cl fw[cf ye[ee
賽倆目	sd[gb lx[rh mu[we
賽瑪	sd[gb ma[wm
賽莫德	sd[gb mo[co de[ru
賽母德	sd[gb mu[vv de[ru
塞那	sd[gt na[ve
賽努西教團	sd[gb nu[nl xi[hk jn[tw tr[wc
賽努西王朝	sd[gb nu[nl xi[hk wh[su ic[uo
賽努西運動	sd[gb nu[nl xi[hk yy[ez ds[el
賽哇布	sd[gb wa[kt bu[uj
賽義德王朝	sd[gb yi[di de[ru wh[su ic[uo
散班阿訇	sj[gw bj[wd aa[ek hs[by
三程	sj[hh ig[hk
三大經學	sj[hh da[hr jk[ss xt[xz
三大障礙	sj[hh da[hr vh[el ai[eo
三大正事	sj[hh da[hr vg[hv ui[hk
三道制	sj[hh dc[bz vi[nd
三德十行	sj[hh de[ru ui[hu hh[rh
三分之德	sj[hh ff[bd vi[dv de[ru
三極之學	sj[hh ji[aj vi[dv xt[xz
三君子	sj[hh jy[xk zi[lh
散課	sj[gw ke[yo
三品十條	sj[hh pb[kk ui[hu tn[wa
三十程	sj[hh ui[hu ig[hk
三抬教派	sj[hh td[fs jn[tw pd[dp
三王之戰	sj[hh wh[su vi[dv vj[bg
三位穆罕默德	sj[hh ww[rl mu[hb hj[gg mo[hq de[ru
三心七品	sj[hh xb[dv qi[hv pb[kk
三亞清真古寺	sj[hh ya[hy qk[df vf[uj gu[uk si[tc
三亞清真南寺	sj[hh ya[hy qk[df vf[uj nj[uk si[tc
三掌教制	sj[hh vh[xf jn[tw vi[nd
三字歸一	sj[hh zi[gz gv[ux yi[hh
桑給巴爾王國	sh[ya ji[sr ba[ku er[dx wh[su go[ww
桑尼王朝	sh[ya ni[ub wh[su ic[uo
色蘭	se[db lj[bs
色倆目	se[db lx[rh mu[we
沙便人	ua[dx bm[rh rf[pd
莎車大寺	ua[cd ie[qu da[hr si[tc
沙德爾	ua[dx de[ru er[dx
沙法維教團	ua[dx fa[dt ww[sv jn[tw tr[wc
沙法維王朝	ua[dx fa[dt ww[sv wh[su ic[uo
沙斐儀學派	ua[dx fw[fw yi[rd xt[xz pd[dp
沙溝門宦	ua[dx gz[db mf[du hr[gk
沙賈漢清真寺	ua[dx jx[xb hj[dy qk[df vf[uj si[tc
沙金達清真寺	ua[dx jb[rw da[dz qk[df vf[uj si[tc
沙克開	ua[dx ke[ge kd[hc
沙裡哈	ua[dx li[ot ha[kr
沙利赫教團	ua[dx li[hd he[tt jn[tw tr[wc
沙裡西派	ua[dx li[ot xi[hk pd[dp
沙里亞	ua[dx li[ot ya[hy
沙里亞法	ua[dx li[ot ya[hy fa[dt
沙里亞法庭	ua[dx li[ot ya[hy fa[dt tk[gq
沙曼尼教團	ua[dx mj[os ni[ub jn[tw tr[wc
沙迷賴人	ua[dx mi[mz ld[hd rf[pd
沙塔裡教團	ua[dx ta[tc li[ot jn[tw tr[wc
沙茲裡教團	ua[dx zi[by li[ot jn[tw tr[wc
沙孜林耶	ua[dx zi[zw lb[aa ye[ee
晒依陀尼	ud[ox yi[ry to[eg ni[ub
善功	uj[yk gs[gl
山中老人	uj[uk vs[ku lc[tb rf[pd
晌禮	uh[op li[uv
上苫單	uh[bh uj[cb dj[bo
稍麻寺	uc[hx ma[ga si[tc
邵武清真寺	uc[de wu[hv qk[df vf[uj si[tc
舍哈代臺	ue[rg ha[kr dd[rq td[sk
社會進步黨	ue[ut hv[re jb[ez bu[vu dh[xk
舍裡阿	ue[rg li[ot aa[ek
射石	ue[uc ui[ek
舍西德	ue[rg xi[hk de[ru
舍希德	ue[rg xi[iu de[ru
涉疑	ue[dv yi[bs
神愛論	uf[uo ai[au ly[yr
神光論	uf[uo gl[xe ly[yr
神祕論者園地	uf[uo mi[hx ly[yr ve[to yr[we di[ty
神祕主義註釋	uf[uo mi[hx vu[dw yi[di vu[dd ui[py
神祕宗教劇	uf[uo mi[hx zs[ge jn[tw ju[ud
滲滲泉	uf[ds uf[ds qr[bu
神聖界	uf[uo ug[yt jp[tr
神聖信條	uf[uo ug[yt xb[ry tn[wa
神聖義務運動	uf[uo ug[yt yi[di wu[wl yy[ez ds[el
瀋陽清真南寺	uf[dg yh[eo qk[df vf[uj nj[uk si[tc
神旨	uf[uo vi[bo
神智	uf[uo vi[uo
神旨變換說	uf[uo vi[bo bm[yy hr[fd uo[yb
神智論	uf[uo vi[uo ly[yr
神智宇宙論	uf[uo vi[uo yu[ge vz[gy ly[yr
聖會	ug[yt hv[re
聖忌	ug[yt ji[kx
聖紀	ug[yt ji[sk
聖潔者	ug[yt jp[du ve[to
聖潔之園	ug[yt jp[du vi[dv yr[we
聖門弟子	ug[yt mf[du di[bg zi[lh
聖門弟子團	ug[yt mf[du di[bg zi[lh tr[wc
聖人	ug[yt rf[pd
聖寺	ug[yt si[tc
聖徒崇拜	ug[yt tu[rz is[ug bd[fh
聖徒列傳	ug[yt tu[rz lp[hd vr[re
聖徒受難戲	ug[yt tu[rz uz[ay nj[yv xi[yg
聖賢傳	ug[yt xm[ub ir[re
聖學重光	ug[yt xt[xz is[ph gl[xe
聖訓	ug[yt xy[yi
聖訓辨異	ug[yt xy[yi bm[ld yi[kc
聖訓廢止說	ug[yt xy[yi fw[gv vi[uh uo[yb
聖訓集	ug[yt xy[yi ji[va
聖訓經	ug[yt xy[yi jk[ss
聖訓律例	ug[yt xy[yi lv[ry li[rh
聖訓派	ug[yt xy[yi pd[dp
聖訓實錄	ug[yt xy[yi ui[gd lu[xu
聖訓學	ug[yt xy[yi xt[xz
聖訓易讀	ug[yt xy[yi yi[ob du[yu
聖訓珠璣	ug[yt xy[yi vu[wp ji[wj
聖裔	ug[yt yi[yk
聖友寺	ug[yt yz[uy si[tc
聖戰者運動	ug[yt vj[bg ve[to yy[ez ds[el
聖治	ug[yt vi[ds
聖智者	ug[yt vi[uo ve[to
聖族	ug[yt zu[fr
事阿訇	ui[hk aa[ek hs[by
十八段	ui[hu ba[pd dr[pj
十八千世界	ui[hu ba[pd qm[pu ui[nv jp[tr
侍從長	ui[rt cs[rr ih[ph
時代瑰寶	ui[oc dd[rq gv[wg bc[gw
時代之主	ui[oc dd[rq vi[dv vu[dw
十二伊瑪目派	ui[hu er[hh yi[rx ma[wm mu[we pd[dp
十六遵行	ui[hu lq[wb zy[bz xk[rh
釋奴	ui[py nu[ny
詩人傳記大全	ui[yt rf[pd vr[re ji[yk da[hr qr[rw
十三本	ui[hu sj[hh bf[ah
十聖人	ui[hu ug[yt rf[pd
施師	ui[fr ui[uh
十四本	ui[hu si[we bf[ah
十項主命	ui[hu xl[gy vu[dw mk[rh
示形禮拜	ui[ex xk[kp li[uv bd[fh
史選	ui[ki xr[nz
誓言保證	ui[fy yj[we bc[rk vg[yh
十葉派繼承法	ui[hu ye[ku pd[dp ji[sm ig[lu fa[dt
十葉派世紀	ui[hu ye[ku pd[dp ui[nv ji[sk
什一稅	ui[ru yi[hh uv[hb
使者與帝王史	ui[rh ve[to yu[hv di[lj wh[su ui[ki
石嘴山清真寺	ui[ek zv[kv uj[uk qk[df vf[uj si[tc
受譴責派	uz[ay qm[yv ze[fb pd[dp
壽縣清真寺	uz[fc xm[qs qk[df vf[uj si[tc
守制期	uz[gc vi[nd qi[qo
舒阿卜	uu[ry aa[ek bu[ud
書爾布	uu[vv er[dx bu[uj
屬迷	uu[up mi[mz
屬性派	uu[up xk[xp pd[dp
屬性之美名	uu[up xk[xp vi[dv mw[bw mk[xk
甩得蓋	uk[ov de[ro gd[bm
雙重買賣	ul[yy is[ph md[vd md[ud
雙角人	ul[yy jn[do rf[pd
四大哈里發	si[we da[hr ha[kr li[ot fa[vy
四大幔帳	si[we da[hr mj[jo vh[ji
四大天使	si[we da[hr tm[hd ui[rh
寺坊	si[tc fh[tf
死後復活	si[hx hz[pk fu[ro ho[dq
四角鄉老	si[we jn[do xl[sp lc[tb
四教要括	si[we jn[tw yc[xn ko[fq
四篇要道	si[we pm[vh yc[xn dc[bz
四任代理	si[we rf[rq dd[rq li[wo
私人瓦剋夫	si[hs rf[pd wa[hv ke[ge fu[er
四任維卡拉	si[we rf[rq ww[sv ka[ub la[fl
寺師傅	si[tc ui[uh fu[rf
四統	si[we ts[sw
私通罪	si[hs ts[sz zv[sf
斯瓦希里文化	si[qj wa[hv xi[iu li[ot wf[wi hx[rq
四伊瑪目傳	si[we yi[rx ma[wm mu[we ir[re
送阿訇	ss[bz aa[ek hs[by
誦經家	ss[ys jk[ss jx[gu
蘇丹哈桑寺	su[cl dj[kw ha[kr sh[ya si[tc
蘇丹烏瑪黨	su[cl dj[kw wu[bv ma[wm dh[xk
蘇丹之律令	su[cl dj[kw vi[dv lv[ry lk[rd
蘇爾斯體	su[cl er[dx si[qj ti[ra
蘇非	su[cl fw[su
蘇非教團	su[cl fw[su jn[tw tr[wc
蘇非教義	su[cl fw[su jn[tw yi[di
蘇非派	su[cl fw[su pd[dp
蘇非派教制	su[cl fw[su pd[dp jn[tw vi[nd
蘇非主義	su[cl fw[su vu[dw yi[di
蘇富揚人	su[cl fu[gh yh[fv rf[pd
蘇拉巴迪經注	su[cl la[fl ba[ku di[yz jk[ss vu[dd
蘇萊曼	su[cl ld[cl mj[os
素賴曼	su[fy ld[hd mj[os
蘇萊曼派	su[cl ld[cl mj[os pd[dp
蘇萊曼遊記	su[cl ld[cl mj[os yz[df ji[yk
蘇力坦麻札	su[cl li[vp tj[to ma[ga va[av
蘇瑪特派	su[cl ma[wm te[nt pd[dp
宿命論派	su[gr mk[rh ly[yr pd[dp
蘇歐布運動	su[cl ou[kd bu[uj yy[ez ds[el
蘇派	su[cl pd[dp
蘇皮	su[cl pi[vp
素瓦爾	su[fy wa[hv er[dx
隨法提	sv[eu fa[dt ti[fo
隋芬之戰	sv[eu ff[cf vi[dv vj[bg
筍乃臺	sy[vx nd[vp td[sk
索哈百	so[uy ha[kr bd[eo
索科託蘇丹國	so[uy ke[hd to[fp su[cl dj[kw go[ww
索嘞	so[uy le[kg
索馬里家庭法	so[uy ma[vv li[ot jx[gu tk[gq fa[dt
塔百里史	ta[tc bd[eo li[ot ui[ki
塔比爾	ta[tc bi[bb er[dx
塔布克之戰	ta[tc bu[uj ke[ge vi[dv vj[bg
塔格利德	ta[tc ge[aw li[hd de[ru
塔格利德派	ta[tc ge[aw li[hd de[ru pd[dp
塔古特	ta[tc gu[uk te[nt
塔哈維派	ta[tc ha[kr ww[sv pd[dp
塔基亞	ta[tc ji[qt ya[hy
塔克魯爾王國	ta[tc ke[ge lu[yo er[dx wh[su go[ww
塔拉格	ta[tc la[fl ge[aw
塔里布	ta[tc li[ot bu[uj
塔魯特	ta[tc lu[yo te[nt
塔什干起義	ta[tc ui[ru gj[hu qi[zk yi[di
塔希爾王朝	ta[tc xi[iu er[dx wh[su ic[uo
塔伊夫之戰	ta[tc yi[rx fu[er vi[dv vj[bg
泰安清真寺	td[su an[gn qk[df vf[uj si[tc
臺北清真大寺	td[sk bw[ub qk[df vf[uj da[hr si[tc
太甫綏魯	td[dd fu[uo sv[sa lu[yo
臺哈勒麥	td[sk ha[kr le[gl md[fw
太哈祕德	td[dd ha[kr mi[hx de[ru
泰姬瑪哈爾	td[su ji[nk ma[wm ha[kr er[dx
太克畢雷	td[dd ke[ge bi[bu lw[yt
太可瓦剋夫地	td[dd ke[dk wa[hv ke[ge fu[er di[ty
太薩伍夫	td[dd sa[ce wu[rw fu[er
臺思迷	td[sk si[tx mi[mz
臺斯米	td[sk si[qj mi[ba
太思米葉	td[dd si[tx mi[ba ye[ku
臺土臥	td[sk tu[uh wo[kb
泰亞蒙	td[su ya[hy mg[ch
臺伊布傳道會	td[sk yi[rx bu[uj ir[re dc[bz hv[re
臺伊佈教義	td[sk yi[rx bu[uj jn[tw yi[di
臺伊布派	td[sk yi[rx bu[uj pd[dp
太原清真古寺	td[dd yr[ib qk[df vf[uj gu[uk si[tc
臺子寺	td[sk zi[lh si[tc
太茲伊爾	td[dd zi[by yi[rx er[dx
坦吉麥特	tj[to ji[uk md[fw te[nt
探泉	tj[fg qr[bu
探索之路	tj[fg so[uy vi[dv lu[zw
湯牌	th[dv pd[pb
湯瓶	th[dv pk[bw
討白	tc[yc bd[po
討菲蓋	tc[yc fw[cf gd[bm
陶菲戈	tc[eb fw[cf ge[qp
討黑德	tc[yc hw[sd de[ru
討拉特	tc[yc la[fl te[nt
陶立嘎	tc[eb li[lh ga[ke
陶醉者	tc[eb zv[yw ve[to
特別代理人	te[nt bp[kd dd[rq li[wo rf[pd
特慈	te[nt ci[bx
特拉威哈	te[nt la[fl ww[wh ha[kr
特斯必赫	te[nt si[qj bi[xp he[tt
替代說	ti[eo dd[rq uo[yb
提加尼教團	ti[fo jx[lk ni[ub jn[tw tr[wc
體一	ti[ra yi[hh
天方教	tm[hd fh[dw jn[tw
天方三字經	tm[hd fh[dw sj[hh zi[gz jk[ss
天方聖教序	tm[hd fh[dw ug[yt jn[tw xu[gy
天方詩經	tm[hd fh[dw ui[yt jk[ss
天方字母解義	tm[hd fh[dw zi[gz mu[vv jp[dd yi[di
天國劇	tm[hd go[ww ju[ud
天降筵席	tm[hd jl[ew yj[vp xi[gn
天津清真大寺	tm[hd jb[dy qk[df vf[uj da[hr si[tc
天使界	tm[hd ui[rh jp[tr
天仙	tm[hd xm[ru
天園聖靈	tm[hd yr[we ug[yt lk[xh
聽訴法庭	tk[kj su[yj fa[dt tk[gq
通貴門宦	ts[sz gv[vb mf[du hr[gk
統教	ts[sw jn[tw
通俗經典註釋	ts[sz su[rb jk[ss dm[kb vu[dd ui[py
同心清真大寺	ts[kh xb[dv qk[df vf[uj da[hr si[tc
偷盜罪	tz[rr dc[dm zv[sf
圖白	tu[ww bd[po
土耳其救國黨	tu[uh er[hu qi[cb jq[hw go[ww dh[xk
土耳其統一黨	tu[uh er[hu qi[cb ts[sw yi[hh dh[xk
圖爾戰役	tu[ww er[dx vj[bg yi[rj
圖格拉體	tu[ww ge[aw la[fl ti[ra
圖格魯克王朝	tu[ww ge[aw lu[yo ke[ge wh[su ic[uo
土淨	tu[uh jk[dd
圖倫王朝	tu[ww ly[rr wh[su ic[uo
圖馬尼派	tu[ww ma[vv ni[ub pd[dp
圖哇	tu[ww wa[kt
吐峪溝拱北	tu[kt yu[ub gz[db gs[fg bw[ub
推定守寡	tv[fv dk[gp uz[gc gx[gf
推定死亡	tv[fv dk[gp si[hx wh[wv
托缽僧	to[fp bo[ja sg[rb
託隆卡瓦	to[fp ls[ew ka[ub wa[hv
託羅貝	to[fp lo[sx bw[kr
託茂人	to[fp mc[cw rf[pd
託吾魯克麻札	to[fp wu[wk lu[yo ke[ge ma[ga va[av
瓦達阿德	wa[hv da[dz aa[ek de[ru
瓦爾茲	wa[hv er[dx zi[by
瓦哈比派	wa[hv ha[kr bi[bb pd[dp
瓦哈比派運動	wa[hv ha[kr bi[bb pd[dp yy[ez ds[el
穵哈德特	wa[[ ha[kr de[ru te[nt
挖哈一	wa[fx ha[kr yi[hh
瓦吉布	wa[hv ji[uk bu[uj
瓦基爾	wa[hv ji[qt er[dx
瓦基法派	wa[hv ji[qt fa[dt pd[dp
瓦剋夫	wa[hv ke[ge fu[er
瓦剋夫地	wa[hv ke[ge fu[er di[ty
瓦剋夫法	wa[hv ke[ge fu[er fa[dt
瓦剋夫經管人	wa[hv ke[ge fu[er jk[ss gr[vg rf[pd
瓦剋夫期限	wa[hv ke[ge fu[er qi[qo xm[eg
瓦剋夫受益人	wa[hv ke[ge fu[er uz[ay yi[bm rf[pd
瓦拉亞	wa[hv la[fl ya[hy
瓦里阿赫德	wa[hv li[ot aa[ek he[tt de[ru
瓦利安拉	wa[hv li[hd an[gn la[fl
瓦伊索夫派	wa[hv yi[rx so[uy fu[er pd[dp
外邦克	wd[xb bh[fe ke[ge
外五常	wd[xb wu[hu ih[xk
外學	wd[xb xt[xz
宛葛思墓	wj[gx ge[co si[tx mu[ct
完滿性	wj[ge mj[dc xk[xp
完人論	wj[ge rf[pd ly[yr
完人之書	wj[ge rf[pd vi[dv uu[vv
亡人	wh[wv rf[pd
望月樓	wh[ww yt[ke lz[am
衛道經解	ww[eh dc[bz jk[ss jp[dd
偉嘎業	ww[rw ga[ke ye[ub
維卡拉	ww[sv ka[ub la[fl
維卡亞教法	ww[sv ka[ub ya[hy jn[tw fa[dt
維拉亞	ww[sv la[fl ya[hy
唯能力論	ww[kv ng[sb li[vp ly[yr
委派制	ww[hn pd[dp vi[nd
委權說	ww[hn qr[ay uo[yb
偉人之園	ww[rw rf[pd vi[dv yr[we
偽士	ww[rd ui[uh
偉特雷	ww[rw te[nt lw[yt
衛特禮	ww[eh te[nt li[uv
委託休妻	ww[hn to[fp xq[ra qi[hn
偽先知	ww[rd xm[ne vi[uk
唯信德論	ww[kv xb[ry de[ru ly[yr
偽訓	ww[rd xy[yi
韋州清真大寺	ww[hh vz[dp qk[df vf[uj da[hr si[tc
吻拜	wf[kb bd[fh
文麥臺	wf[wi md[fw td[sk
渥都	wo[du dz[te
臥爾茲	wo[kb er[dx zi[by
臥各夫	wo[kb ge[wk fu[er
倭馬亞清真寺	wo[rh ma[vv ya[hy qk[df vf[uj si[tc
倭馬亞王朝	wo[rh ma[vv ya[hy wh[su ic[uo
烏巴德派	wu[bv ba[ku de[ru pd[dp
無常	wu[ee ih[xk
武昌清真寺	wu[hv ih[oo qk[df vf[uj si[tc
五大本	wu[hu da[hr bf[ah
五典	wu[hu dm[kb
五番拜	wu[hu fj[pt bd[fh
無方式信條	wu[ee fh[dw ui[qg xb[ry tn[wa
五更月	wu[hu gg[ho yt[ke
五功	wu[hu gs[gl
五功釋義	wu[hu gs[gl ui[py yi[di
五觀清	wu[hu gr[yj qk[df
伍侯德之戰	wu[rw hz[rv de[ru vi[dv vj[bg
吾吉麥麻札	wu[wk ji[uk md[fw ma[ga va[av
吳鑑清淨寺記	wu[kt jm[uj qk[df jk[dd si[tc ji[yk
吾裡	wu[wk li[ot
烏里瑪	wu[bv li[ot ma[wm
伍麥葉王朝	wu[rw md[fw ye[ku wh[su ic[uo
五聖界	wu[hu ug[yt jp[tr
五聖界說	wu[hu ug[yt jp[tr uo[yb
五聖書	wu[hu ug[yt uu[vv
五時三會	wu[hu ui[oc sj[hh hv[re
烏斯里	wu[bv si[qj li[ot
務思立	wu[wl si[tx li[lh
勿斯里	wu[bp si[qj li[ot
烏蘇爾	wu[bv su[cl er[dx
烏蘇爾學派	wu[bv su[cl er[dx xt[xz pd[dp
烏蘇勒	wu[bv su[cl le[gl
烏韋斯教團	wu[bv ww[hh si[qj jn[tw tr[wc
烏吾斯傳	wu[bv wu[wk si[qj ir[re
五仙馬	wu[hu xm[ru ma[vv
誣陷私通罪	wu[yg xm[ed si[hs ts[sz zv[sf
無效婚姻	wu[ee xn[lw hy[nu yb[nw
無伊瑪目教義	wu[ee yi[rx ma[wm mu[we jn[tw yi[di
烏札	wu[bv va[av
五種行為規範	wu[hu vs[hv xk[rh ww[dl gv[ej fj[cd
無字真經歌	wu[ee zi[gz vf[uj jk[ss ge[kd
希巴拉	xi[iu ba[ku la[fl
析產	xi[aj ij[lp
希大亞教法	xi[iu da[hr ya[hy jn[tw fa[dt
西道堂	xi[hk dc[bz th[xt
西哈胡西塔	xi[hk ha[kr hu[go xi[hk ta[tc
希吉拉	xi[iu ji[uk la[fl
希吉拉歷	xi[iu ji[uk la[fl li[il
希拉山洞	xi[iu la[fl uj[uk ds[dk
西來宗譜	xi[hk ld[hm zs[ge pu[yb
西浪瓦剋夫地	xi[hk lh[dl wa[hv ke[ge fu[er di[ty
錫斯坦史	xi[jo si[qj tj[to ui[ki
希亞沙沙里亞	xi[iu ya[hy ua[dx ua[dx li[ot ya[hy
希只爾	xi[iu vi[kb er[dx
希茲布	xi[iu zi[by bu[uj
夏赫散買吉提	xx[ew he[tt sj[gw md[vd ji[uk ti[fo
狹經	xx[qj jk[ss
先買權	xm[ne md[vd qr[ay
鮮門門宦	xm[yy mf[du mf[du hr[gk
現象一元論	xm[wj xl[dk yi[hh yr[ee ly[yr
先知	xm[ne vi[uk
先知故事集	xm[ne vi[uk gu[gw ui[hk ji[va
先知寺	xm[ne vi[uk si[tc
限制童婚法	xm[eg vi[nd ts[lo hy[nu fa[dt
先知無罪教義	xm[ne vi[uk wu[ee zv[sf jn[tw yi[di
先知之城	xm[ne vi[uk vi[dv ig[tw
相對隱密世界	xl[am dv[yc yb[ed mi[gu ui[nv jp[tr
響墳	xl[kp ff[tw
象軍	xl[dk jy[gi
鄉老	xl[sp lc[tb
象年	xl[dk nm[rn
詳史	xl[yy ui[ki
鄉約制	xl[sp yt[sb vi[nd
小兒錦	xn[ub er[pv jb[jb
小淨	xn[ub jk[dd
宵禮	xn[gx li[uv
小麥加	xn[ub md[fw jx[lk
小皮院清真寺	xn[ub pi[vp yr[eg qk[df vf[uj si[tc
小桃園清真寺	xn[ub tc[av yr[we qk[df vf[uj si[tc
小隱遁	xn[ub yb[ed dy[pz
謝赫學派	xp[yu he[tt xt[xz pd[dp
謝里夫王朝	xp[yu li[ot fu[er wh[su ic[uo
寫作啟明	xp[gh zo[rv qi[hk mk[oo
新罕百里派	xb[lj hj[gg bd[eo li[ot pd[dp
信後世	xb[ry hz[pk ui[nv
心見	xb[dv jm[ke
信禁	xb[ry jb[ae
新凱拉姆	xb[lj kd[uj la[fl mu[nm
新聖訓派	xb[lj ug[yt xy[yi pd[dp
新史	xb[lj ui[ki
信士傳	xb[ry ui[uh ir[re
信士修行之道	xb[ry ui[uh xq[ru xk[rh vi[dv dc[bz
新蘇非派	xb[lj su[cl fw[su pd[dp
信徒之坦途	xb[ry tu[rz vi[dv tj[to tu[rz
新興派	xb[lj xk[xb pd[dp
新汛史錄	xb[lj xy[dv ui[ki lu[xu
信仰學	xb[ry yh[rp xt[xz
醒回篇	xk[yo hv[wk pm[vh
形界	xk[kp jp[tr
性理本經註釋	xk[xp li[wo bf[ah jk[ss vu[dd ui[py
醒迷要錄	xk[yo mi[mz yc[xn lu[xu
性命宗旨	xk[xp mk[rh zs[ge vi[bo
行為指南	xk[rh ww[dl vi[fb nj[uk
雄辯之路	xs[uv bm[ly vi[dv lu[zw
雄辯之路注	xs[uv bm[ly vi[dv lu[zw vu[dd
修辭之坦途	xq[ru ci[ql vi[dv tj[to tu[rz
修建天房傳說	xq[ru jm[yj tm[hd fh[hf ir[re uo[yb
羞體	xq[yi ti[ra
修真蒙引	xq[ru vf[uj mg[ch yb[gu
酗酒罪	xu[yi jq[dy zv[sf
續認	xu[su rf[yr
續聖潔之園	xu[su ug[yt jp[du vi[dv yr[we
虛位殯禮	xu[hy ww[rl bb[hg li[uv
宣邦克	xr[gh bh[fe ke[ge
宣化清真北寺	xr[gh hx[rq qk[df vf[uj bw[ub si[tc
宣化清真南寺	xr[gh hx[rq qk[df vf[uj nj[uk si[tc
宣禮	xr[gh li[uv
宣禮樓	xr[gh li[uv lz[am
宣禮員	xr[gh li[uv yr[kb
選聘制	xr[nz pb[ey vi[nd
選擇期	xr[nz ze[fy qi[qo
學董	xt[xz ds[cp
血金	xt[pm jb[rw
尋道者	xy[xc dc[bz ve[to
殉教者園地	xy[hb jn[tw ve[to yr[we di[ty
遜奈	xy[zz nd[de
遜奈和大眾派	xy[zz nd[de he[hk da[hr vs[rr pd[dp
遜尼派繼承法	xy[zz ni[ub pd[dp ji[sm ig[lu fa[dt
遜尼蘇非學派	xy[zz ni[ub su[cl fw[su xt[xz pd[dp
循序禮拜	xy[rp xu[gy li[uv bd[fh
雅非斯	ya[yv fw[su si[qj
雅古柏	ya[yv gu[uk bd[ab
雅穆克之戰	ya[yv mu[hb ke[ge vi[dv vj[bg
亞齊蘇丹國	ya[hy qi[wp su[cl dj[kw go[ww
亞齊戰爭	ya[hy qi[wp vj[bg vg[dx
崖頭門宦	ya[ui tz[dd mf[du hr[gk
雅朱者	ya[yv vu[ph ve[to
雅茲里布	ya[yv zi[by li[ot bu[uj
岩石清真寺	yj[ue ui[ek qk[df vf[uj si[tc
洋行清真寺	yh[dy hh[rh qk[df vf[uj si[tc
搖頭派	yc[fa tz[dd pd[dp
葉爾孤白	ye[ku er[dx gu[zp bd[po
耶爾穆克之戰	ye[ee er[dx mu[hb ke[ge vi[dv vj[bg
葉哈雅	ye[ku ha[kr ya[yv
耶海雅	ye[ee hd[dr ya[yv
耶乎德	ye[ee hu[pb de[ru
葉歐格	ye[ku ou[kd ge[aw
耶提木買吉提	ye[ee ti[fo mu[ub md[vd ji[uk ti[fo
葉巫斯	ye[ku wu[gr si[qj
伊巴達特	yi[rx ba[ku da[dz te[nt
易巴德王朝	yi[ob ba[ku de[ru wh[su ic[uo
伊巴哈派	yi[rx ba[ku ha[kr pd[dp
伊巴希葉派	yi[rx ba[ku xi[iu ye[ku pd[dp
伊布拉欣	yi[rx bu[uj la[fl xb[jd
易卜力斯	yi[ob bu[ud li[vp si[qj
易卜劣廝	yi[ob bu[ud lp[xl si[iq
依禪	yi[ry ij[ub
依禪來爾	yi[ry ij[ub ld[hm er[dx
依禪派	yi[ry ij[ub pd[dp
依達耶提傳	yi[ry da[dz ye[ee ti[fo ir[re
一德理師	yi[hh de[ru li[wo ui[uh
易德里斯	yi[ob de[ru li[ot si[qj
伊德里斯教團	yi[rx de[ru li[ot si[qj jn[tw tr[wc
伊德里斯王朝	yi[rx de[ru li[ot si[qj wh[su ic[uo
益都真教寺	yi[bm du[te vf[uj jn[tw si[tc
伊兒汗國	yi[rx er[pv hj[dg go[ww
伊兒汗歷	yi[rx er[pv hj[dg li[il
易夫裡特	yi[ob fu[er li[ot te[nt
伊赫什德王朝	yi[rx he[tt uf[ru de[ru wh[su ic[uo
伊合瓦尼	yi[rx he[rh wa[hv ni[ub
意見派	yi[lx jm[ke pd[dp
意見註釋	yi[lx jm[ke vu[dd ui[py
伊賴姆	yi[rx ld[hd mu[nm
易勒雅斯	yi[ob le[gl ya[yv si[qj
伊歷	yi[rx li[il
益路	yi[bm lu[zw
伊鑾	yi[rx lr[yj
伊瑪目	yi[rx ma[wm mu[we
伊瑪目代理人	yi[rx ma[wm mu[we dd[rq li[wo rf[pd
伊瑪目反對者	yi[rx ma[wm mu[we fj[py dv[yc ve[to
伊瑪目教義	yi[rx ma[wm mu[we jn[tw yi[di
伊瑪目派	yi[rx ma[wm mu[we pd[dp
伊瑪目追隨者	yi[rx ma[wm mu[we vv[pz sv[eu ve[to
伊瑪尼	yi[rx ma[wm ni[ub
儀姆蘭	yi[rd mu[nm lj[bs
伊寧回族大寺	yi[rx nk[gd hv[wk zu[fr da[hr si[tc
伊寧塔塔爾寺	yi[rx nk[gd ta[tc ta[tc er[dx si[tc
伊賽夫	yi[rx sd[gb fu[er
伊沙維教團	yi[rx ua[dx ww[sv jn[tw tr[wc
以石擊斃刑	yi[sr ui[ek ji[fk bi[bh xk[kd
伊斯法罕學派	yi[rx si[qj fa[dt hj[gg xt[xz pd[dp
伊斯哈格	yi[rx si[qj ha[kr ge[aw
易司哈格	yi[ob si[vh ha[kr ge[aw
伊斯哈格派	yi[rx si[qj ha[kr ge[aw pd[dp
伊斯坎達爾	yi[rx si[qj kj[td da[dz er[dx
伊斯拉非來	yi[rx si[qj la[fl fw[su ld[hm
易司拉儀	yi[ob si[vh la[fl yi[rd
伊斯蘭	yi[rx si[qj lj[bs
伊斯蘭促進會	yi[rx si[qj lj[bs cu[rz jb[ez hv[re
伊斯蘭法庭	yi[rx si[qj lj[bs fa[dt tk[gq
伊斯蘭復興	yi[rx si[qj lj[bs fu[ro xk[xb
伊斯蘭共和黨	yi[rx si[qj lj[bs gs[gb he[hk dh[xk
伊斯蘭國家	yi[rx si[qj lj[bs go[ww jx[gu
伊斯蘭教	yi[rx si[qj lj[bs jn[tw
伊斯蘭教法	yi[rx si[qj lj[bs jn[tw fa[dt
伊斯蘭教概論	yi[rx si[qj lj[bs jn[tw gd[ag ly[yr
伊斯蘭教歷	yi[rx si[qj lj[bs jn[tw li[il
伊斯蘭教長老	yi[rx si[qj lj[bs jn[tw vh[ph lc[tb
伊斯蘭教哲學	yi[rx si[qj lj[bs jn[tw ve[fk xt[xz
伊斯蘭金融	yi[rx si[qj lj[bs jb[rw rs[hi
伊斯蘭經濟	yi[rx si[qj lj[bs jk[ss ji[dw
伊斯蘭經濟學	yi[rx si[qj lj[bs jk[ss ji[dw xt[xz
伊斯蘭社會主義	yi[rx si[qj lj[bs ue[ut hv[re vu[dw yi[di
伊斯蘭憲法	yi[rx si[qj lj[bs xm[gn fa[dt
伊斯蘭研究會	yi[rx si[qj lj[bs yj[ek jq[xj hv[re
伊斯蘭政府	yi[rx si[qj lj[bs vg[hw fu[gr
伊斯倆目	yi[rx si[qj lx[rh mu[we
伊斯瑪儀	yi[rx si[qj ma[wm yi[rd
易司馬儀	yi[ob si[vh ma[vv yi[rd
伊斯瑪儀教團	yi[rx si[qj ma[wm yi[rd jn[tw tr[wc
伊斯瑪依萊	yi[rx si[qj ma[wm yi[ry ld[cl
伊斯瑪儀派	yi[rx si[qj ma[wm yi[rd pd[dp
依斯目咱提	yi[ry si[qj mu[we zj[kz ti[fo
伊斯納德	yi[rx si[qj na[sk de[ru
伊斯提哈桑	yi[rx si[qj ti[fo ha[kr sh[ya
伊斯提斯哈伯	yi[rx si[qj ti[fo si[qj ha[kr bo[rb
伊斯提斯拉赫	yi[rx si[qj ti[fo si[qj la[fl he[tt
以體哈德	yi[sr ti[ra ha[kr de[ru
義務遺囑	yi[di wu[wl yi[vz vu[ku
一用學	yi[hh ys[ou xt[xz
意欲	yi[lx yu[bd
遺贈繼承人	yi[vz zg[bb ji[sm ig[lu rf[pd
伊扎布	yi[rx va[fv bu[uj
依札布	yi[ry va[av bu[uj
依札孜	yi[ry va[av zi[zw
易真	yi[ob vf[uj
伊制瑪爾	yi[rx vi[nd ma[wm er[dx
伊智提哈德	yi[rx vi[uo ti[fo ha[kr de[ru
意志自由論	yi[lx vi[ux zi[pm yz[ou ly[yr
遺囑處分法	yi[vz vu[ku iu[wb ff[bd fa[dt
伊茲拉伊來	yi[rx zi[by la[fl yi[rx ld[hm
印巴分治決議	yb[pe ba[ku ff[bd vi[ds jt[dv yi[yd
隱遁教義	yb[ed dy[pz jn[tw yi[di
隱遁井	yb[ed dy[pz jk[ep
隱遁室	yb[ed dy[pz ui[gh
隱遁伊瑪目	yb[ed dy[pz yi[rx ma[wm mu[we
隱遁之門	yb[ed dy[pz vi[dv mf[du
印尼穆斯林黨	yb[pe ni[ub mu[hb si[qj lb[aa dh[xk
印沙安拉	yb[pe ua[dx an[gn la[fl
因善安拉	yb[wd uj[yk an[gn la[fl
隱意	yb[ed yi[lx
引支勒	yb[gu vi[uy le[gl
永樂五年敕諭	ys[dv le[px wu[hu nm[rn ii[hw yu[yr
遊墳	yz[df ff[tw
有經人	yz[uo jk[ss rf[pd
優努斯	yz[ry nu[nl si[qj
優努思出無難	yz[ry nu[nl si[tx iu[ck wu[ee nj[yv
優努斯派	yz[ry nu[nl si[qj pd[dp
優舍阿	yz[ry ue[rg aa[ek
猶太教式註釋	yz[qy td[dd jn[tw ui[qg vu[dd ui[py
油香	yz[dy xl[ho
有效婚姻	yz[uo xn[lw hy[nu yb[nw
餘產	yu[re ij[lp
育人聖道	yu[wo rf[pd ug[yt dc[bz
喻世書信集	yu[kr ui[nv uu[vv xb[ry ji[va
于闐宗教戰爭	yu[eu tm[mu zs[ge jn[tw vj[bg vg[dx
宇宙精神	yu[ge vz[gy jk[mf uf[uo
宇宙靈魂	yu[ge vz[gy lk[xh hy[eg
願安拉回賜你	yr[ix an[gn la[fl hv[wk ci[bo ni[rd
圓頂清真寺	yr[wk dk[dy qk[df vf[uj si[tc
圓經	yr[wk jk[ss
遠親繼承人	yr[ez qb[la ji[sm ig[lu rf[pd
遠寺	yr[ez si[tc
原型界	yr[ib xk[kt jp[tr
約定聘禮	yt[sb dk[gp pb[ey li[uv
樂府集成	yt[px fu[gr ji[va ig[wv
樂府詩集	yt[px fu[gr ui[yt ji[va
月即別汗國	yt[ke ji[ge bp[kd hj[dg go[ww
宰逋爾	zd[gl bu[fz er[dx
再傳弟子	zd[hk ir[re di[bg zi[lh
栽德派	zd[ta de[ru pd[dp
栽德派起義	zd[ta de[ru pd[dp qi[zk yi[di
栽德王朝	zd[ta de[ru wh[su ic[uo
宰卡提	zd[gl ka[ub ti[fo
宰凱里雅	zd[gl kd[uj li[ot ya[yv
宰洛祈福禮	zd[gl lo[dw qi[uj fu[uh li[uv
宰牲	zd[gl ug[np
宰牲節	zd[gl ug[np jp[ce
再世說	zd[hk ui[nv uo[yb
仔雅墩事件	zd[rz ya[yv dy[tw ui[hk jm[rn
贊德王朝	zj[nb de[ru wh[su ic[uo
贊吉起義	zj[nb ji[uk qi[zk yi[di
贊吉王朝	zj[nb ji[uk wh[su ic[uo
贊念	zj[nb nm[rx
讚許性	zj[nb xu[yw xk[xp
贊珠	zj[nb vu[wp
早期教法學派	zc[ou qi[qo jn[tw fa[dt xt[xz pd[dp
贈與人	zg[bb yu[hv rf[pd
扎卡利亞陵墓	va[fv ka[ub li[hd ya[hy lk[et mu[ct
札卡特	va[av ka[ub te[nt
札維亞	va[av ww[sv ya[hy
札希爾學派	va[av xi[iu er[dx xt[xz pd[dp
扎西來	va[fv xi[hk ld[hm
齋功	vd[we gs[gl
齋戒	vd[we jp[gc
翟克賃亞	vd[xv ke[ge lb[rb ya[hy
齋月	vd[we yt[ke
站拱北者	vj[lb gs[fg bw[ub ve[to
佔乃提	vj[bk nd[vp ti[fo
斬首刑	vj[ij uz[be xk[kd
沾沾	vj[db vj[db
戰爭地區	vj[bg vg[dx di[ty qu[ki
掌燈人	vh[xf dg[hd rf[pd
掌教制	vh[xf jn[tw vi[nd
掌學阿訇	vh[xf xt[xz aa[ek hs[by
照明學派	vc[od mk[oo xt[xz pd[dp
罩幕	vc[sb mu[cj
爪哇戰爭	vc[pu wa[kt vj[bg vg[dx
昭微經	vc[od ww[ru jk[ss
昭元祕訣	vc[od yr[ee mi[hx jt[yv
哲布勒伊來	ve[fk bu[uj le[gl yi[rx ld[hm
哲德沙爾汗國	ve[fk de[ru ua[dx er[dx hj[dg go[ww
哲罕南木	ve[fk hj[gg nj[uk mu[ub
哲合林耶	ve[fk he[rh lb[aa ye[ee
哲理大全	ve[fk li[wo da[hr qr[rw
者倆來尼經注	ve[to lx[rh ld[hm ni[ub jk[ss vu[dd
哲麻爾提	ve[fk ma[ga er[dx ti[fo
者那再	ve[to na[ve zd[hk
者那則	ve[to na[ve ze[bd
珍寶集	vf[wr bc[gw ji[va
真賜	vf[uj ci[bo
真功發微	vf[uj gs[gl fa[vy ww[ru
真光閃耀	vf[uj gl[xe uj[mr yc[xx
真教說	vf[uj jn[tw uo[yb
真教寺碑記	vf[uj jn[tw si[tc bw[eb ji[yk
真境花園	vf[uj jk[tl hx[cr yr[we
真理之園	vf[uj li[wo vi[dv yr[we
鎮尼	vf[ju ni[ub
真義探討	vf[uj yi[di tj[fg tc[yc
真忠	vf[uj vs[vx
真主	vf[uj vu[dw
真主回賜	vf[uj vu[dw hv[wk ci[bo
珍珠清真寺	vf[wr vu[wp qk[df vf[uj si[tc
真主世界	vf[uj vu[dw ui[nv jp[tr
正變	vg[hv bm[yy
正朝	vg[hv ic[uo
正道派	vg[hv dc[bz pd[dp
正教理論	vg[hv jn[tw li[wo ly[yr
正教論	vg[hv jn[tw ly[yr
拯救論	vg[fl jq[hw ly[yr
證人信譽	vg[yh rf[pd xb[ry yu[xy
正堂禁碑	vg[hv th[xt jb[ae bw[eb
正統哈里發	vg[hv ts[sw ha[kr li[ot fa[vy
政治論	vg[hw vi[ds ly[yr
治安法庭	vi[ds an[gn fa[dt tk[gq
滯布特	vi[dc bu[uj te[nt
至誠之徵	vi[ht ig[yw vi[dv vg[rh
治坊阿訇	vi[ds fh[tf aa[ek hs[by
知感	vi[uk gj[wx
知感安拉	vi[uk gj[wx an[gn la[fl
智慧館	vi[uo hv[fx gr[ug
直解學派	vi[uj jp[dd xt[xz pd[dp
知認	vi[uk rf[yr
至仁主	vi[ht rf[re vu[dw
止一之光	vi[uh yi[hh vi[dv gl[xe
中阿初婚	vs[ku aa[ek iu[yd hy[nu
中斷期	vs[ku dr[mj qi[qo
中國回教公會	vs[ku go[ww hv[wk jn[tw gs[bs hv[re
中國回教史	vs[ku go[ww hv[wk jn[tw ui[ki
中國回教史鑑	vs[ku go[ww hv[wk jn[tw ui[ki jm[uj
中國回教小史	vs[ku go[ww hv[wk jn[tw xn[ub ui[ki
中國回教協會	vs[ku go[ww hv[wk jn[tw xp[ul hv[re
中國回教學會	vs[ku go[ww hv[wk jn[tw xt[xz hv[re
中華回教公會	vs[ku hx[ru hv[wk jn[tw gs[bs hv[re
週期聖職史	vz[kt qi[qo ug[yt vi[ek ui[ki
朱迭	vu[ph dp[pz
朱乎得忒	vu[ph hu[pb de[ro tw[qx
助勒基福勒	vu[ql le[gl ji[qt fu[uh le[gl
主麻	vu[dw ma[ga
主麻拜	vu[dw ma[ga bd[fh
主麻日	vu[dw ma[ga ri[wh
祝天大讚集解	vu[uk tm[hd da[hr zj[nb ji[va jp[dd
祝延聖壽	vu[uk yj[pj ug[yt uz[fc
朱茲	vu[ph zi[by
轉白拉提	vr[ie bd[po la[fl ti[fo
轉化制	vr[ie hx[rq vi[nd
轉香爐	vr[ie xl[ho lu[hh
酌定刑	vo[yb dk[gp xk[kd
擢升者	vo[fx ug[pc ve[to
榟橔清真大寺	zi[[ dy[[ qk[df vf[uj da[hr si[tc
孜那買克他甫	zi[zw na[ve md[vd ke[ge ta[ry fu[uo
自羊王朝	zi[pm yh[bs wh[su ic[uo
自由思想派	zi[pm yz[ou si[tx xl[ax pd[dp
總傳教師	zs[bx ir[re jn[tw ui[uh
總教法官	zs[bx jn[tw fa[dt gr[gu
宗教軌儀	zs[ge jn[tw gv[ij yi[rd
宗教信仰論	zs[ge jn[tw xb[ry yh[rp ly[yr
宗教原理	zs[ge jn[tw yr[ib li[wo
總信	zs[bx xb[ry
租立格爾乃尼	zu[hq li[lh ge[aw er[dx nd[vp ni[ub
最長妊娠期	zv[oe ih[ph rf[nq uf[ni qi[qo
最短妊娠期	zv[oe dr[ud rf[nq uf[ni qi[qo
遵法派	zy[bz fa[dt pd[dp
遵古教	zy[bz gu[uk jn[tw
左勒蓋爾奈英	zo[ug le[gl gd[bm er[dx nd[de yk[ck
左農	zo[ug ns[gy
作證詞	zo[rv vg[yh ci[yv
