阿巴嘎旗	aa[ek ba[ku ga[ke qi[fr
阿壩縣	aa[ek ba[tb xm[qs
阿壩藏族羌族自治州	aa[ek ba[tb zh[cw zu[fr ql[yv zu[fr zi[pm vi[ds vz[dp
阿城區	aa[ek ig[tw qu[ki
阿爾山市	aa[ek er[dx uj[uk ui[wj
阿合奇縣	aa[ek he[rh qi[dk xm[qs
阿克塞哈薩克族自治縣	aa[ek ke[ge sd[gt ha[kr sa[ce ke[ge zu[fr zi[pm vi[ds xm[qs
阿克蘇地區	aa[ek ke[ge su[cl di[ty qu[ki
阿克蘇市	aa[ek ke[ge su[cl ui[wj
阿克陶縣	aa[ek ke[ge tc[eb xm[qs
阿拉爾市	aa[ek la[fl er[dx ui[wj
阿拉山口市	aa[ek la[fl uj[uk kz[uv ui[wj
阿拉善盟	aa[ek la[fl uj[yk mg[om
阿拉善右旗	aa[ek la[fl uj[yk yz[uk qi[fr
阿拉善左旗	aa[ek la[fl uj[yk zo[ug qi[fr
阿勒泰地區	aa[ek le[gl td[su di[ty qu[ki
阿勒泰市	aa[ek le[gl td[su ui[wj
阿里地區	aa[ek li[ot di[ty qu[ki
阿魯科爾沁旗	aa[ek lu[yo ke[hd er[dx qb[dx qi[fr
阿榮旗	aa[ek rs[ca qi[fr
阿圖什市	aa[ek tu[ww ui[ru ui[wj
阿瓦提縣	aa[ek wa[hv ti[fo xm[qs
愛輝區	ai[au hv[xg qu[ki
愛民區	ai[au mb[kv qu[ki
安次區	an[gn ci[dd qu[ki
安達市	an[gn da[dz ui[wj
安定區	an[gn dk[gp qu[ki
安多縣	an[gn do[xx xm[qs
安福縣	an[gn fu[uh xm[qs
安國市	an[gn go[ww ui[wj
安化縣	an[gn hx[rq xm[qs
安徽省	an[gn hv[ru ug[xm
安吉縣	an[gn ji[uk xm[qs
安居區	an[gn ju[ug qu[ki
安康市	an[gn kh[gx ui[wj
安龍縣	an[gn ls[yp xm[qs
安陸市	an[gn lu[ef ui[wj
安寧區	an[gn nk[gd qu[ki
安寧市	an[gn nk[gd ui[wj
安平縣	an[gn pk[hb xm[qs
安慶市	an[gn qk[gd ui[wj
安丘市	an[gn qq[jh ui[wj
安仁縣	an[gn rf[re xm[qs
安塞區	an[gn sd[gt qu[ki
鞍山市	an[gg uj[uk ui[wj
安順市	an[gn uy[iy ui[wj
安圖縣	an[gn tu[ww xm[qs
安溪縣	an[gn xi[da xm[qs
安鄉縣	an[gn xl[sp xm[qs
安新縣	an[gn xb[lj xm[qs
安陽市	an[gn yh[eo ui[wj
安陽縣	an[gn yh[eo xm[qs
安義縣	an[gn yi[di xm[qs
安源區	an[gn yr[di qu[ki
安遠縣	an[gn yr[ez xm[qs
安嶽縣	an[gn yt[qu xm[qs
安澤縣	an[gn ze[dy xm[qs
安州區	an[gn vz[dp qu[ki
昂昂溪區	ah[op ah[op xi[da qu[ki
昂仁縣	ah[op rf[re xm[qs
敖漢旗	ao[fw hj[dy qi[fr
澳門特別行政區	ao[dp mf[du te[nt bp[kd xk[rh vg[hw qu[ki
八步區	ba[pd bu[vu qu[ki
巴楚縣	ba[ku iu[ap xm[qs
巴東縣	ba[ku ds[qx xm[qs
八公山區	ba[pd gs[bs uj[uk qu[ki
巴裡坤哈薩克自治縣	ba[ku li[ot ky[to ha[kr sa[ce ke[ge zi[pm vi[ds xm[qs
巴林右旗	ba[ku lb[aa yz[uk qi[fr
巴林左旗	ba[ku lb[aa zo[ug qi[fr
巴馬瑤族自治縣	ba[ku ma[vv yc[wa zu[fr zi[pm vi[ds xm[qs
巴南區	ba[ku nj[uk qu[ki
灞橋區	ba[dy qn[ap qu[ki
巴青縣	ba[ku qk[fo xm[qs
八宿縣	ba[pd su[gr xm[qs
巴塘縣	ba[ku th[tg xm[qs
巴彥淖爾市	ba[ku yj[lp nc[db er[dx ui[wj
巴彥縣	ba[ku yj[lp xm[qs
巴宜區	ba[ku yi[gq qu[ki
巴音郭楞蒙古自治州	ba[ku yb[lo go[we lg[as mg[ch gu[uk zi[pm vi[ds vz[dp
鮁魚圈區	ba[yu yu[dt qr[wb qu[ki
巴中市	ba[ku vs[ku ui[wj
巴州區	ba[ku vz[dp qu[ki
霸州市	ba[yg vz[dp ui[wj
白城市	bd[po ig[tw ui[wj
拜城縣	bd[fh ig[tw xm[qs
白河縣	bd[po he[dk xm[qs
白鹼灘區	bd[po jm[ew tj[dy qu[ki
白朗縣	bd[po lh[lo xm[qs
拜泉縣	bd[fh qr[bu xm[qs
百色市	bd[eo se[db ui[wj
白沙黎族自治縣	bd[po ua[dx li[hr zu[fr zi[pm vi[ds xm[qs
白山市	bd[po uj[uk ui[wj
白水縣	bd[po uv[uu xm[qs
白塔區	bd[po ta[tc qu[ki
柏鄉縣	bd[ab xl[sp xm[qs
白銀區	bd[po yb[jg qu[ki
白銀市	bd[po yb[jg ui[wj
白玉縣	bd[po yu[wd xm[qs
白雲鄂博礦區	bd[po yy[es ee[ke bo[uf kl[eg qu[ki
白雲區	bd[po yy[es qu[ki
班戈縣	bj[wd ge[qp xm[qs
班瑪縣	bj[wd ma[wm xm[qs
寶安區	bc[gw an[gn qu[ki
保德縣	bc[rk de[ru xm[qs
寶坻區	bc[gw di[tu qu[ki
保定市	bc[rk dk[gp ui[wj
寶豐縣	bc[gw fg[su xm[qs
包河區	bc[bk he[dk qu[ki
寶雞市	bc[gw ji[yn ui[wj
保靖縣	bc[rk jk[lf xm[qs
保康縣	bc[rk kh[gx xm[qs
寶清縣	bc[gw qk[df xm[qs
寶山區	bc[gw uj[uk qu[ki
保山市	bc[rk uj[uk ui[wj
寶塔區	bc[gw ta[tc qu[ki
保亭黎族苗族自治縣	bc[rk tk[wd li[hr zu[fr mn[ct zu[fr zi[pm vi[ds xm[qs
包頭市	bc[bk tz[dd ui[wj
寶興縣	bc[gw xk[xb xm[qs
寶應縣	bc[gw yk[gx xm[qs
北安市	bw[ub an[gn ui[wj
北碚區	bw[ub bw[el qu[ki
北辰區	bw[ub if[ie qu[ki
北川羌族自治縣	bw[ub ir[pu ql[yv zu[fr zi[pm vi[ds xm[qs
北戴河區	bw[ub dd[tt he[dk qu[ki
北關區	bw[ub gr[bt qu[ki
北海市	bw[ub hd[dr ui[wj
北湖區	bw[ub hu[dg qu[ki
北京市	bw[ub jk[wk ui[wj
北林區	bw[ub lb[aa qu[ki
碑林區	bw[eb lb[aa qu[ki
北流市	bw[ub lq[dw ui[wj
北侖區	bw[ub ly[rb qu[ki
北票市	bw[ub pn[xe ui[wj
北塔區	bw[ub ta[tc qu[ki
北屯市	bw[ub ty[hk ui[wj
北鎮市	bw[ub vf[ju ui[wj
本溪滿族自治縣	bf[ah xi[da mj[dc zu[fr zi[pm vi[ds xm[qs
本溪市	bf[ah xi[da ui[wj
蚌埠市	bg[if bu[tp ui[wj
蚌山區	bg[if uj[uk qu[ki
碧江區	bi[we jl[dg qu[ki
畢節市	bi[bu jp[ce ui[wj
比如縣	bi[bb ru[nk xm[qs
璧山區	bi[uw uj[uk qu[ki
泌陽縣	bi[dx yh[eo xm[qs
邊壩縣	bm[lz ba[tb xm[qs
濱城區	bb[dg ig[tw qu[ki
賓川縣	bb[gq ir[pu xm[qs
濱海縣	bb[dg hd[dr xm[qs
濱海新區	bb[dg hd[dr xb[lj qu[ki
濱湖區	bb[dg hu[dg qu[ki
濱江區	bb[dg jl[dg qu[ki
賓縣	bb[gq xm[qs
賓陽縣	bb[gq yh[eo xm[qs
彬州市	bb[aa vz[dp ui[wj
濱州市	bb[dg vz[dp ui[wj
博愛縣	bo[uf ai[au xm[qs
博白縣	bo[uf bd[po xm[qs
博爾塔拉蒙古自治州	bo[uf er[dx ta[tc la[fl mg[ch gu[uk zi[pm vi[ds vz[dp
博湖縣	bo[uf hu[dg xm[qs
博樂市	bo[uf le[px ui[wj
勃利縣	bo[ul li[hd xm[qs
博羅縣	bo[uf lo[sx xm[qs
波密縣	bo[dp mi[gu xm[qs
博山區	bo[uf uj[uk qu[ki
泊頭市	bo[db tz[dd ui[wj
博望區	bo[uf wh[ww qu[ki
博興縣	bo[uf xk[xb xm[qs
博野縣	bo[uf ye[oy xm[qs
播州區	bo[fp vz[dp qu[ki
亳州市	bo[wp vz[dp ui[wj
布爾津縣	bu[uj er[dx jb[dy xm[qs
布拖縣	bu[uj to[fr xm[qs
蔡甸區	cd[cx dm[bt qu[ki
蒼南縣	ch[cr nj[uk xm[qs
倉山區	ch[re uj[uk qu[ki
蒼梧縣	ch[cr wu[aw xm[qs
蒼溪縣	ch[cr xi[da xm[qs
滄縣	ch[dr xm[qs
滄源佤族自治縣	ch[dr yr[di wa[rw zu[fr zi[pm vi[ds xm[qs
滄州市	ch[dr vz[dp ui[wj
曹妃甸區	cc[ho fw[nk dm[bt qu[ki
曹縣	cc[ho xm[qs
冊亨縣	ce[kk hg[wl xm[qs
策勒縣	ce[vc le[gl xm[qs
岑鞏縣	cf[ur gs[gj xm[qs
岑溪市	cf[ur xi[da ui[wj
察布查爾錫伯自治縣	ia[gx bu[uj ia[ao er[dx xi[jo bo[rb zi[pm vi[ds xm[qs
察哈爾右翼後旗	ia[gx ha[kr er[dx yz[uk yi[xt hz[pk qi[fr
察哈爾右翼前旗	ia[gx ha[kr er[dx yz[uk yi[xt qm[bo qi[fr
察哈爾右翼中旗	ia[gx ha[kr er[dx yz[uk yi[xt vs[ku qi[fr
茶陵縣	ia[cr lk[et xm[qs
察雅縣	ia[gx ya[yv xm[qs
察隅縣	ia[gx yu[eo xm[qs
柴桑區	id[va sh[ya qu[ki
禪城區	ij[ub ig[tw qu[ki
瀍河回族區	ij[dg he[dk hv[wk zu[fr qu[ki
長安區	ih[ph an[gn qu[ki
長白朝鮮族自治縣	ih[ph bd[po ic[uo xm[yy zu[fr zi[pm vi[ds xm[qs
長春市	ih[ph iy[so ui[wj
常德市	ih[xk de[ru ui[wj
昌都市	ih[oo du[te ui[wj
長豐縣	ih[ph fg[su xm[qs
長葛市	ih[ph ge[co ui[wj
長海縣	ih[ph hd[dr xm[qs
昌吉回族自治州	ih[oo ji[uk hv[wk zu[fr zi[pm vi[ds vz[dp
昌吉市	ih[oo ji[uk ui[wj
昌江黎族自治縣	ih[oo jl[dg li[hr zu[fr zi[pm vi[ds xm[qs
昌江區	ih[oo jl[dg qu[ki
長樂區	ih[ph le[px qu[ki
昌樂縣	ih[oo le[px xm[qs
昌黎縣	ih[oo li[hr xm[qs
長嶺縣	ih[ph lk[ur xm[qs
長寧區	ih[ph nk[gd qu[ki
常寧市	ih[xk nk[gd ui[wj
昌寧縣	ih[oo nk[gd xm[qs
長寧縣	ih[ph nk[gd xm[qs
昌平區	ih[oo pk[hb qu[ki
長清區	ih[ph qk[df qu[ki
長沙市	ih[ph ua[dx ui[wj
長沙縣	ih[ph ua[dx xm[qs
常山縣	ih[xk uj[uk xm[qs
長壽區	ih[ph uz[fc qu[ki
常熟市	ih[xk uu[wd ui[wj
長順縣	ih[ph uy[iy xm[qs
長泰縣	ih[ph td[su xm[qs
長汀縣	ih[ph tk[dd xm[qs
昌圖縣	ih[oo tu[ww xm[qs
長武縣	ih[ph wu[hv xm[qs
長興縣	ih[ph xk[xb xm[qs
長陽土家族自治縣	ih[ph yh[eo tu[uh jx[gu zu[fr zi[pm vi[ds xm[qs
昌邑區	ih[oo yi[kb qu[ki
昌邑市	ih[oo yi[kb ui[wj
長垣市	ih[ph yr[th ui[wj
長治市	ih[ph vi[ds ui[wj
長洲區	ih[ph vz[dd qu[ki
常州市	ih[xk vz[dp ui[wj
潮安區	ic[du an[gn qu[ki
巢湖市	ic[vo hu[dg ui[wj
潮南區	ic[du nj[uk qu[ki
朝天區	ic[uo tm[hd qu[ki
朝陽區	ic[uo yh[eo qu[ki
潮陽區	ic[du yh[eo qu[ki
朝陽市	ic[uo yh[eo ui[wj
朝陽縣	ic[uo yh[eo xm[qs
潮州市	ic[du vz[dp ui[wj
陳巴爾虎旗	if[eq ba[ku er[dx hu[hj qi[fr
陳倉區	if[eq ch[re qu[ki
辰溪縣	if[ie xi[da xm[qs
郴州市	if[ae vz[dp ui[wj
成安縣	ig[wv an[gn xm[qs
城北區	ig[tw bw[ub qu[ki
城步苗族自治縣	ig[tw bu[vu mn[ct zu[fr zi[pm vi[ds xm[qs
澄城縣	ig[dd ig[tw xm[qs
承德市	ig[lu de[ru ui[wj
承德縣	ig[lu de[ru xm[qs
城東區	ig[tw ds[qx qu[ki
成都市	ig[wv du[te ui[wj
稱多縣	ig[hd do[xx xm[qs
呈貢區	ig[kw gs[gb qu[ki
城固縣	ig[tw gu[wg xm[qs
城關區	ig[tw gr[bt qu[ki
澄海區	ig[dd hd[dr qu[ki
成華區	ig[wv hx[ru qu[ki
澄江市	ig[dd jl[dg ui[wj
城口縣	ig[tw kz[uv xm[qs
澄邁縣	ig[dd md[wz xm[qs
城區	ig[tw qu[ki
成武縣	ig[wv wu[hv xm[qs
城西區	ig[tw xi[hk qu[ki
成縣	ig[wv xm[qs
城廂區	ig[tw xl[ia qu[ki
城陽區	ig[tw yh[eo qu[ki
城中區	ig[tw vs[ku qu[ki
城子河區	ig[tw zi[lh he[dk qu[ki
赤壁市	ii[ty bi[ut ui[wj
赤城縣	ii[ty ig[tw xm[qs
赤峰市	ii[ty fg[uw ui[wj
赤坎區	ii[ty kj[td qu[ki
茌平區	ii[cr pk[hb qu[ki
赤水市	ii[ty uv[uu ui[wj
池州市	ii[dy vz[dp ui[wj
崇川區	is[ug ir[pu qu[ki
崇禮區	is[ug li[uv qu[ki
崇明區	is[ug mk[oo qu[ki
重慶市	is[ph qk[gd ui[wj
崇仁縣	is[ug rf[re xm[qs
崇信縣	is[ug xb[ry xm[qs
崇陽縣	is[ug yh[eo xm[qs
崇義縣	is[ug yi[di xm[qs
崇州市	is[ug vz[dp ui[wj
崇左市	is[ug zo[ug ui[wj
楚雄市	iu[ap xs[uv ui[wj
楚雄彝族自治州	iu[ap xs[uv yi[vm zu[fr zi[pm vi[ds vz[dp
滁州市	iu[de vz[dp ui[wj
川匯區	ir[pu hv[dk qu[ki
船山區	ir[vj uj[uk qu[ki
船營區	ir[vj yk[ck qu[ki
淳安縣	iy[dw an[gn xm[qs
淳化縣	iy[dw hx[rq xm[qs
慈利縣	ci[bx li[hd xm[qs
慈溪市	ci[bx xi[da ui[wj
磁縣	ci[eb xm[qs
從化區	cs[rr hx[rq qu[ki
從江縣	cs[rr jl[dg xm[qs
叢臺區	cs[rh td[sk qu[ki
翠屏區	cv[xw pk[ub qu[ki
措美縣	co[fg mw[bw xm[qs
錯那縣	co[jg na[ve xm[qs
措勤縣	co[fg qb[nl xm[qs
大安區	da[hr an[gn qu[ki
大安市	da[hr an[gn ui[wj
達坂城區	da[dz bj[tp ig[tw qu[ki
大埔縣	da[hr bu[tf xm[qs
大廠回族自治縣	da[hr ih[hp hv[wk zu[fr zi[pm vi[ds xm[qs
大城縣	da[hr ig[tw xm[qs
達川區	da[dz ir[pu qu[ki
大東區	da[hr ds[qx qu[ki
大渡口區	da[hr du[dg kz[uv qu[ki
達爾罕茂明安聯合旗	da[dz er[dx hj[gg mc[cw mk[oo an[gn lm[eb he[rh qi[fr
大方縣	da[hr fh[dw xm[qs
大豐區	da[hr fg[su qu[ki
大觀區	da[hr gr[yj qu[ki
大關縣	da[hr gr[bt xm[qs
大化瑤族自治縣	da[hr hx[rq yc[wa zu[fr zi[pm vi[ds xm[qs
大箐山縣	da[hr jk[vf uj[uk xm[qs
達拉特旗	da[dz la[fl te[nt qi[fr
大理白族自治州	da[hr li[wo bd[po zu[fr zi[pm vi[ds vz[dp
大理市	da[hr li[wo ui[wj
大荔縣	da[hr li[cl xm[qs
大連市	da[hr lm[iz ui[wj
大名縣	da[hr mk[xk xm[qs
大寧縣	da[hr nk[gd xm[qs
大慶市	da[hr qk[gd ui[wj
達日縣	da[dz ri[wh xm[qs
大石橋市	da[hr ui[ek qn[ap ui[wj
大田縣	da[hr tm[wu xm[qs
大通回族土族自治縣	da[hr ts[sz hv[wk zu[fr tu[uh zu[fr zi[pm vi[ds xm[qs
大同區	da[hr ts[kh qu[ki
大通區	da[hr ts[sz qu[ki
大同市	da[hr ts[kh ui[wj
大窪區	da[hr wa[dt qu[ki
大武口區	da[hr wu[hv kz[uv qu[ki
大悟縣	da[hr wu[xw xm[qs
大祥區	da[hr xl[uy qu[ki
大新縣	da[hr xb[lj xm[qs
大興安嶺地區	da[hr xk[xb an[gn lk[ur di[ty qu[ki
大興區	da[hr xk[xb qu[ki
大姚縣	da[hr yc[nv xm[qs
大冶市	da[hr ye[ds ui[wj
大邑縣	da[hr yi[kb xm[qs
大英縣	da[hr yk[ck xm[qs
大餘縣	da[hr yu[re xm[qs
達州市	da[dz vz[dp ui[wj
大竹縣	da[hr vu[rr xm[qs
達孜區	da[dz zi[zw qu[ki
大足區	da[hr zu[kv qu[ki
岱山縣	dd[ru uj[uk xm[qs
代縣	dd[rq xm[qs
岱嶽區	dd[ru yt[qu qu[ki
丹巴縣	dj[kw ba[ku xm[qs
鄲城縣	dj[be ig[tw xm[qs
丹東市	dj[kw ds[qx ui[wj
丹鳳縣	dj[kw fg[jy xm[qs
丹江口市	dj[kw jl[dg kz[uv ui[wj
丹稜縣	dj[kw lk[at xm[qs
丹徒區	dj[kw tu[rz qu[ki
丹陽市	dj[kw yh[eo ui[wj
丹寨縣	dj[kw vd[ga xm[qs
儋州市	dj[rd vz[dp ui[wj
宕昌縣	dh[ge ih[oo xm[qs
碭山縣	dh[ev uj[uk xm[qs
當塗縣	dh[xx tu[dr xm[qs
當雄縣	dh[xx xs[uv xm[qs
當陽市	dh[xx yh[eo ui[wj
稻城縣	dc[ha ig[tw xm[qs
道孚縣	dc[bz fu[az xm[qs
道里區	dc[bz li[ot qu[ki
道外區	dc[bz wd[xb qu[ki
道縣	dc[bz xm[qs
道真仡佬族苗族自治縣	dc[bz vf[uj ge[rr lc[rt zu[fr mn[ct zu[fr zi[pm vi[ds xm[qs
德安縣	de[ru an[gn xm[qs
德保縣	de[ru bc[rk xm[qs
德昌縣	de[ru ih[oo xm[qs
德城區	de[ru ig[tw qu[ki
德格縣	de[ru ge[aw xm[qs
德宏傣族景頗族自治州	de[ru hs[gu dd[rs zu[fr jk[ow po[py zu[fr zi[pm vi[ds vz[dp
德化縣	de[ru hx[rq xm[qs
德惠市	de[ru hv[hx ui[wj
德江縣	de[ru jl[dg xm[qs
德令哈市	de[ru lk[rd ha[kr ui[wj
德欽縣	de[ru qb[jd xm[qs
德慶縣	de[ru qk[gd xm[qs
德清縣	de[ru qk[df xm[qs
得榮縣	de[ro rs[ca xm[qs
德興市	de[ru xk[xb ui[wj
德陽市	de[ru yh[eo ui[wj
德州市	de[ru vz[dp ui[wj
登封市	dg[dd fg[tc ui[wj
磴口縣	dg[ed kz[uv xm[qs
燈塔市	dg[hd ta[tc ui[wj
鄧州市	dg[ye vz[dp ui[wj
滴道區	di[dl dc[bz qu[ki
迪慶藏族自治州	di[yz qk[gd zh[cw zu[fr zi[pm vi[ds vz[dp
電白區	dm[ov bd[po qu[ki
墊江縣	dm[ft jl[dg xm[qs
點軍區	dm[bd jy[gi qu[ki
調兵山市	dn[yk bk[qb uj[uk ui[wj
迭部縣	dp[pz bu[le xm[qs
疊彩區	dp[yq cd[ap qu[ki
定安縣	dk[gp an[gn xm[qs
定邊縣	dk[gp bm[lz xm[qs
鼎城區	dk[mv ig[tw qu[ki
定海區	dk[gp hd[dr qu[ki
鼎湖區	dk[mv hu[dg qu[ki
定結縣	dk[gp jp[su xm[qs
定南縣	dk[gp nj[uk xm[qs
丁青縣	dk[hu qk[fo xm[qs
定日縣	dk[gp ri[wh xm[qs
定陶區	dk[gp tc[eb qu[ki
定西市	dk[gp xi[hk ui[wj
定襄縣	dk[gp xl[wk xm[qs
定興縣	dk[gp xk[xb xm[qs
定遠縣	dk[gp yr[ez xm[qs
定州市	dk[gp vz[dp ui[wj
東安區	ds[qx an[gn qu[ki
東安縣	ds[qx an[gn xm[qs
東寶區	ds[qx bc[gw qu[ki
東昌府區	ds[qx ih[oo fu[gr qu[ki
東昌區	ds[qx ih[oo qu[ki
東城區	ds[qx ig[tw qu[ki
東川區	ds[qx ir[pu qu[ki
東阿縣	ds[qx ee[ek xm[qs
東方市	ds[qx fh[dw ui[wj
東風區	ds[qx fg[ji qu[ki
東豐縣	ds[qx fg[su xm[qs
東港區	ds[qx gh[dg qu[ki
東港市	ds[qx gh[dg ui[wj
東莞市	ds[qx gr[cg ui[wj
東光縣	ds[qx gl[xe xm[qs
東海縣	ds[qx hd[dr xm[qs
東河區	ds[qx he[dk qu[ki
東湖區	ds[qx hu[dg qu[ki
洞口縣	ds[dk kz[uv xm[qs
東蘭縣	ds[qx lj[bs xm[qs
東麗區	ds[qx li[hk qu[ki
東遼縣	ds[qx ln[lz xm[qs
東明縣	ds[qx mk[oo xm[qs
東寧市	ds[qx nk[gd ui[wj
東平縣	ds[qx pk[hb xm[qs
東坡區	ds[qx po[tp qu[ki
東區	ds[qx qu[ki
東山區	ds[qx uj[uk qu[ki
東山縣	ds[qx uj[uk xm[qs
東勝區	ds[qx ug[op qu[ki
東臺市	ds[qx td[sk ui[wj
洞頭區	ds[dk tz[dd qu[ki
東烏珠穆沁旗	ds[qx wu[bv vu[wp mu[hb qb[dx qi[fr
東西湖區	ds[qx xi[hk hu[dg qu[ki
東鄉區	ds[qx xl[sp qu[ki
東鄉族自治縣	ds[qx xl[sp zu[fr zi[pm vi[ds xm[qs
東興區	ds[qx xk[xb qu[ki
東興市	ds[qx xk[xb ui[wj
東陽市	ds[qx yh[eo ui[wj
東營區	ds[qx yk[ck qu[ki
東營市	ds[qx yk[ck ui[wj
東源縣	ds[qx yr[di xm[qs
東至縣	ds[qx vi[ht xm[qs
東洲區	ds[qx vz[dd qu[ki
都安瑤族自治縣	dz[te an[gn yc[wa zu[fr zi[pm vi[ds xm[qs
斗門區	dz[du mf[du qu[ki
都昌縣	du[te ih[oo xm[qs
杜爾伯特蒙古族自治縣	du[at er[dx bo[rb te[nt mg[ch gu[uk zu[fr zi[pm vi[ds xm[qs
杜集區	du[at ji[va qu[ki
都江堰市	du[te jl[dg yj[tk ui[wj
都蘭縣	du[te lj[bs xm[qs
獨山縣	du[qi uj[uk xm[qs
獨山子區	du[qi uj[uk zi[lh qu[ki
都勻市	du[te yy[bd ui[wj
端州區	dr[lu vz[dp qu[ki
堆龍德慶區	dv[tv ls[yp de[ru qk[gd qu[ki
敦化市	dy[ww hx[rq ui[wj
敦煌市	dy[ww hl[hb ui[wj
掇刀區	do[fy dc[vp qu[ki
多倫縣	do[xx ly[rr xm[qs
峨邊彝族自治縣	ee[up bm[lz yi[vm zu[fr zi[pm vi[ds xm[qs
鄂城區	ee[ke ig[tw qu[ki
鄂爾多斯市	ee[ke er[dx do[xx si[qj ui[wj
額爾古納市	ee[gy er[dx gu[uk na[sk ui[wj
額濟納旗	ee[gy ji[dw na[sk qi[fr
鄂倫春自治旗	ee[ke ly[rr iy[so zi[pm vi[ds qi[fr
峨眉山市	ee[up mw[mm uj[uk ui[wj
額敏縣	ee[gy mb[rw xm[qs
峨山彝族自治縣	ee[up uj[uk yi[vm zu[fr zi[pm vi[ds xm[qs
鄂托克旗	ee[ke to[fp ke[ge qi[fr
鄂托克前旗	ee[ke to[fp ke[ge qm[bo qi[fr
鄂溫克族自治旗	ee[ke wf[do ke[ge zu[fr zi[pm vi[ds qi[fr
鄂州市	ee[ke vz[dp ui[wj
恩平市	en[wx pk[hb ui[wj
恩施市	en[wx ui[fr ui[wj
恩施土家族苗族自治州	en[wx ui[fr tu[uh jx[gu zu[fr mn[ct zu[fr zi[pm vi[ds vz[dp
恩陽區	en[wx yh[eo qu[ki
二道江區	er[hh dc[bz jl[dg qu[ki
二道區	er[hh dc[bz qu[ki
二連浩特市	er[hh lm[iz hc[dn te[nt ui[wj
二七區	er[hh qi[hv qu[ki
洱源縣	er[de yr[di xm[qs
法庫縣	fa[dt ku[gi xm[qs
繁昌區	fj[ry ih[oo qu[ki
樊城區	fj[ad ig[tw qu[ki
繁峙縣	fj[ry ui[ut xm[qs
範縣	fj[cd xm[qs
防城港市	fh[ef ig[tw gh[dg ui[wj
防城區	fh[ef ig[tw qu[ki
方城縣	fh[dw ig[tw xm[qs
房山區	fh[hf uj[uk qu[ki
方山縣	fh[dw uj[uk xm[qs
房縣	fh[hf xm[qs
方正縣	fh[dw vg[hv xm[qs
坊子區	fh[tf zi[lh qu[ki
肥城市	fw[ob ig[tw ui[wj
肥東縣	fw[ob ds[qx xm[qs
肥西縣	fw[ob xi[hk xm[qs
費縣	fw[fb xm[qs
肥鄉區	fw[ob xl[sp qu[ki
汾西縣	ff[df xi[hk xm[qs
汾陽市	ff[df yh[eo ui[wj
分宜縣	ff[bd yi[gq xm[qs
豐城市	fg[su ig[tw ui[wj
鳳城市	fg[jy ig[tw ui[wj
豐都縣	fg[su du[te xm[qs
峰峰礦區	fg[uw fg[uw kl[eg qu[ki
鳳岡縣	fg[jy gh[ki xm[qs
奉化區	fg[sf hx[rq qu[ki
鳳凰縣	fg[jy hl[jb xm[qs
奉節縣	fg[sf jp[ce xm[qs
封開縣	fg[tc kd[hc xm[qs
豐林縣	fg[su lb[aa xm[qs
豐滿區	fg[su mj[dc qu[ki
豐南區	fg[su nj[uk qu[ki
豐寧滿族自治縣	fg[su nk[gd mj[dc zu[fr zi[pm vi[ds xm[qs
鳳慶縣	fg[jy qk[gd xm[qs
封丘縣	fg[tc qq[jh xm[qs
鳳泉區	fg[jy qr[bu qu[ki
豐潤區	fg[su ry[dm qu[ki
鳳山縣	fg[jy uj[uk xm[qs
豐順縣	fg[su uy[iy xm[qs
豐臺區	fg[su td[sk qu[ki
鳳臺縣	fg[jy td[sk xm[qs
豐縣	fg[su xm[qs
鳳縣	fg[jy xm[qs
奉賢區	fg[sf xm[ub qu[ki
鳳翔縣	fg[jy xl[yx xm[qs
奉新縣	fg[sf xb[lj xm[qs
鳳陽縣	fg[jy yh[eo xm[qs
豐澤區	fg[su ze[dy qu[ki
豐鎮市	fg[su vf[ju ui[wj
佛岡縣	fo[rf gh[ki xm[qs
佛坪縣	fo[rf pk[tp xm[qs
佛山市	fo[rf uj[uk ui[wj
福安市	fu[uh an[gn ui[wj
涪城區	fu[dl ig[tw qu[ki
阜城縣	fu[pu ig[tw xm[qs
富川瑤族自治縣	fu[gh ir[pu yc[wa zu[fr zi[pm vi[ds xm[qs
福鼎市	fu[uh dk[mv ui[wj
扶風縣	fu[fe fg[ji xm[qs
福貢縣	fu[uh gs[gb xm[qs
扶溝縣	fu[fe gz[db xm[qs
府谷縣	fu[gr gu[bk xm[qs
福海縣	fu[uh hd[dr xm[qs
福建省	fu[uh jm[yj ug[xm
富錦市	fu[gh jb[jb ui[wj
阜康市	fu[pu kh[gx ui[wj
富拉爾基區	fu[gh la[fl er[dx ji[qt qu[ki
浮樑縣	fu[da ll[da xm[qs
涪陵區	fu[dl lk[et qu[ki
福綿區	fu[uh mm[sb qu[ki
富民縣	fu[gh mb[kv xm[qs
阜南縣	fu[pu nj[uk xm[qs
撫寧區	fu[fe nk[gd qu[ki
富寧縣	fu[gh nk[gd xm[qs
阜寧縣	fu[pu nk[gd xm[qs
富平縣	fu[gh pk[hb xm[qs
阜平縣	fu[pu pk[hb xm[qs
福清市	fu[uh qk[df ui[wj
福泉市	fu[uh qr[bu ui[wj
芙蓉區	fu[ce rs[cx qu[ki
福山區	fu[uh uj[uk qu[ki
浮山縣	fu[da uj[uk xm[qs
撫順市	fu[fe uy[iy ui[wj
富順縣	fu[gh uy[iy xm[qs
撫順縣	fu[fe uy[iy xm[qs
撫松縣	fu[fe ss[ab xm[qs
扶綏縣	fu[fe sv[sa xm[qs
福田區	fu[uh tm[wu qu[ki
富縣	fu[gh xm[qs
阜新蒙古族自治縣	fu[pu xb[lj mg[ch gu[uk zu[fr zi[pm vi[ds xm[qs
阜新市	fu[pu xb[lj ui[wj
復興區	fu[ro xk[xb qu[ki
富陽區	fu[gh yh[eo qu[ki
阜陽市	fu[pu yh[eo ui[wj
扶余市	fu[fe yu[re ui[wj
富裕縣	fu[gh yu[yb xm[qs
撫遠市	fu[fe yr[ez ui[wj
富源縣	fu[gh yr[di xm[qs
富蘊縣	fu[gh yy[cs xm[qs
撫州市	fu[fe vz[dp ui[wj
福州市	fu[uh vz[dp ui[wj
噶爾縣	ga[kc er[dx xm[qs
改則縣	gd[kw ze[bd xm[qs
蓋州市	gd[bm vz[dp ui[wj
甘德縣	gj[nh de[ru xm[qs
甘谷縣	gj[nh gu[bk xm[qs
甘井子區	gj[nh jk[ep zi[lh qu[ki
甘洛縣	gj[nh lo[dw xm[qs
甘南縣	gj[nh nj[uk xm[qs
甘南藏族自治州	gj[nh nj[uk zh[cw zu[fr zi[pm vi[ds vz[dp
甘泉縣	gj[nh qr[bu xm[qs
甘肅省	gj[nh su[xu ug[xm
贛縣區	gj[lw xm[qs qu[ki
贛榆區	gj[lw yu[ar qu[ki
甘州區	gj[nh vz[dp qu[ki
贛州市	gj[lw vz[dp ui[wj
甘孜縣	gj[nh zi[zw xm[qs
甘孜藏族自治州	gj[nh zi[zw zh[cw zu[fr zi[pm vi[ds vz[dp
崗巴縣	gh[uk ba[ku xm[qs
港北區	gh[dg bw[ub qu[ki
剛察縣	gh[kd ia[gx xm[qs
鋼城區	gh[jk ig[tw qu[ki
港口區	gh[dg kz[uv qu[ki
港南區	gh[dg nj[uk qu[ki
高安市	gc[wk an[gn ui[wj
高碑店市	gc[wk bw[eb dm[gb ui[wj
高昌區	gc[wk ih[oo qu[ki
藁城區	gc[ca ig[tw qu[ki
高淳區	gc[wk iy[dw qu[ki
高港區	gc[wk gh[dg qu[ki
皋蘭縣	gc[bd lj[bs xm[qs
高陵區	gc[wk lk[et qu[ki
高密市	gc[wk mi[gu ui[wj
高明區	gc[wk mk[oo qu[ki
高坪區	gc[wk pk[tp qu[ki
高平市	gc[wk pk[hb ui[wj
高青縣	gc[wk qk[fo xm[qs
高臺縣	gc[wk td[sk xm[qs
高唐縣	gc[wk th[gx xm[qs
高縣	gc[wk xm[qs
高陽縣	gc[wk yh[eo xm[qs
高要區	gc[wk yc[xn qu[ki
高邑縣	gc[wk yi[kb xm[qs
高郵市	gc[wk yz[ye ui[wj
高州市	gc[wk vz[dp ui[wj
格爾木市	ge[aw er[dx mu[ub ui[wj
革吉縣	ge[nk ji[uk xm[qs
箇舊市	ge[ru jq[uo ui[wj
根河市	gf[ag he[dk ui[wj
耿馬傣族佤族自治縣	gg[eh ma[vv dd[rs zu[fr wa[rw zu[fr zi[pm vi[ds xm[qs
公安縣	gs[bs an[gn xm[qs
工布江達縣	gs[hu bu[uj jl[dg da[dz xm[qs
弓長嶺區	gs[kv ih[ph lk[ur qu[ki
恭城瑤族自治縣	gs[gx ig[tw yc[wa zu[fr zi[pm vi[ds xm[qs
貢嘎縣	gs[gb ga[ke xm[qs
共和縣	gs[gb he[hk xm[qs
貢井區	gs[gb jk[ep qu[ki
貢覺縣	gs[gb jt[xj xm[qs
鞏留縣	gs[gj lq[pt xm[qs
工農區	gs[hu ns[gy qu[ki
共青城市	gs[gb qk[fo ig[tw ui[wj
貢山獨龍族怒族自治縣	gs[gb uj[uk du[qi ls[yp zu[fr nu[nx zu[fr zi[pm vi[ds xm[qs
拱墅區	gs[fg uu[ot qu[ki
珙縣	gs[wg xm[qs
鞏義市	gs[gj yi[di ui[wj
公主嶺市	gs[bs vu[dw lk[ur ui[wj
固安縣	gu[wg an[gn xm[qs
古城區	gu[uk ig[tw qu[ki
故城縣	gu[gw ig[tw xm[qs
谷城縣	gu[bk ig[tw xm[qs
古交市	gu[uk jn[li ui[wj
古浪縣	gu[uk lh[dl xm[qs
古藺縣	gu[uk lb[cm xm[qs
鼓樓區	gu[uu lz[am qu[ki
固始縣	gu[wg ui[ns xm[qs
姑蘇區	gu[ng su[cl qu[ki
古塔區	gu[uk ta[tc qu[ki
古田縣	gu[uk tm[wu xm[qs
古縣	gu[uk xm[qs
固陽縣	gu[wg yh[eo xm[qs
古冶區	gu[uk ye[ds qu[ki
固原市	gu[wg yr[ib ui[wj
沽源縣	gu[dg yr[di xm[qs
古丈縣	gu[uk vh[hi xm[qs
固鎮縣	gu[wg vf[ju xm[qs
瓜州縣	gx[ps vz[dp xm[qs
管城回族區	gr[vg ig[tw hv[wk zu[fr qu[ki
官渡區	gr[gu du[dg qu[ki
關嶺布依族苗族自治縣	gr[bt lk[ur bu[uj yi[ry zu[fr mn[ct zu[fr zi[pm vi[ds xm[qs
灌南縣	gr[dc nj[uk xm[qs
觀山湖區	gr[yj uj[uk hu[dg qu[ki
館陶縣	gr[ug tc[eb xm[qs
冠縣	gr[ge xm[qs
灌陽縣	gr[dc yh[eo xm[qs
灌雲縣	gr[dc yy[es xm[qs
廣安區	gl[di an[gn qu[ki
廣安市	gl[di an[gn ui[wj
廣昌縣	gl[di ih[oo xm[qs
廣德市	gl[di de[ru ui[wj
廣東省	gl[di ds[qx ug[xm
廣豐區	gl[di fg[su qu[ki
廣漢市	gl[di hj[dy ui[wj
廣河縣	gl[di he[dk xm[qs
廣陵區	gl[di lk[et qu[ki
廣靈縣	gl[di lk[xh xm[qs
光明區	gl[xe mk[oo qu[ki
廣南縣	gl[di nj[uk xm[qs
廣寧縣	gl[di nk[gd xm[qs
廣平縣	gl[di pk[hb xm[qs
廣饒縣	gl[di rc[uq xm[qs
光山縣	gl[xe uj[uk xm[qs
廣水市	gl[di uv[uu ui[wj
廣西壯族自治區	gl[di xi[hk vl[du zu[fr zi[pm vi[ds qu[ki
廣信區	gl[di xb[ry qu[ki
廣陽區	gl[di yh[eo qu[ki
廣元市	gl[di yr[ee ui[wj
光澤縣	gl[xe ze[dy xm[qs
廣州市	gl[di vz[dp ui[wj
廣宗縣	gl[di zs[ge xm[qs
貴池區	gv[vb ii[dy qu[ki
貴德縣	gv[vb de[ru xm[qs
貴定縣	gv[vb dk[gp xm[qs
桂東縣	gv[at ds[qx xm[qs
貴港市	gv[vb gh[dg ui[wj
桂林市	gv[at lb[aa ui[wj
貴南縣	gv[vb nj[uk xm[qs
桂平市	gv[at pk[hb ui[wj
貴溪市	gv[vb xi[da ui[wj
貴陽市	gv[vb yh[eo ui[wj
桂陽縣	gv[at yh[eo xm[qs
貴州省	gv[vb vz[dp ug[xm
果洛藏族自治州	go[oa lo[dw zh[cw zu[fr zi[pm vi[ds vz[dp
渦陽縣	go[dk yh[eo xm[qs
哈巴河縣	ha[kr ba[ku he[dk xm[qs
哈爾濱市	ha[kr er[dx bb[dg ui[wj
哈密市	ha[kr mi[gu ui[wj
海安市	hd[dr an[gn ui[wj
海北藏族自治州	hd[dr bw[ub zh[cw zu[fr zi[pm vi[ds vz[dp
海勃灣區	hd[dr bo[ul wj[dy qu[ki
海滄區	hd[dr ch[dr qu[ki
海城區	hd[dr ig[tw qu[ki
海城市	hd[dr ig[tw ui[wj
海淀區	hd[dr dm[dg qu[ki
海東市	hd[dr ds[qx ui[wj
海豐縣	hd[dr fg[su xm[qs
海港區	hd[dr gh[dg qu[ki
海口市	hd[dr kz[uv ui[wj
海拉爾區	hd[dr la[fl er[dx qu[ki
海林市	hd[dr lb[aa ui[wj
海陵區	hd[dr lk[et qu[ki
海倫市	hd[dr ly[rr ui[wj
海門區	hd[dr mf[du qu[ki
海南區	hd[dr nj[uk qu[ki
海南省	hd[dr nj[uk ug[xm
海南藏族自治州	hd[dr nj[uk zh[cw zu[fr zi[pm vi[ds vz[dp
海寧市	hd[dr nk[gd ui[wj
海曙區	hd[dr uu[os qu[ki
海棠區	hd[dr th[xa qu[ki
海西蒙古族藏族自治州	hd[dr xi[hk mg[ch gu[uk zu[fr zh[cw zu[fr zi[pm vi[ds vz[dp
海興縣	hd[dr xk[xb xm[qs
海晏縣	hd[dr yj[og xm[qs
海鹽縣	hd[dr yj[tm xm[qs
海陽市	hd[dr yh[eo ui[wj
海原縣	hd[dr yr[ib xm[qs
海州區	hd[dr vz[dp qu[ki
海珠區	hd[dr vu[wp qu[ki
漢濱區	hj[dy bb[dg qu[ki
韓城市	hj[uw ig[tw ui[wj
漢川市	hj[dy ir[pu ui[wj
邯鄲市	hj[ge dj[be ui[wj
涵江區	hj[dl jl[dg qu[ki
邗江區	hj[ge jl[dg qu[ki
漢南區	hj[dy nj[uk qu[ki
邯山區	hj[ge uj[uk qu[ki
含山縣	hj[rk uj[uk xm[qs
漢壽縣	hj[dy uz[fc xm[qs
漢臺區	hj[dy td[sk qu[ki
寒亭區	hj[gd tk[wd qu[ki
漢陽區	hj[dy yh[eo qu[ki
漢陰縣	hj[dy yb[eo xm[qs
漢源縣	hj[dy yr[di xm[qs
漢中市	hj[dy vs[ku ui[wj
杭錦後旗	hh[aw jb[jb hz[pk qi[fr
杭錦旗	hh[aw jb[jb qi[fr
杭州市	hh[aw vz[dp ui[wj
濠江區	hc[dw jl[dg qu[ki
河北區	he[dk bw[ub qu[ki
河北省	he[dk bw[ub ug[xm
鶴壁市	he[gn bi[ut ui[wj
和布克賽爾蒙古自治縣	he[hk bu[uj ke[ge sd[gb er[dx mg[ch gu[uk zi[pm vi[ds xm[qs
鶴城區	he[gn ig[tw qu[ki
河池市	he[dk ii[dy ui[wj
合川區	he[rh ir[pu qu[ki
河東區	he[dk ds[qx qu[ki
合肥市	he[rh fw[ob ui[wj
鶴峰縣	he[gn fg[uw xm[qs
鶴崗市	he[gn gh[uk ui[wj
河間市	he[dk jm[mo ui[wj
合江縣	he[rh jl[dg xm[qs
河津市	he[dk jb[dy ui[wj
和靜縣	he[hk jk[fd xm[qs
河口區	he[dk kz[uv qu[ki
河口瑤族自治縣	he[dk kz[uv yc[wa zu[fr zi[pm vi[ds xm[qs
賀蘭縣	he[lb lj[bs xm[qs
和林格爾縣	he[hk lb[aa ge[aw er[dx xm[qs
和龍市	he[hk ls[yp ui[wj
河南蒙古族自治縣	he[dk nj[uk mg[ch gu[uk zu[fr zi[pm vi[ds xm[qs
河南省	he[dk nj[uk ug[xm
和平區	he[hk pk[hb qu[ki
和平縣	he[hk pk[hb xm[qs
合浦縣	he[rh pu[df xm[qs
鶴慶縣	he[gn qk[gd xm[qs
河曲縣	he[dk qu[ou xm[qs
赫山區	he[tt uj[uk qu[ki
鶴山區	he[gn uj[uk qu[ki
合山市	he[rh uj[uk ui[wj
鶴山市	he[gn uj[uk ui[wj
合水縣	he[rh uv[uu xm[qs
和順縣	he[hk uy[iy xm[qs
和碩縣	he[hk uo[ey xm[qs
荷塘區	he[cr th[tg qu[ki
和田地區	he[hk tm[wu di[ty qu[ki
和田市	he[hk tm[wu ui[wj
和田縣	he[hk tm[wu xm[qs
河西區	he[dk xi[hk qu[ki
和縣	he[hk xm[qs
合陽縣	he[rh yh[eo xm[qs
河源市	he[dk yr[di ui[wj
菏澤市	he[cd ze[dy ui[wj
赫章縣	he[tt vh[lo xm[qs
和政縣	he[hk vg[hw xm[qs
賀州市	he[lb vz[dp ui[wj
合作市	he[rh zo[rv ui[wj
黑河市	hw[sd he[dk ui[wj
黑龍江省	hw[sd ls[yp jl[dg ug[xm
黑山縣	hw[sd uj[uk xm[qs
黑水縣	hw[sd uv[uu xm[qs
衡東縣	hg[rd ds[qx xm[qs
橫峰縣	hg[ag fg[uw xm[qs
衡南縣	hg[rd nj[uk xm[qs
恆山區	hg[xh uj[uk qu[ki
橫山區	hg[ag uj[uk qu[ki
衡山縣	hg[rd uj[uk xm[qs
衡水市	hg[rd uv[uu ui[wj
橫縣	hg[ag xm[qs
衡陽市	hg[rd yh[eo ui[wj
衡陽縣	hg[rd yh[eo xm[qs
紅安縣	hs[sg an[gn xm[qs
紅崗區	hs[sg gh[uk qu[ki
紅古區	hs[sg gu[uk qu[ki
紅谷灘區	hs[sg gu[bk tj[dy qu[ki
紅河哈尼族彝族自治州	hs[sg he[dk ha[kr ni[ub zu[fr yi[vm zu[fr zi[pm vi[ds vz[dp
紅河縣	hs[sg he[dk xm[qs
洪湖市	hs[dg hu[dg ui[wj
紅花崗區	hs[sg hx[cr gh[uk qu[ki
洪江市	hs[dg jl[dg ui[wj
虹口區	hs[ig kz[uv qu[ki
紅旗區	hs[sg qi[fr qu[ki
紅橋區	hs[sg qn[ap qu[ki
洪山區	hs[dg uj[uk qu[ki
紅山區	hs[sg uj[uk qu[ki
紅寺堡區	hs[sg si[tc bc[rt qu[ki
紅塔區	hs[sg ta[tc qu[ki
洪洞縣	hs[dg ts[dk xm[qs
宏偉區	hs[gu ww[rw qu[ki
洪雅縣	hs[dg ya[yv xm[qs
紅原縣	hs[sg yr[ib xm[qs
洪澤區	hs[dg ze[dy qu[ki
侯馬市	hz[rv ma[vv ui[wj
湖北省	hu[dg bw[ub ug[xm
湖濱區	hu[dg bb[dg qu[ki
壺關縣	hu[uy gr[bt xm[qs
呼和浩特市	hu[kp he[hk hc[dn te[nt ui[wj
湖口縣	hu[dg kz[uv xm[qs
呼蘭區	hu[kp lj[bs qu[ki
湖裡區	hu[dg li[ot qu[ki
虎林市	hu[hj lb[aa ui[wj
葫蘆島市	hu[cg lu[ch dc[nu ui[wj
呼倫貝爾市	hu[kp ly[rr bw[kr er[dx ui[wj
呼瑪縣	hu[kp ma[wm xm[qs
湖南省	hu[dg nj[uk ug[xm
虎丘區	hu[hj qq[jh qu[ki
呼圖壁縣	hu[kp tu[ww bi[ut xm[qs
胡楊河市	hu[go yh[av he[dk ui[wj
鄠邑區	hu[[ yi[kb qu[ki
湖州市	hu[dg vz[dp ui[wj
互助土族自治縣	hu[hv vu[ql tu[uh zu[fr zi[pm vi[ds xm[qs
華安縣	hx[ru an[gn xm[qs
華池縣	hx[ru ii[dy xm[qs
樺川縣	hx[ar ir[pu xm[qs
化德縣	hx[rq de[ru xm[qs
樺甸市	hx[ar dm[bt ui[wj
花都區	hx[cr du[te qu[ki
化隆回族自治縣	hx[rq ls[ew hv[wk zu[fr zi[pm vi[ds xm[qs
華龍區	hx[ru ls[yp qu[ki
樺南縣	hx[ar nj[uk xm[qs
華寧縣	hx[ru nk[gd xm[qs
華坪縣	hx[ru pk[tp xm[qs
華容區	hx[ru rs[xr qu[ki
華容縣	hx[ru rs[xr xm[qs
花山區	hx[cr uj[uk qu[ki
華亭市	hx[ru tk[wd ui[wj
花溪區	hx[cr xi[da qu[ki
滑縣	hx[dg xm[qs
華陰市	hx[ru yb[eo ui[wj
華鎣市	hx[ru yk[cj ui[wj
花垣縣	hx[cr yr[th xm[qs
華州區	hx[ru vz[dp qu[ki
化州市	hx[rq vz[dp ui[wj
淮安區	hk[dv an[gn qu[ki
淮安市	hk[dv an[gn ui[wj
懷安縣	hk[xb an[gn xm[qs
淮北市	hk[dv bw[ub ui[wj
淮濱縣	hk[dv bb[dg xm[qs
懷化市	hk[xb hx[rq ui[wj
懷集縣	hk[xb ji[va xm[qs
懷來縣	hk[xb ld[hm xm[qs
淮南市	hk[dv nj[uk ui[wj
懷寧縣	hk[xb nk[gd xm[qs
懷仁市	hk[xb rf[re ui[wj
懷柔區	hk[xb rz[ya qu[ki
淮上區	hk[dv uh[bh qu[ki
淮陽區	hk[dv yh[eo qu[ki
槐蔭區	hk[ag yb[ce qu[ki
淮陰區	hk[dv yb[eo qu[ki
懷遠縣	hk[xb yr[ez xm[qs
環翠區	hr[wb cv[xw qu[ki
環江毛南族自治縣	hr[wb jl[dg mc[sv nj[uk zu[fr zi[pm vi[ds xm[qs
桓仁滿族自治縣	hr[ah rf[re mj[dc zu[fr zi[pm vi[ds xm[qs
桓臺縣	hr[ah td[sk xm[qs
環縣	hr[wb xm[qs
潢川縣	hl[dg ir[pu xm[qs
黃島區	hl[gy dc[nu qu[ki
黃岡市	hl[gy gh[ki ui[wj
皇姑區	hl[bw gu[ng qu[ki
黃驊市	hl[gy hx[mr ui[wj
黃陵縣	hl[gy lk[et xm[qs
黃龍縣	hl[gy ls[yp xm[qs
黃梅縣	hl[gy mw[ar xm[qs
黃南藏族自治州	hl[gy nj[uk zh[cw zu[fr zi[pm vi[ds vz[dp
黃陂區	hl[gy pi[ep qu[ki
黃平縣	hl[gy pk[hb xm[qs
黃埔區	hl[gy pu[tf qu[ki
黃浦區	hl[gy pu[df qu[ki
黃山區	hl[gy uj[uk qu[ki
黃山市	hl[gy uj[uk ui[wj
黃石港區	hl[gy ui[ek gh[dg qu[ki
黃石市	hl[gy ui[ek ui[wj
黃巖區	hl[gy yj[ue qu[ki
湟源縣	hl[db yr[di xm[qs
湟中區	hl[db vs[ku qu[ki
黃州區	hl[gy vz[dp qu[ki
惠安縣	hv[hx an[gn xm[qs
會昌縣	hv[re ih[oo xm[qs
惠城區	hv[hx ig[tw qu[ki
匯川區	hv[dk ir[pu qu[ki
會東縣	hv[re ds[qx xm[qs
惠東縣	hv[hx ds[qx xm[qs
惠濟區	hv[hx ji[dw qu[ki
惠來縣	hv[hx ld[hm xm[qs
會理縣	hv[re li[wo xm[qs
回民區	hv[wk mb[kv qu[ki
惠民縣	hv[hx mb[kv xm[qs
輝南縣	hv[xg nj[uk xm[qs
會寧縣	hv[re nk[gd xm[qs
惠農區	hv[hx ns[gy qu[ki
惠山區	hv[hx uj[uk qu[ki
惠水縣	hv[hx uv[uu xm[qs
會同縣	hv[re ts[kh xm[qs
徽縣	hv[ru xm[qs
輝縣市	hv[xg xm[qs ui[wj
惠陽區	hv[hx yh[eo qu[ki
會澤縣	hv[re ze[dy xm[qs
徽州區	hv[ru vz[dp qu[ki
惠州市	hv[hx vz[dp ui[wj
琿春市	hy[wg iy[so ui[wj
渾江區	hy[dg jl[dg qu[ki
渾南區	hy[dg nj[uk qu[ki
渾源縣	hy[dg yr[di xm[qs
霍城縣	ho[yv ig[tw xm[qs
霍爾果斯市	ho[yv er[dx go[oa si[qj ui[wj
獲嘉縣	ho[cq jx[ul xm[qs
霍林郭勒市	ho[yv lb[aa go[we le[gl ui[wj
霍邱縣	ho[yv qq[qe xm[qs
霍山縣	ho[yv uj[uk xm[qs
霍州市	ho[yv vz[dp ui[wj
吉安市	ji[uk an[gn ui[wj
集安市	ji[va an[gn ui[wj
吉安縣	ji[uk an[gn xm[qs
雞東縣	ji[yn ds[qx xm[qs
雞冠區	ji[yn gr[ge qu[ki
吉利區	ji[uk li[hd qu[ki
吉林省	ji[uk lb[aa ug[xm
吉林市	ji[uk lb[aa ui[wj
吉隆縣	ji[uk ls[ew xm[qs
集美區	ji[va mw[bw qu[ki
即墨區	ji[ge mo[ht qu[ki
吉木乃縣	ji[uk mu[ub nd[vp xm[qs
吉木薩爾縣	ji[uk mu[ub sa[ce er[dx xm[qs
濟南市	ji[dw nj[uk ui[wj
集寧區	ji[va nk[gd qu[ki
濟寧市	ji[dw nk[gd ui[wj
稷山縣	ji[ht uj[uk xm[qs
吉首市	ji[uk uz[be ui[wj
吉水縣	ji[uk uv[uu xm[qs
雞西市	ji[yn xi[hk ui[wj
績溪縣	ji[sf xi[da xm[qs
吉縣	ji[uk xm[qs
集賢縣	ji[va xm[ub xm[qs
吉陽區	ji[uk yh[eo qu[ki
濟陽區	ji[dw yh[eo qu[ki
濟源市	ji[dw yr[di ui[wj
雞澤縣	ji[yn ze[dy xm[qs
冀州區	ji[bt vz[dp qu[ki
吉州區	ji[uk vz[dp qu[ki
薊州區	ji[cy vz[dp qu[ki
加查縣	jx[lk ia[ao xm[qs
嘉定區	jx[ul dk[gp qu[ki
嘉禾縣	jx[ul he[pa xm[qs
夾江縣	jx[hb jl[dg xm[qs
嘉黎縣	jx[ul li[hr xm[qs
嘉陵區	jx[ul lk[et qu[ki
佳木斯市	jx[rt mu[ub si[qj ui[wj
嘉善縣	jx[ul uj[yk xm[qs
伽師縣	jx[rl ui[uh xm[qs
賈汪區	jx[xb wh[dw qu[ki
佳縣	jx[rt xm[qs
郟縣	jx[je xm[qs
嘉祥縣	jx[ul xl[uy xm[qs
嘉興市	jx[ul xk[xb ui[wj
嘉蔭縣	jx[ul yb[ce xm[qs
嘉峪關市	jx[ul yu[ub gr[bt ui[wj
嘉魚縣	jx[ul yu[dt xm[qs
建安區	jm[yj an[gn qu[ki
尖草坪區	jm[xd cc[co pk[tp qu[ki
建昌縣	jm[yj ih[oo xm[qs
劍川縣	jm[rd ir[pu xm[qs
建德市	jm[yj de[ru ui[wj
劍閣縣	jm[rd ge[mw xm[qs
劍河縣	jm[rd he[dk xm[qs
建湖縣	jm[yj hu[dg xm[qs
建華區	jm[yj hx[ru qu[ki
監利市	jm[um li[hd ui[wj
建寧縣	jm[yj nk[gd xm[qs
建甌市	jm[yj ou[kw ui[wj
建平縣	jm[yj pk[hb xm[qs
尖山區	jm[xd uj[uk qu[ki
建始縣	jm[yj ui[ns xm[qs
建水縣	jm[yj uv[uu xm[qs
澗西區	jm[dm xi[hk qu[ki
建陽區	jm[yj yh[eo qu[ki
簡陽市	jm[vm yh[eo ui[wj
建鄴區	jm[yj ye[ye qu[ki
尖扎縣	jm[xd va[fv xm[qs
江岸區	jl[dg an[ui qu[ki
江安縣	jl[dg an[gn xm[qs
江北區	jl[dg bw[ub qu[ki
江城哈尼族彝族自治縣	jl[dg ig[tw ha[kr ni[ub zu[fr yi[vm zu[fr zi[pm vi[ds xm[qs
江城區	jl[dg ig[tw qu[ki
江川區	jl[dg ir[pu qu[ki
江達縣	jl[dg da[dz xm[qs
江都區	jl[dg du[te qu[ki
江乾區	jl[dg gj[hu qu[ki
江海區	jl[dg hd[dr qu[ki
江漢區	jl[dg hj[dy qu[ki
江華瑤族自治縣	jl[dg hx[ru yc[wa zu[fr zi[pm vi[ds xm[qs
江津區	jl[dg jb[dy qu[ki
江口縣	jl[dg kz[uv xm[qs
將樂縣	jl[dx le[px xm[qs
江陵縣	jl[dg lk[et xm[qs
江門市	jl[dg mf[du ui[wj
江南區	jl[dg nj[uk qu[ki
江寧區	jl[dg nk[gd qu[ki
江山市	jl[dg uj[uk ui[wj
江蘇省	jl[dg su[cl ug[xm
江西省	jl[dg xi[hk ug[xm
江夏區	jl[dg xx[ew qu[ki
絳縣	jl[sw xm[qs
姜堰區	jl[bn yj[tk qu[ki
江陽區	jl[dg yh[eo qu[ki
江陰市	jl[dg yb[eo ui[wj
江永縣	jl[dg ys[dv xm[qs
江油市	jl[dg yz[dy ui[wj
江源區	jl[dg yr[di qu[ki
江州區	jl[dg vz[dp qu[ki
江孜縣	jl[dg zi[zw xm[qs
蕉城區	jn[cv ig[tw qu[ki
交城縣	jn[li ig[tw xm[qs
蛟河市	jn[il he[dk ui[wj
椒江區	jn[au jl[dg qu[ki
交口縣	jn[li kz[uv xm[qs
蕉嶺縣	jn[cv lk[ur xm[qs
郊區	jn[le qu[ki
膠州市	jn[ol vz[dp ui[wj
焦作市	jn[vd zo[rv ui[wj
揭東區	jp[fo ds[qx qu[ki
解放區	jp[dd fh[fw qu[ki
界首市	jp[tr uz[be ui[wj
揭西縣	jp[fo xi[hk xm[qs
介休市	jp[rp xq[ra ui[wj
揭陽市	jp[fo yh[eo ui[wj
晉安區	jb[ho an[gn qu[ki
金安區	jb[rw an[gn qu[ki
金昌市	jb[rw ih[oo ui[wj
金城江區	jb[rw ig[tw jl[dg qu[ki
晉城市	jb[ho ig[tw ui[wj
金川區	jb[rw ir[pu qu[ki
金川縣	jb[rw ir[pu xm[qs
金東區	jb[rw ds[qx qu[ki
金鳳區	jb[rw fg[jy qu[ki
金湖縣	jb[rw hu[dg xm[qs
金華市	jb[rw hx[ru ui[wj
錦江區	jb[jb jl[dg qu[ki
晉江市	jb[ho jl[dg ui[wj
金口河區	jb[rw kz[uv he[dk qu[ki
金林區	jb[rw lb[aa qu[ki
金門縣	jb[rw mf[du xm[qs
津南區	jb[dy nj[uk qu[ki
晉寧區	jb[ho nk[gd qu[ki
金牛區	jb[rw nq[pf qu[ki
金平苗族瑤族傣族自治縣	jb[rw pk[hb mn[ct zu[fr yc[wa zu[fr dd[rs zu[fr zi[pm vi[ds xm[qs
金平區	jb[rw pk[hb qu[ki
錦屏縣	jb[jb pk[ub xm[qs
金沙縣	jb[rw ua[dx xm[qs
金山區	jb[rw uj[uk qu[ki
津市市	jb[dy ui[wj ui[wj
金水區	jb[rw uv[uu qu[ki
金塔縣	jb[rw ta[tc xm[qs
金臺區	jb[rw td[sk qu[ki
金壇區	jb[rw tj[te qu[ki
金堂縣	jb[rw th[xt xm[qs
金灣區	jb[rw wj[dy qu[ki
金溪縣	jb[rw xi[da xm[qs
進賢縣	jb[ez xm[ub xm[qs
金鄉縣	jb[rw xl[sp xm[qs
金秀瑤族自治縣	jb[rw xq[hn yc[wa zu[fr zi[pm vi[ds xm[qs
金陽縣	jb[rw yh[eo xm[qs
晉源區	jb[ho yr[di qu[ki
縉雲縣	jb[sh yy[es xm[qs
金寨縣	jb[rw vd[ga xm[qs
晉中市	jb[ho vs[ku ui[wj
金州區	jb[rw vz[dp qu[ki
晉州市	jb[ho vz[dp ui[wj
錦州市	jb[jb vz[dp ui[wj
靜安區	jk[fd an[gn qu[ki
靖安縣	jk[lf an[gn xm[qs
靖邊縣	jk[lf bm[lz xm[qs
涇川縣	jk[ds ir[pu xm[qs
旌德縣	jk[fr de[ru xm[qs
景德鎮市	jk[ow de[ru vf[ju ui[wj
景東彝族自治縣	jk[ow ds[qx yi[vm zu[fr zi[pm vi[ds xm[qs
井岡山市	jk[ep gh[ki uj[uk ui[wj
景谷傣族彝族自治縣	jk[ow gu[bk dd[rs zu[fr yi[vm zu[fr zi[pm vi[ds xm[qs
靜海區	jk[fd hd[dr qu[ki
精河縣	jk[mf he[dk xm[qs
景洪市	jk[ow hs[dg ui[wj
鏡湖區	jk[jl hu[dg qu[ki
靖江市	jk[lf jl[dg ui[wj
京口區	jk[wk kz[uv qu[ki
靜樂縣	jk[fd le[px xm[qs
荊門市	jk[cd mf[du ui[wj
景寧畲族自治縣	jk[ow nk[gd ue[rt zu[fr zi[pm vi[ds xm[qs
靜寧縣	jk[fd nk[gd xm[qs
京山市	jk[wk uj[uk ui[wj
景泰縣	jk[ow td[su xm[qs
靖西市	jk[lf xi[hk ui[wj
景縣	jk[ow xm[qs
涇縣	jk[ds xm[qs
井陘礦區	jk[ep xk[es kl[eg qu[ki
井陘縣	jk[ep xk[es xm[qs
競秀區	jk[lk xq[hn qu[ki
井研縣	jk[ep yj[ek xm[qs
旌陽區	jk[fr yh[eo qu[ki
涇陽縣	jk[ds yh[eo xm[qs
靖宇縣	jk[lf yu[ge xm[qs
涇源縣	jk[ds yr[di xm[qs
靖遠縣	jk[lf yr[ez xm[qs
靖州苗族侗族自治縣	jk[lf vz[dp mn[ct zu[fr ds[rk zu[fr zi[pm vi[ds xm[qs
荊州區	jk[cd vz[dp qu[ki
荊州市	jk[cd vz[dp ui[wj
鳩江區	jq[jn jl[dg qu[ki
九江市	jq[pv jl[dg ui[wj
九龍坡區	jq[pv ls[yp po[tp qu[ki
九龍縣	jq[pv ls[yp xm[qs
酒泉市	jq[dy qr[bu ui[wj
九臺區	jq[pv td[sk qu[ki
九原區	jq[pv yr[ib qu[ki
九寨溝縣	jq[pv vd[ga gz[db xm[qs
久治縣	jq[xd vi[ds xm[qs
鉅鹿縣	ju[kk lu[gb xm[qs
莒南縣	ju[ck nj[uk xm[qs
句容市	ju[bk rs[xr ui[wj
莒縣	ju[ck xm[qs
鉅野縣	ju[kk ye[oy xm[qs
鄄城縣	jr[xe ig[tw xm[qs
筠連縣	jy[vt lm[iz xm[qs
君山區	jy[xk uj[uk qu[ki
喀喇沁旗	ka[kg la[kh qb[dx qi[fr
喀喇沁左翼蒙古族自治縣	ka[kg la[kh qb[dx zo[ug yi[xt mg[ch gu[uk zu[fr zi[pm vi[ds xm[qs
卡若區	ka[ub ro[cu qu[ki
喀什地區	ka[kg ui[ru di[ty qu[ki
喀什市	ka[kg ui[ru ui[wj
開封市	kd[hc fg[tc ui[wj
開福區	kd[hc fu[uh qu[ki
開化縣	kd[hc hx[rq xm[qs
開江縣	kd[hc jl[dg xm[qs
凱裡市	kd[uj li[ot ui[wj
開魯縣	kd[hc lu[yo xm[qs
開平區	kd[hc pk[hb qu[ki
開平市	kd[hc pk[hb ui[wj
開陽縣	kd[hc yh[eo xm[qs
開原市	kd[hc yr[ib ui[wj
開遠市	kd[hc yr[ez ui[wj
開州區	kd[hc vz[dp qu[ki
康巴什區	kh[gx ba[ku ui[ru qu[ki
康保縣	kh[gx bc[rk xm[qs
康定市	kh[gx dk[gp ui[wj
康樂縣	kh[gx le[px xm[qs
康馬縣	kh[gx ma[vv xm[qs
康平縣	kh[gx pk[hb xm[qs
康縣	kh[gx xm[qs
柯城區	ke[ak ig[tw qu[ki
克東縣	ke[ge ds[qx xm[qs
科爾沁區	ke[hd er[dx qb[dx qu[ki
科爾沁右翼前旗	ke[hd er[dx qb[dx yz[uk yi[xt qm[bo qi[fr
科爾沁右翼中旗	ke[hd er[dx qb[dx yz[uk yi[xt vs[ku qi[fr
科爾沁左翼後旗	ke[hd er[dx qb[dx zo[ug yi[xt hz[pk qi[fr
科爾沁左翼中旗	ke[hd er[dx qb[dx zo[ug yi[xt vs[ku qi[fr
可克達拉市	ke[dk ke[ge da[dz la[fl ui[wj
克拉瑪依區	ke[ge la[fl ma[wm yi[ry qu[ki
克拉瑪依市	ke[ge la[fl ma[wm yi[ry ui[wj
岢嵐縣	ke[uk lj[uf xm[qs
柯坪縣	ke[ak pk[tp xm[qs
柯橋區	ke[ak qn[ap qu[ki
克山縣	ke[ge uj[uk xm[qs
克什克騰旗	ke[ge ui[ru ke[ge tg[ob qi[fr
克孜勒蘇柯爾克孜自治州	ke[ge zi[zw le[gl su[cl ke[ak er[dx ke[ge zi[zw zi[pm vi[ds vz[dp
墾利區	kf[gt li[hd qu[ki
崆峒區	ks[ux ts[uk qu[ki
庫車市	ku[gi ie[qu ui[wj
庫爾勒市	ku[gi er[dx le[gl ui[wj
庫倫旗	ku[gi ly[rr qi[fr
寬城滿族自治縣	kr[gc ig[tw mj[dc zu[fr zi[pm vi[ds xm[qs
寬城區	kr[gc ig[tw qu[ki
寬甸滿族自治縣	kr[gc dm[bt mj[dc zu[fr zi[pm vi[ds xm[qs
礦區	kl[eg qu[ki
奎屯市	kv[dt ty[hk ui[wj
奎文區	kv[dt wf[wi qu[ki
昆都侖區	ky[ob du[te ly[rb qu[ki
昆明市	ky[ob mk[oo ui[wj
崑山市	ky[ob uj[uk ui[wj
崑玉市	ky[ob yu[wd ui[wj
拉薩市	la[fl sa[ce ui[wj
拉孜縣	la[fl zi[zw xm[qs
來安縣	ld[hm an[gn xm[qs
來賓市	ld[hm bb[gq ui[wj
來鳳縣	ld[hm fg[jy xm[qs
萊山區	ld[cl uj[uk qu[ki
淶水縣	ld[dl uv[uu xm[qs
萊蕪區	ld[cl wu[ce qu[ki
萊西市	ld[cl xi[hk ui[wj
萊陽市	ld[cl yh[eo ui[wj
淶源縣	ld[dl yr[di xm[qs
萊州市	ld[cl vz[dp ui[wj
瀾滄拉祜族自治縣	lj[dm ch[dr la[fl hu[ug zu[fr zi[pm vi[ds xm[qs
嵐皋縣	lj[uf gc[bd xm[qs
蘭考縣	lj[bs kc[tk xm[qs
蘭陵縣	lj[bs lk[et xm[qs
蘭坪白族普米族自治縣	lj[bs pk[tp bd[po zu[fr pu[bo mi[ba zu[fr zi[pm vi[ds xm[qs
蘭山區	lj[bs uj[uk qu[ki
嵐山區	lj[uf uj[uk qu[ki
藍山縣	lj[cu uj[uk xm[qs
藍田縣	lj[cu tm[wu xm[qs
蘭溪市	lj[bs xi[da ui[wj
蘭西縣	lj[bs xi[hk xm[qs
嵐縣	lj[uf xm[qs
蘭州市	lj[bs vz[dp ui[wj
廊坊市	lh[gl fh[tf ui[wj
浪卡子縣	lh[dl ka[ub zi[lh xm[qs
郎溪縣	lh[le xi[da xm[qs
朗縣	lh[lo xm[qs
琅琊區	lh[wl ya[wy qu[ki
閬中市	lh[ml vs[ku ui[wj
老邊區	lc[tb bm[lz qu[ki
老城區	lc[tb ig[tw qu[ki
老河口市	lc[tb he[dk kz[uv ui[wj
嶗山區	lc[uc uj[uk qu[ki
樂亭縣	lc[px tk[wd xm[qs
樂安縣	le[px an[gn xm[qs
樂昌市	le[px ih[oo ui[wj
樂東黎族自治縣	le[px ds[qx li[hr zu[fr zi[pm vi[ds xm[qs
樂都區	le[px du[te qu[ki
樂陵市	le[px lk[et ui[wj
樂平市	le[px pk[hb ui[wj
樂山市	le[px uj[uk ui[wj
樂業縣	le[px ye[ub xm[qs
樂至縣	le[px vi[ht xm[qs
雷波縣	lw[yt bo[dp xm[qs
雷山縣	lw[yt uj[uk xm[qs
類烏齊縣	lw[md wu[bv qi[wp xm[qs
耒陽市	lw[fb yh[eo ui[wj
雷州市	lw[yt vz[dp ui[wj
冷水江市	lg[dr uv[uu jl[dg ui[wj
冷水灘區	lg[dr uv[uu tj[dy qu[ki
荔波縣	li[cl bo[dp xm[qs
李滄區	li[az ch[dr qu[ki
歷城區	li[il ig[tw qu[ki
荔城區	li[cl ig[tw qu[ki
鯉城區	li[yo ig[tw qu[ki
黎城縣	li[hr ig[tw xm[qs
利川市	li[hd ir[pu ui[wj
黎川縣	li[hr ir[pu xm[qs
麗江市	li[hk jl[dg ui[wj
利津縣	li[hd jb[dy xm[qs
醴陵市	li[yq lk[et ui[wj
黎平縣	li[hr pk[hb xm[qs
荔浦市	li[cl pu[df ui[wj
禮泉縣	li[uv qr[bu xm[qs
立山區	li[lh uj[uk qu[ki
離石區	li[wk ui[ek qu[ki
梨樹區	li[ha uu[ay qu[ki
梨樹縣	li[ha uu[ay xm[qs
溧水區	li[dx uv[uu qu[ki
麗水市	li[hk uv[uu ui[wj
理塘縣	li[wo th[tg xm[qs
利通區	li[hd ts[sz qu[ki
荔灣區	li[cl wj[dy qu[ki
歷下區	li[il xx[hb qu[ki
澧縣	li[dq xm[qs
理縣	li[wo xm[qs
禮縣	li[uv xm[qs
蠡縣	li[vi xm[qs
利辛縣	li[hd xb[lu xm[qs
溧陽市	li[dx yh[eo ui[wj
利州區	li[hd vz[dp qu[ki
連城縣	lm[iz ig[tw xm[qs
蓮池區	lm[ci ii[dy qu[ki
蓮都區	lm[ci du[te qu[ki
蓮湖區	lm[ci hu[dg qu[ki
蓮花縣	lm[ci hx[cr xm[qs
廉江市	lm[gb jl[dg ui[wj
連江縣	lm[iz jl[dg xm[qs
連南瑤族自治縣	lm[iz nj[uk yc[wa zu[fr zi[pm vi[ds xm[qs
連平縣	lm[iz pk[hb xm[qs
連山區	lm[iz uj[uk qu[ki
連山壯族瑤族自治縣	lm[iz uj[uk vl[du zu[fr yc[wa zu[fr zi[pm vi[ds xm[qs
漣水縣	lm[di uv[uu xm[qs
濂溪區	lm[dg xi[da qu[ki
漣源市	lm[di yr[di ui[wj
連雲港市	lm[iz yy[es gh[dg ui[wj
連雲區	lm[iz yy[es qu[ki
連州市	lm[iz vz[dp ui[wj
涼城縣	ll[dw ig[tw xm[qs
兩當縣	ll[hk dh[xx xm[qs
梁河縣	ll[da he[dk xm[qs
梁平區	ll[da pk[hb qu[ki
良慶區	ll[dg qk[gd qu[ki
梁山縣	ll[da uj[uk xm[qs
涼山彝族自治州	ll[dw uj[uk yi[vm zu[fr zi[pm vi[ds vz[dp
梁溪區	ll[da xi[da qu[ki
梁園區	ll[da yr[we qu[ki
涼州區	ll[dw vz[dp qu[ki
梁子湖區	ll[da zi[lh hu[dg qu[ki
聊城市	ln[ep ig[tw ui[wj
遼寧省	ln[lz nk[gd ug[xm
遼陽市	ln[lz yh[eo ui[wj
遼陽縣	ln[lz yh[eo xm[qs
遼源市	ln[lz yr[di ui[wj
遼中區	ln[lz vs[ku qu[ki
烈山區	lp[hd uj[uk qu[ki
臨安區	lb[uv an[gn qu[ki
臨滄市	lb[uv ch[dr ui[wj
臨城縣	lb[uv ig[tw xm[qs
臨川區	lb[uv ir[pu qu[ki
林甸縣	lb[aa dm[bt xm[qs
臨汾市	lb[uv ff[df ui[wj
臨高縣	lb[uv gc[wk xm[qs
臨桂區	lb[uv gv[at qu[ki
臨海市	lb[uv hd[dr ui[wj
臨河區	lb[uv he[dk qu[ki
臨江市	lb[uv jl[dg ui[wj
林口縣	lb[aa kz[uv xm[qs
臨澧縣	lb[uv li[dq xm[qs
臨清市	lb[uv qk[df ui[wj
臨朐縣	lb[uv qu[ob xm[qs
臨泉縣	lb[uv qr[bu xm[qs
臨沭縣	lb[uv uu[da xm[qs
鄰水縣	lb[re uv[uu xm[qs
臨潭縣	lb[uv tj[dx xm[qs
臨洮縣	lb[uv tc[dv xm[qs
臨潼區	lb[uv ts[dl qu[ki
臨渭區	lb[uv ww[dt qu[ki
臨武縣	lb[uv wu[hv xm[qs
臨西縣	lb[uv xi[hk xm[qs
林西縣	lb[aa xi[hk xm[qs
臨夏回族自治州	lb[uv xx[ew hv[wk zu[fr zi[pm vi[ds vz[dp
臨夏市	lb[uv xx[ew ui[wj
臨夏縣	lb[uv xx[ew xm[qs
臨縣	lb[uv xm[qs
臨翔區	lb[uv xl[yx qu[ki
臨湘市	lb[uv xl[da ui[wj
臨沂市	lb[uv yi[dj ui[wj
臨猗縣	lb[uv yi[qd xm[qs
臨邑縣	lb[uv yi[kb xm[qs
臨潁縣	lb[uv yk[by xm[qs
麟遊縣	lb[gm yz[df xm[qs
臨澤縣	lb[uv ze[dy xm[qs
臨漳縣	lb[uv vh[dl xm[qs
林芝市	lb[aa vi[cv ui[wj
林州市	lb[aa vz[dp ui[wj
林周縣	lb[aa vz[kt xm[qs
臨淄區	lb[uv zi[dv qu[ki
靈寶市	lk[xh bc[gw ui[wj
靈璧縣	lk[xh bi[uw xm[qs
陵城區	lk[et ig[tw qu[ki
靈川縣	lk[xh ir[pu xm[qs
陵川縣	lk[et ir[pu xm[qs
嶺東區	lk[ur ds[qx qu[ki
凌海市	lk[dt hd[dr ui[wj
淩河區	lk[dt he[dk qu[ki
零陵區	lk[yr lk[et qu[ki
靈丘縣	lk[xh qq[jh xm[qs
靈山縣	lk[xh uj[uk xm[qs
靈石縣	lk[xh ui[ek xm[qs
靈壽縣	lk[xh uz[fc xm[qs
陵水黎族自治縣	lk[et uv[uu li[hr zu[fr zi[pm vi[ds xm[qs
靈臺縣	lk[xh td[sk xm[qs
靈武市	lk[xh wu[hv ui[wj
凌源市	lk[dt yr[di ui[wj
凌雲縣	lk[dt yy[es xm[qs
六安市	lq[wb an[gn ui[wj
留壩縣	lq[pt ba[tb xm[qs
柳北區	lq[ap bw[ub qu[ki
柳城縣	lq[ap ig[tw xm[qs
六合區	lq[wb he[rh qu[ki
柳河縣	lq[ap he[dk xm[qs
柳江區	lq[ap jl[dg qu[ki
柳林縣	lq[ap lb[aa xm[qs
柳南區	lq[ap nj[uk qu[ki
六盤水市	lq[wb pj[vm uv[uu ui[wj
瀏陽市	lq[dw yh[eo ui[wj
六枝特區	lq[wb vi[au te[nt qu[ki
柳州市	lq[ap vz[dp ui[wj
龍安區	ls[yp an[gn qu[ki
隆安縣	ls[ew an[gn xm[qs
隆昌市	ls[ew ih[oo ui[wj
龍城區	ls[yp ig[tw qu[ki
隴川縣	ls[ey ir[pu xm[qs
龍川縣	ls[yp ir[pu xm[qs
隆德縣	ls[ew de[ru xm[qs
龍鳳區	ls[yp fg[jy qu[ki
龍崗區	ls[yp gh[uk qu[ki
龍港區	ls[yp gh[dg qu[ki
龍港市	ls[yp gh[dg ui[wj
龍海市	ls[yp hd[dr ui[wj
龍湖區	ls[yp hu[dg qu[ki
龍華區	ls[yp hx[ru qu[ki
隆化縣	ls[ew hx[rq xm[qs
隆回縣	ls[ew hv[wk xm[qs
龍江縣	ls[yp jl[dg xm[qs
龍井市	ls[yp jk[ep ui[wj
龍口市	ls[yp kz[uv ui[wj
龍里縣	ls[yp li[ot xm[qs
隆林各族自治縣	ls[ew lb[aa ge[wk zu[fr zi[pm vi[ds xm[qs
龍陵縣	ls[yp lk[et xm[qs
龍馬潭區	ls[yp ma[vv tj[dx qu[ki
龍門縣	ls[yp mf[du xm[qs
隴南市	ls[ey nj[uk ui[wj
龍南市	ls[yp nj[uk ui[wj
龍泉市	ls[yp qr[bu ui[wj
龍泉驛區	ls[yp qr[bu yi[my qu[ki
龍沙區	ls[yp ua[dx qu[ki
龍山區	ls[yp uj[uk qu[ki
龍山縣	ls[yp uj[uk xm[qs
龍勝各族自治縣	ls[yp ug[op ge[wk zu[fr zi[pm vi[ds xm[qs
龍潭區	ls[yp tj[dx qu[ki
龍亭區	ls[yp tk[wd qu[ki
龍灣區	ls[yp wj[dy qu[ki
龍文區	ls[yp wf[wi qu[ki
隴西縣	ls[ey xi[hk xm[qs
隴縣	ls[ey xm[qs
龍圩區	ls[yp xu[te qu[ki
龍巖市	ls[yp yj[ue ui[wj
隆陽區	ls[ew yh[eo qu[ki
隆堯縣	ls[ew yc[qh xm[qs
龍游縣	ls[yp yz[df xm[qs
龍州縣	ls[yp vz[dp xm[qs
龍子湖區	ls[yp zi[lh hu[dg qu[ki
隆子縣	ls[ew zi[lh xm[qs
婁底市	lz[mn di[gu ui[wj
婁煩縣	lz[mn fj[hy xm[qs
婁星區	lz[mn xk[op qu[ki
路北區	lu[zw bw[ub qu[ki
潞城區	lu[dz ig[tw qu[ki
鹿城區	lu[gb ig[tw qu[ki
陸川縣	lu[ef ir[pu xm[qs
魯甸縣	lu[yo dm[bt xm[qs
瀘定縣	lu[db dk[gp xm[qs
陸豐市	lu[ef fg[su ui[wj
祿豐縣	lu[ux fg[su xm[qs
陸河縣	lu[ef he[dk xm[qs
爐霍縣	lu[hh ho[yv xm[qs
廬江縣	lu[gh jl[dg xm[qs
淥口區	lu[dx kz[uv qu[ki
陸良縣	lu[ef ll[dg xm[qs
盧龍縣	lu[bu ls[yp xm[qs
路南區	lu[zw nj[uk qu[ki
路橋區	lu[zw qn[ap qu[ki
碌曲縣	lu[ex qu[ou xm[qs
鹿泉區	lu[gb qr[bu qu[ki
祿勸彝族苗族自治縣	lu[ux qr[yl yi[vm zu[fr mn[ct zu[fr zi[pm vi[ds xm[qs
廬山市	lu[gh uj[uk ui[wj
蘆山縣	lu[ch uj[uk xm[qs
魯山縣	lu[yo uj[uk xm[qs
盧氏縣	lu[bu ui[pq xm[qs
瀘水市	lu[db uv[uu ui[wj
蘆淞區	lu[ch ss[da qu[ki
瀘溪縣	lu[db xi[da xm[qs
瀘西縣	lu[db xi[hk xm[qs
蘆溪縣	lu[ch xi[da xm[qs
瀘縣	lu[db xm[qs
廬陽區	lu[gh yh[eo qu[ki
鹿邑縣	lu[gb yi[kb xm[qs
鹿寨縣	lu[gb vd[ga xm[qs
潞州區	lu[dz vz[dp qu[ki
瀘州市	lu[db vz[dp ui[wj
欒城區	lr[ya ig[tw qu[ki
欒川縣	lr[ya ir[pu xm[qs
灤南縣	lr[dy nj[uk xm[qs
灤平縣	lr[dy pk[hb xm[qs
灤州市	lr[dy vz[dp ui[wj
略陽縣	lt[tw yh[eo xm[qs
輪臺縣	ly[ir td[sk xm[qs
蘿北縣	lo[cs bw[ub xm[qs
羅城仫佬族自治縣	lo[sx ig[tw mu[rp lc[rt zu[fr zi[pm vi[ds xm[qs
洛川縣	lo[dw ir[pu xm[qs
羅甸縣	lo[sx dm[bt xm[qs
羅定市	lo[sx dk[gp ui[wj
漯河市	lo[dt he[dk ui[wj
羅湖區	lo[sx hu[dg qu[ki
洛江區	lo[dw jl[dg qu[ki
羅江區	lo[sx jl[dg qu[ki
洛龍區	lo[dw ls[yp qu[ki
洛隆縣	lo[dw ls[ew xm[qs
洛南縣	lo[dw nj[uk xm[qs
洛寧縣	lo[dw nk[gd xm[qs
羅平縣	lo[sx pk[hb xm[qs
洛浦縣	lo[dw pu[df xm[qs
羅山縣	lo[sx uj[uk xm[qs
羅田縣	lo[sx tm[wu xm[qs
洛陽市	lo[dw yh[eo ui[wj
羅源縣	lo[sx yr[di xm[qs
洛扎縣	lo[dw va[fv xm[qs
羅莊區	lo[sx vl[gt qu[ki
綠春縣	lv[sx iy[so xm[qs
呂梁市	lv[kk ll[da ui[wj
旅順口區	lv[fr uy[iy kz[uv qu[ki
綠園區	lv[sx yr[we qu[ki
馬鞍山市	ma[vv an[gg uj[uk ui[wj
馬邊彝族自治縣	ma[vv bm[lz yi[vm zu[fr zi[pm vi[ds xm[qs
麻城市	ma[ga ig[tw ui[wj
馬村區	ma[vv cy[ac qu[ki
瑪多縣	ma[wm do[xx xm[qs
馬爾康市	ma[vv er[dx kh[gx ui[wj
馬關縣	ma[vv gr[bt xm[qs
麻江縣	ma[ga jl[dg xm[qs
麻栗坡縣	ma[ga li[xa po[tp xm[qs
馬龍區	ma[vv ls[yp qu[ki
瑪納斯縣	ma[wm na[sk si[qj xm[qs
瑪沁縣	ma[wm qb[dx xm[qs
瑪曲縣	ma[wm qu[ou xm[qs
麻山區	ma[ga uj[uk qu[ki
馬山縣	ma[vv uj[uk xm[qs
馬尾區	ma[vv ww[um qu[ki
麻陽苗族自治縣	ma[ga yh[eo mn[ct zu[fr zi[pm vi[ds xm[qs
麻章區	ma[ga vh[lo qu[ki
麥蓋提縣	md[fw gd[bm ti[fo xm[qs
麥積區	md[fw ji[hk qu[ki
滿城區	mj[dc ig[tw qu[ki
滿洲裡市	mj[dc vz[dd li[ot ui[wj
芒康縣	mh[cw kh[gx xm[qs
芒市	mh[cw ui[wj
茫崖市	mh[cd ya[ui ui[wj
茅箭區	mc[cy jm[vb qu[ki
茂名市	mc[cw mk[xk ui[wj
茂南區	mc[cw nj[uk qu[ki
茂縣	mc[cw xm[qs
美姑縣	mw[bw gu[ng xm[qs
梅河口市	mw[ar he[dk kz[uv ui[wj
梅江區	mw[ar jl[dg qu[ki
美蘭區	mw[bw lj[bs qu[ki
梅里斯達斡爾族區	mw[ar li[ot si[qj da[dz wo[ur er[dx zu[fr qu[ki
梅列區	mw[ar lp[hd qu[ki
眉山市	mw[mm uj[uk ui[wj
湄潭縣	mw[dm tj[dx xm[qs
眉縣	mw[mm xm[qs
梅縣區	mw[ar xm[qs qu[ki
梅州市	mw[ar vz[dp ui[wj
門頭溝區	mf[du tz[dd gz[db qu[ki
門源回族自治縣	mf[du yr[di hv[wk zu[fr zi[pm vi[ds xm[qs
蒙城縣	mg[ch ig[tw xm[qs
孟村回族自治縣	mg[zm cy[ac hv[wk zu[fr zi[pm vi[ds xm[qs
勐海縣	mg[zl hd[dr xm[qs
孟津縣	mg[zm jb[dy xm[qs
勐臘縣	mg[zl la[og xm[qs
孟連傣族拉祜族佤族自治縣	mg[zm lm[iz dd[rs zu[fr la[fl hu[ug zu[fr wa[rw zu[fr zi[pm vi[ds xm[qs
蒙山縣	mg[ch uj[uk xm[qs
蒙陰縣	mg[ch yb[eo xm[qs
孟州市	mg[zm vz[dp ui[wj
蒙自市	mg[ch zi[pm ui[wj
米東區	mi[ba ds[qx qu[ki
彌渡縣	mi[gd du[dg xm[qs
彌勒市	mi[gd le[gl ui[wj
米林縣	mi[ba lb[aa xm[qs
汨羅市	mi[do lo[sx ui[wj
密山市	mi[gu uj[uk ui[wj
米易縣	mi[ba yi[ob xm[qs
密雲區	mi[gu yy[es qu[ki
米脂縣	mi[ba vi[ob xm[qs
澠池縣	mm[dk ii[dy xm[qs
冕寧縣	mm[od nk[gd xm[qs
勉縣	mm[dl xm[qs
綿陽市	mm[sb yh[eo ui[wj
綿竹市	mm[sb vu[rr ui[wj
民豐縣	mb[kv fg[su xm[qs
閔行區	mb[mw hh[rh qu[ki
民和回族土族自治縣	mb[kv he[hk hv[wk zu[fr tu[uh zu[fr zi[pm vi[ds xm[qs
閩侯縣	mb[mi hz[rv xm[qs
民樂縣	mb[kv le[px xm[qs
民勤縣	mb[kv qb[nl xm[qs
閩清縣	mb[mi qk[df xm[qs
民權縣	mb[kv qr[ay xm[qs
岷縣	mb[um xm[qs
明光市	mk[oo gl[xe ui[wj
名山區	mk[xk uj[uk qu[ki
明山區	mk[oo uj[uk qu[ki
明水縣	mk[oo uv[uu xm[qs
明溪縣	mk[oo xi[da xm[qs
漠河市	mo[dc he[dk ui[wj
墨江哈尼族自治縣	mo[ht jl[dg ha[kr ni[ub zu[fr zi[pm vi[ds xm[qs
莫力達瓦達斡爾族自治旗	mo[co li[vp da[dz wa[hv da[dz wo[ur er[dx zu[fr zi[pm vi[ds qi[fr
墨脫縣	mo[ht to[ob xm[qs
墨玉縣	mo[ht yu[wd xm[qs
墨竹工卡縣	mo[ht vu[rr gs[hu ka[ub xm[qs
牟定縣	mz[sn dk[gp xm[qs
沐川縣	mu[da ir[pu xm[qs
牡丹江市	mu[nt dj[kw jl[dg ui[wj
牡丹區	mu[nt dj[kw qu[ki
木蘭縣	mu[ub lj[bs xm[qs
木壘哈薩克自治縣	mu[ub lw[st ha[kr sa[ce ke[ge zi[pm vi[ds xm[qs
木裡藏族自治縣	mu[ub li[ot zh[cw zu[fr zi[pm vi[ds xm[qs
穆稜市	mu[hb lk[at ui[wj
牟平區	mu[sn pk[hb qu[ki
牧野區	mu[nw ye[oy qu[ki
那坡縣	na[ve po[tp xm[qs
那曲市	na[ve qu[ou ui[wj
納溪區	na[sk xi[da qu[ki
納雍縣	na[sk ys[ws xm[qs
乃東區	nd[vp ds[qx qu[ki
奈曼旗	nd[de mj[os qi[fr
南岸區	nj[uk an[ui qu[ki
南安市	nj[uk an[gn ui[wj
南澳縣	nj[uk ao[dp xm[qs
南部縣	nj[uk bu[le xm[qs
南岔縣	nj[uk ia[fu xm[qs
南昌市	nj[uk ih[oo ui[wj
南昌縣	nj[uk ih[oo xm[qs
南城縣	nj[uk ig[tw xm[qs
南充市	nj[uk is[we ui[wj
南川區	nj[uk ir[pu qu[ki
南丹縣	nj[uk dj[kw xm[qs
南芬區	nj[uk ff[cf qu[ki
南豐縣	nj[uk fg[su xm[qs
南崗區	nj[uk gh[uk qu[ki
南宮市	nj[uk gs[gk ui[wj
南關區	nj[uk gr[bt qu[ki
南海區	nj[uk hd[dr qu[ki
南和區	nj[uk he[hk qu[ki
南湖區	nj[uk hu[dg qu[ki
南華縣	nj[uk hx[ru xm[qs
南澗彝族自治縣	nj[uk jm[dm yi[vm zu[fr zi[pm vi[ds xm[qs
南江縣	nj[uk jl[dg xm[qs
南京市	nj[uk jk[wk ui[wj
南靖縣	nj[uk jk[lf xm[qs
南開區	nj[uk kd[hc qu[ki
南康區	nj[uk kh[gx qu[ki
南樂縣	nj[uk le[px xm[qs
南陵縣	nj[uk lk[et xm[qs
南明區	nj[uk mk[oo qu[ki
南木林縣	nj[uk mu[ub lb[aa xm[qs
南寧市	nj[uk nk[gd ui[wj
南皮縣	nj[uk pi[vp xm[qs
南票區	nj[uk pn[xe qu[ki
南平市	nj[uk pk[hb ui[wj
南譙區	nj[uk qn[yv qu[ki
南沙區	nj[uk ua[dx qu[ki
南山區	nj[uk uj[uk qu[ki
南通市	nj[uk ts[sz ui[wj
南溪區	nj[uk xi[da qu[ki
南縣	nj[uk xm[qs
南雄市	nj[uk xs[uv ui[wj
南潯區	nj[uk xy[dx qu[ki
南陽市	nj[uk yh[eo ui[wj
南嶽區	nj[uk yt[qu qu[ki
南漳縣	nj[uk vh[dl xm[qs
南召縣	nj[uk vc[dk xm[qs
南鄭區	nj[uk vg[be qu[ki
囊謙縣	nh[hk qm[yb xm[qs
訥河市	ne[yk he[dk ui[wj
內黃縣	nw[kr hl[gy xm[qs
內江市	nw[kr jl[dg ui[wj
內蒙古自治區	nw[kr mg[ch gu[uk zi[pm vi[ds qu[ki
內丘縣	nw[kr qq[jh xm[qs
內鄉縣	nw[kr xl[sp xm[qs
嫩江市	nf[nh jl[dg ui[wj
尼勒克縣	ni[ub le[gl ke[ge xm[qs
尼瑪縣	ni[ub ma[wm xm[qs
尼木縣	ni[ub mu[ub xm[qs
碾子山區	nm[eu zi[lh uj[uk qu[ki
聶拉木縣	np[ey la[fl mu[ub xm[qs
聶榮縣	np[ey rs[ca xm[qs
寧安市	nk[gd an[gn ui[wj
寧波市	nk[gd bo[dp ui[wj
寧城縣	nk[gd ig[tw xm[qs
寧德市	nk[gd de[ru ui[wj
寧都縣	nk[gd du[te xm[qs
寧洱哈尼族彝族自治縣	nk[gd er[de ha[kr ni[ub zu[fr yi[vm zu[fr zi[pm vi[ds xm[qs
寧國市	nk[gd go[ww ui[wj
寧海縣	nk[gd hd[dr xm[qs
寧河區	nk[gd he[dk qu[ki
寧化縣	nk[gd hx[rq xm[qs
寧江區	nk[gd jl[dg qu[ki
寧晉縣	nk[gd jb[ho xm[qs
寧津縣	nk[gd jb[dy xm[qs
寧蒗彝族自治縣	nk[gd lh[cd yi[vm zu[fr zi[pm vi[ds xm[qs
寧陵縣	nk[gd lk[et xm[qs
寧明縣	nk[gd mk[oo xm[qs
寧南縣	nk[gd nj[uk xm[qs
寧強縣	nk[gd ql[gk xm[qs
寧陝縣	nk[gd uj[ej xm[qs
寧武縣	nk[gd wu[hv xm[qs
寧夏回族自治區	nk[gd xx[ew hv[wk zu[fr zi[pm vi[ds qu[ki
寧縣	nk[gd xm[qs
寧鄉市	nk[gd xl[sp ui[wj
寧陽縣	nk[gd yh[eo xm[qs
寧遠縣	nk[gd yr[ez xm[qs
農安縣	ns[gy an[gn xm[qs
怒江傈僳族自治州	nu[nx jl[dg li[rx su[rx zu[fr zi[pm vi[ds vz[dp
甌海區	ou[kw hd[dr qu[ki
磐安縣	pj[ve an[gn xm[qs
潘集區	pj[dp ji[va qu[ki
盤錦市	pj[vm jb[jb ui[wj
盤龍區	pj[vm ls[yp qu[ki
盤山縣	pj[vm uj[uk xm[qs
磐石市	pj[ve ui[ek ui[wj
番禺區	pj[pt yu[ok qu[ki
攀枝花市	pj[ad vi[au hx[cr ui[wj
盤州市	pj[vm vz[dp ui[wj
沛縣	pw[dh xm[qs
蓬安縣	pg[cw an[gn xm[qs
蓬江區	pg[cw jl[dg qu[ki
蓬萊區	pg[cw ld[cl qu[ki
彭山區	pg[up uj[uk qu[ki
彭水苗族土家族自治縣	pg[up uv[uu mn[ct zu[fr tu[uh jx[gu zu[fr zi[pm vi[ds xm[qs
蓬溪縣	pg[cw xi[da xm[qs
彭陽縣	pg[up yh[eo xm[qs
彭澤縣	pg[up ze[dy xm[qs
彭州市	pg[up vz[dp ui[wj
郫都區	pi[be dz[te qu[ki
皮山縣	pi[vp uj[uk xm[qs
邳州市	pi[be vz[dp ui[wj
偏關縣	pm[rh gr[bt xm[qs
平安區	pk[hb an[gn qu[ki
平壩區	pk[hb ba[tb qu[ki
屏邊苗族自治縣	pk[ub bm[lz mn[ct zu[fr zi[pm vi[ds xm[qs
平昌縣	pk[hb ih[oo xm[qs
平城區	pk[hb ig[tw qu[ki
平川區	pk[hb ir[pu qu[ki
平頂山市	pk[hb dk[dy uj[uk ui[wj
平定縣	pk[hb dk[gp xm[qs
平度市	pk[hb du[gn ui[wj
平房區	pk[hb fh[hf qu[ki
平谷區	pk[hb gu[bk qu[ki
平桂區	pk[hb gv[at qu[ki
平果市	pk[hb go[oa ui[wj
平和縣	pk[hb he[hk xm[qs
平湖市	pk[hb hu[dg ui[wj
平江縣	pk[hb jl[dg xm[qs
平樂縣	pk[hb le[px xm[qs
平利縣	pk[hb li[hd xm[qs
平涼市	pk[hb ll[dw ui[wj
平魯區	pk[hb lu[yo qu[ki
平陸縣	pk[hb lu[ef xm[qs
平羅縣	pk[hb lo[sx xm[qs
屏南縣	pk[ub nj[uk xm[qs
平南縣	pk[hb nj[uk xm[qs
平橋區	pk[hb qn[ap qu[ki
平泉市	pk[hb qr[bu ui[wj
坪山區	pk[tp uj[uk qu[ki
平山區	pk[hb uj[uk qu[ki
屏山縣	pk[ub uj[uk xm[qs
平山縣	pk[hb uj[uk xm[qs
平順縣	pk[hb uy[iy xm[qs
平潭縣	pk[hb tj[dx xm[qs
平塘縣	pk[hb th[tg xm[qs
平武縣	pk[hb wu[hv xm[qs
憑祥市	pk[rj xl[uy ui[wj
萍鄉市	pk[cd xl[sp ui[wj
平鄉縣	pk[hb xl[sp xm[qs
平陽縣	pk[hb yh[eo xm[qs
平遙縣	pk[hb yc[az xm[qs
平邑縣	pk[hb yi[kb xm[qs
平陰縣	pk[hb yb[eo xm[qs
平輿縣	pk[hb yu[pb xm[qs
平原縣	pk[hb yr[ib xm[qs
平遠縣	pk[hb yr[ez xm[qs
坡頭區	po[tp tz[dd qu[ki
鄱陽縣	po[pe yh[eo xm[qs
普安縣	pu[bo an[gn xm[qs
浦北縣	pu[df bw[ub xm[qs
浦城縣	pu[df ig[tw xm[qs
蒲城縣	pu[cd ig[tw xm[qs
普定縣	pu[bo dk[gp xm[qs
浦東新區	pu[df ds[qx xb[lj qu[ki
普洱市	pu[bo er[de ui[wj
普格縣	pu[bo ge[aw xm[qs
浦江縣	pu[df jl[dg xm[qs
蒲江縣	pu[cd jl[dg xm[qs
浦口區	pu[df kz[uv qu[ki
普蘭店區	pu[bo lj[bs dm[gb qu[ki
普蘭縣	pu[bo lj[bs xm[qs
普寧市	pu[bo nk[gd ui[wj
莆田市	pu[cf tm[wu ui[wj
普陀區	pu[bo to[eg qu[ki
蒲縣	pu[cd xm[qs
濮陽市	pu[dr yh[eo ui[wj
濮陽縣	pu[dr yh[eo xm[qs
淇濱區	qi[dq bb[dg qu[ki
蘄春縣	qi[cb iy[so xm[qs
啟東市	qi[hk ds[qx ui[wj
祁東縣	qi[ue ds[qx xm[qs
齊河縣	qi[wp he[dk xm[qs
綦江區	qi[qy jl[dg qu[ki
七里河區	qi[hv li[ot he[dk qu[ki
祁連縣	qi[ue lm[iz xm[qs
麒麟區	qi[gq lb[gm qu[ki
祁門縣	qi[ue mf[du xm[qs
齊齊哈爾市	qi[wp qi[wp ha[kr er[dx ui[wj
岐山縣	qi[uu uj[uk xm[qs
七臺河市	qi[hv td[sk he[dk ui[wj
奇臺縣	qi[dk td[sk xm[qs
棲霞區	qi[ax xx[yk qu[ki
棲霞市	qi[ax xx[yk ui[wj
杞縣	qi[ak xm[qs
淇縣	qi[dq xm[qs
祁縣	qi[ue xm[qs
七星關區	qi[hv xk[op gr[bt qu[ki
七星區	qi[hv xk[op qu[ki
祁陽縣	qi[ue yh[eo xm[qs
遷安市	qm[qz an[gn ui[wj
乾安縣	qm[ur an[gn xm[qs
黔東南苗族侗族自治州	qm[hr ds[qx nj[uk mn[ct zu[fr ds[rk zu[fr zi[pm vi[ds vz[dp
前鋒區	qm[bo fg[jw qu[ki
前郭爾羅斯蒙古族自治縣	qm[bo go[we er[dx lo[sx si[qj mg[ch gu[uk zu[fr zi[pm vi[ds xm[qs
黔江區	qm[hr jl[dg qu[ki
潛江市	qm[de jl[dg ui[wj
前進區	qm[bo jb[ez qu[ki
黔南布依族苗族自治州	qm[hr nj[uk bu[uj yi[ry zu[fr mn[ct zu[fr zi[pm vi[ds vz[dp
千山區	qm[pu uj[uk qu[ki
潛山市	qm[de uj[uk ui[wj
犍為縣	qm[ny ww[dl xm[qs
黔西南布依族苗族自治州	qm[hr xi[hk nj[uk bu[uj yi[ry zu[fr mn[ct zu[fr zi[pm vi[ds vz[dp
遷西縣	qm[qz xi[hk xm[qs
黔西縣	qm[hr xi[hk xm[qs
乾縣	qm[ur xm[qs
千陽縣	qm[pu yh[eo xm[qs
譙城區	qn[yv ig[tw qu[ki
橋東區	qn[ap ds[qx qu[ki
巧家縣	qn[gk jx[gu xm[qs
礄口區	qn[ep kz[uv qu[ki
橋西區	qn[ap xi[hk qu[ki
且末縣	qp[ke mo[ha xm[qs
茄子河區	qp[cl zi[lh he[dk qu[ki
秦安縣	qb[sh an[gn xm[qs
欽北區	qb[jd bw[ub qu[ki
秦都區	qb[sh du[te qu[ki
秦淮區	qb[sh hk[dv qu[ki
秦皇島市	qb[sh hl[bw dc[nu ui[wj
欽南區	qb[jd nj[uk qu[ki
沁水縣	qb[dx uv[uu xm[qs
覃塘區	qb[xo th[tg qu[ki
沁縣	qb[dx xm[qs
沁陽市	qb[dx yh[eo ui[wj
沁源縣	qb[dx yr[di xm[qs
秦州區	qb[sh vz[dp qu[ki
欽州市	qb[jd vz[dp ui[wj
慶安縣	qk[gd an[gn xm[qs
青白江區	qk[fo bd[po jl[dg qu[ki
清城區	qk[df ig[tw qu[ki
慶城縣	qk[gd ig[tw xm[qs
青川縣	qk[fo ir[pu xm[qs
青島市	qk[fo dc[nu ui[wj
清豐縣	qk[df fg[su xm[qs
青岡縣	qk[fo gh[ki xm[qs
青海省	qk[fo hd[dr ug[xm
清河門區	qk[df he[dk mf[du qu[ki
清河區	qk[df he[dk qu[ki
清河縣	qk[df he[dk xm[qs
青河縣	qk[fo he[dk xm[qs
清澗縣	qk[df jm[dm xm[qs
清江浦區	qk[df jl[dg pu[df qu[ki
清流縣	qk[df lq[dw xm[qs
青龍滿族自治縣	qk[fo ls[yp mj[dc zu[fr zi[pm vi[ds xm[qs
晴隆縣	qk[of ls[ew xm[qs
青浦區	qk[fo pu[df qu[ki
青山湖區	qk[fo uj[uk hu[dg qu[ki
青山區	qk[fo uj[uk qu[ki
青神縣	qk[fo uf[uo xm[qs
清水河縣	qk[df uv[uu he[dk xm[qs
清水縣	qk[df uv[uu xm[qs
青田縣	qk[fo tm[wu xm[qs
青銅峽市	qk[fo ts[jk xx[uj ui[wj
青縣	qk[fo xm[qs
清新區	qk[df xb[lj qu[ki
青秀區	qk[fo xq[hn qu[ki
清徐縣	qk[df xu[rr xm[qs
青羊區	qk[fo yh[bs qu[ki
慶陽市	qk[gd yh[eo ui[wj
青陽縣	qk[fo yh[eo xm[qs
清原滿族自治縣	qk[df yr[ib mj[dc zu[fr zi[pm vi[ds xm[qs
清苑區	qk[df yr[cx qu[ki
青原區	qk[fo yr[ib qu[ki
清遠市	qk[df yr[ez ui[wj
慶元縣	qk[gd yr[ee xm[qs
青雲譜區	qk[fo yy[es pu[yb qu[ki
慶雲縣	qk[gd yy[es xm[qs
清鎮市	qk[df vf[ju ui[wj
青州市	qk[fo vz[dp ui[wj
瓊海市	qs[ww hd[dr ui[wj
瓊結縣	qs[ww jp[su xm[qs
邛崍市	qs[ge ld[ul ui[wj
瓊山區	qs[ww uj[uk qu[ki
瓊中黎族苗族自治縣	qs[ww vs[ku li[hr zu[fr mn[ct zu[fr zi[pm vi[ds xm[qs
丘北縣	qq[jh bw[ub xm[qs
邱縣	qq[qe xm[qs
曲阜市	qu[ou fu[pu ui[wj
曲江區	qu[ou jl[dg qu[ki
衢江區	qu[rm jl[dg qu[ki
曲靖市	qu[ou jk[lf ui[wj
曲麻萊縣	qu[ou ma[ga ld[cl xm[qs
曲水縣	qu[ou uv[uu xm[qs
曲松縣	qu[ou ss[ab xm[qs
曲沃縣	qu[ou wo[dp xm[qs
渠縣	qu[da xm[qs
曲陽縣	qu[ou yh[eo xm[qs
衢州市	qu[rm vz[dp ui[wj
曲周縣	qu[ou vz[kt xm[qs
泉港區	qr[bu gh[dg qu[ki
全椒縣	qr[rw jn[au xm[qs
全南縣	qr[rw nj[uk xm[qs
泉山區	qr[bu uj[uk qu[ki
泉州市	qr[bu vz[dp ui[wj
全州縣	qr[rw vz[dp xm[qs
確山縣	qt[ed uj[uk xm[qs
讓胡路區	rh[yu hu[go lu[zw qu[ki
壤塘縣	rh[tw th[tg xm[qs
饒河縣	rc[uq he[dk xm[qs
饒平縣	rc[uq pk[hb xm[qs
饒陽縣	rc[uq yh[eo xm[qs
仁布縣	rf[re bu[uj xm[qs
任城區	rf[rq ig[tw qu[ki
仁和區	rf[re he[hk qu[ki
仁化縣	rf[re hx[rq xm[qs
仁懷市	rf[re hk[xb ui[wj
任丘市	rf[rq qq[jh ui[wj
仁壽縣	rf[re uz[fc xm[qs
任澤區	rf[rq ze[dy qu[ki
日喀則市	ri[wh ka[kg ze[bd ui[wj
日土縣	ri[wh tu[uh xm[qs
日照市	ri[wh vc[od ui[wj
融安縣	rs[hi an[gn xm[qs
榮昌區	rs[ca ih[oo qu[ki
榕城區	rs[ax ig[tw qu[ki
榮成市	rs[ca ig[wv ui[wj
容城縣	rs[xr ig[tw xm[qs
榕江縣	rs[ax jl[dg xm[qs
融水苗族自治縣	rs[hi uv[uu mn[ct zu[fr zi[pm vi[ds xm[qs
容縣	rs[xr xm[qs
榮縣	rs[ca xm[qs
汝城縣	ru[dn ig[tw xm[qs
如東縣	ru[nk ds[qx xm[qs
如皋市	ru[nk gc[bd ui[wj
汝南縣	ru[dn nj[uk xm[qs
乳山市	ru[av uj[uk ui[wj
汝陽縣	ru[dn yh[eo xm[qs
乳源瑤族自治縣	ru[av yr[di yc[wa zu[fr zi[pm vi[ds xm[qs
汝州市	ru[dn vz[dp ui[wj
瑞安市	rv[wu an[gn ui[wj
瑞昌市	rv[wu ih[oo ui[wj
芮城縣	rv[ck ig[tw xm[qs
瑞金市	rv[wu jb[rw ui[wj
瑞麗市	rv[wu li[hk ui[wj
潤州區	ry[dm vz[dp qu[ki
若爾蓋縣	ro[cu er[dx gd[bm xm[qs
若羌縣	ro[cu ql[yv xm[qs
薩爾圖區	sa[ce er[dx tu[ww qu[ki
薩嘎縣	sa[ce ga[ke xm[qs
薩迦縣	sa[ce jx[lz xm[qs
賽罕區	sd[gb hj[gg qu[ki
三都水族自治縣	sj[hh du[te uv[uu zu[fr zi[pm vi[ds xm[qs
三河市	sj[hh he[dk ui[wj
三江侗族自治縣	sj[hh jl[dg ds[rk zu[fr zi[pm vi[ds xm[qs
三門峽市	sj[hh mf[du xx[uj ui[wj
三門縣	sj[hh mf[du xm[qs
三明市	sj[hh mk[oo ui[wj
三沙市	sj[hh ua[dx ui[wj
三水區	sj[hh uv[uu qu[ki
三穗縣	sj[hh sv[hh xm[qs
三臺縣	sj[hh td[sk xm[qs
三亞市	sj[hh ya[hy ui[wj
三元區	sj[hh yr[ee qu[ki
三原縣	sj[hh yr[ib xm[qs
桑日縣	sh[ya ri[wh xm[qs
桑植縣	sh[ya vi[au xm[qs
桑珠孜區	sh[ya vu[wp zi[zw qu[ki
色達縣	se[db da[dz xm[qs
色尼區	se[db ni[ub qu[ki
莎車縣	ua[cd ie[qu xm[qs
沙河口區	ua[dx he[dk kz[uv qu[ki
沙河市	ua[dx he[dk ui[wj
沙坪壩區	ua[dx pk[tp ba[tb qu[ki
沙坡頭區	ua[dx po[tp tz[dd qu[ki
沙市區	ua[dx ui[wj qu[ki
沙灣區	ua[dx wj[dy qu[ki
沙灣縣	ua[dx wj[dy xm[qs
沙縣	ua[dx xm[qs
沙雅縣	ua[dx ya[yv xm[qs
沙洋縣	ua[dx yh[dy xm[qs
沙依巴克區	ua[dx yi[ry ba[ku ke[ge qu[ki
山城區	uj[uk ig[tw qu[ki
山丹縣	uj[uk dj[kw xm[qs
山東省	uj[uk ds[qx ug[xm
山海關區	uj[uk hd[dr gr[bt qu[ki
山南市	uj[uk nj[uk ui[wj
鄯善縣	uj[ye uj[yk xm[qs
山亭區	uj[uk tk[wd qu[ki
汕頭市	uj[du tz[dd ui[wj
汕尾市	uj[du ww[um ui[wj
山西省	uj[uk xi[hk ug[xm
陝西省	uj[ej xi[hk ug[xm
單縣	uj[bo xm[qs
山陽區	uj[uk yh[eo qu[ki
山陽縣	uj[uk yh[eo xm[qs
山陰縣	uj[uk yb[eo xm[qs
陝州區	uj[ej vz[dp qu[ki
上蔡縣	uh[bh cd[cx xm[qs
上城區	uh[bh ig[tw qu[ki
商城縣	uh[lk ig[tw xm[qs
上黨區	uh[bh dh[xk qu[ki
商都縣	uh[lk du[te xm[qs
上高縣	uh[bh gc[wk xm[qs
上海市	uh[bh hd[dr ui[wj
上杭縣	uh[bh hh[aw xm[qs
商河縣	uh[lk he[dk xm[qs
上街區	uh[bh jp[rt qu[ki
上栗縣	uh[bh li[xa xm[qs
上林縣	uh[bh lb[aa xm[qs
商洛市	uh[lk lo[dw ui[wj
商南縣	uh[lk nj[uk xm[qs
商丘市	uh[lk qq[jh ui[wj
上饒市	uh[bh rc[uq ui[wj
商水縣	uh[lk uv[uu xm[qs
上思縣	uh[bh si[tx xm[qs
尚義縣	uh[xk yi[di xm[qs
上猶縣	uh[bh yz[qy xm[qs
上虞區	uh[bh yu[hk qu[ki
尚志市	uh[xk vi[ux ui[wj
商州區	uh[lk vz[dp qu[ki
邵東市	uc[de ds[qx ui[wj
韶關市	uc[ld gr[bt ui[wj
韶山市	uc[ld uj[uk ui[wj
邵武市	uc[de wu[hv ui[wj
紹興市	uc[sd xk[xb ui[wj
邵陽市	uc[de yh[eo ui[wj
邵陽縣	uc[de yh[eo xm[qs
射洪市	ue[uc hs[dg ui[wj
社旗縣	ue[ut qi[fr xm[qs
歙縣	ue[rd xm[qs
涉縣	ue[dv xm[qs
射陽縣	ue[uc yh[eo xm[qs
沈北新區	uf[dg bw[ub xb[lj qu[ki
神池縣	uf[uo ii[dy xm[qs
瀋河區	uf[dg he[dk qu[ki
神木市	uf[uo mu[ub ui[wj
神農架林區	uf[uo ns[gy jx[la lb[aa qu[ki
沈丘縣	uf[dg qq[jh xm[qs
莘縣	uf[cl xm[qs
瀋陽市	uf[dg yh[eo ui[wj
深澤縣	uf[dg ze[dy xm[qs
申扎縣	uf[ou va[fv xm[qs
深圳市	uf[dg vf[ti ui[wj
深州市	uf[dg vz[dp ui[wj
嵊泗縣	ug[uq si[ds xm[qs
嵊州市	ug[uq vz[dp ui[wj
市北區	ui[wj bw[ub qu[ki
施秉縣	ui[fr bk[ph xm[qs
石城縣	ui[ek ig[tw xm[qs
施甸縣	ui[fr dm[bt xm[qs
什邡市	ui[ru fh[fe ui[wj
石峰區	ui[ek fg[uw qu[ki
石鼓區	ui[ek gu[uu qu[ki
石柺區	ui[ek gk[fk qu[ki
溮河區	ui[du he[dk qu[ki
石河子市	ui[ek he[dk zi[lh ui[wj
石家莊市	ui[ek jx[gu vl[gt ui[wj
石景山區	ui[ek jk[ow uj[uk qu[ki
石林彝族自治縣	ui[ek lb[aa yi[vm zu[fr zi[pm vi[ds xm[qs
石龍區	ui[ek ls[yp qu[ki
石樓縣	ui[ek lz[am xm[qs
石門縣	ui[ek mf[du xm[qs
石棉縣	ui[ek mm[ab xm[qs
市南區	ui[wj nj[uk qu[ki
石屏縣	ui[ek pk[ub xm[qs
石阡縣	ui[ek qm[eq xm[qs
石渠縣	ui[ek qu[da xm[qs
石泉縣	ui[ek qr[bu xm[qs
石獅市	ui[ek ui[qu ui[wj
石首市	ui[ek uz[be ui[wj
石臺縣	ui[ek td[sk xm[qs
始興縣	ui[ns xk[xb xm[qs
十堰市	ui[hu yj[tk ui[wj
市中區	ui[wj vs[ku qu[ki
石柱土家族自治縣	ui[ek vu[ad tu[uh jx[gu zu[fr zi[pm vi[ds xm[qs
師宗縣	ui[uh zs[ge xm[qs
石嘴山市	ui[ek zv[kv uj[uk ui[wj
壽光市	uz[fc gl[xe ui[wj
壽寧縣	uz[fc nk[gd xm[qs
壽縣	uz[fc xm[qs
壽陽縣	uz[fc yh[eo xm[qs
舒城縣	uu[ry ig[tw xm[qs
疏附縣	uu[pw fu[er xm[qs
舒蘭市	uu[ry lj[bs ui[wj
疏勒縣	uu[pw le[gl xm[qs
蜀山區	uu[sb uj[uk qu[ki
沭陽縣	uu[da yh[eo xm[qs
雙柏縣	ul[yy bd[ab xm[qs
雙城區	ul[yy ig[tw qu[ki
雙峰縣	ul[yy fg[uw xm[qs
雙河市	ul[yy he[dk ui[wj
雙湖縣	ul[yy hu[dg xm[qs
雙遼市	ul[yy ln[lz ui[wj
雙流區	ul[yy lq[dw qu[ki
雙灤區	ul[yy lr[dy qu[ki
雙牌縣	ul[yy pd[pb xm[qs
雙橋區	ul[yy qn[ap qu[ki
雙清區	ul[yy qk[df qu[ki
雙塔區	ul[yy ta[tc qu[ki
雙臺子區	ul[yy td[sk zi[lh qu[ki
雙鴨山市	ul[yy ya[on uj[uk ui[wj
雙陽區	ul[yy yh[eo qu[ki
水城區	uv[uu ig[tw qu[ki
水富市	uv[uu fu[gh ui[wj
水磨溝區	uv[uu mo[ge gz[db qu[ki
順昌縣	uy[iy ih[oo xm[qs
順城區	uy[iy ig[tw qu[ki
順德區	uy[iy de[ru qu[ki
順河回族區	uy[iy he[dk hv[wk zu[fr qu[ki
順平縣	uy[iy pk[hb xm[qs
順慶區	uy[iy qk[gd qu[ki
順義區	uy[iy yi[di qu[ki
朔城區	uo[no ig[tw qu[ki
朔州市	uo[no vz[dp ui[wj
四川省	si[we ir[pu ug[xm
四方臺區	si[we fh[dw td[sk qu[ki
泗洪縣	si[ds hs[dg xm[qs
四會市	si[we hv[re ui[wj
思茅區	si[tx mc[cy qu[ki
思明區	si[tx mk[oo qu[ki
思南縣	si[tx nj[uk xm[qs
四平市	si[we pk[hb ui[wj
泗水縣	si[ds uv[uu xm[qs
泗縣	si[ds xm[qs
泗陽縣	si[ds yh[eo xm[qs
四子王旗	si[we zi[lh wh[su qi[fr
松北區	ss[ab bw[ub qu[ki
松江區	ss[ab jl[dg qu[ki
嵩明縣	ss[uw mk[oo xm[qs
松潘縣	ss[ab pj[dp xm[qs
松山區	ss[ab uj[uk qu[ki
松桃苗族自治縣	ss[ab tc[av mn[ct zu[fr zi[pm vi[ds xm[qs
松溪縣	ss[ab xi[da xm[qs
嵩縣	ss[uw xm[qs
松陽縣	ss[ab yh[eo xm[qs
松原市	ss[ab yr[ib ui[wj
松滋市	ss[ab zi[db ui[wj
肅北蒙古族自治縣	su[xu bw[ub mg[ch gu[uk zu[fr zi[pm vi[ds xm[qs
宿城區	su[gr ig[tw qu[ki
蘇家屯區	su[cl jx[gu ty[hk qu[ki
肅南裕固族自治縣	su[xu nj[uk yu[yb gu[wg zu[fr zi[pm vi[ds xm[qs
蘇尼特右旗	su[cl ni[ub te[nt yz[uk qi[fr
蘇尼特左旗	su[cl ni[ub te[nt zo[ug qi[fr
肅寧縣	su[xu nk[gd xm[qs
宿遷市	su[gr qm[qz ui[wj
宿松縣	su[gr ss[ab xm[qs
甦仙區	su[cl xm[ru qu[ki
宿豫區	su[gr yu[yd qu[ki
肅州區	su[xu vz[dp qu[ki
宿州市	su[gr vz[dp ui[wj
蘇州市	su[cl vz[dp ui[wj
綏濱縣	sv[sa bb[dg xm[qs
遂昌縣	sv[bz ih[oo xm[qs
遂川縣	sv[bz ir[pu xm[qs
綏德縣	sv[sa de[ru xm[qs
綏芬河市	sv[sa ff[cf he[dk ui[wj
綏化市	sv[sa hx[rq ui[wj
綏江縣	sv[sa jl[dg xm[qs
綏稜縣	sv[sa lk[at xm[qs
遂寧市	sv[bz nk[gd ui[wj
睢寧縣	sv[mv nk[gd xm[qs
綏寧縣	sv[sa nk[gd xm[qs
遂平縣	sv[bz pk[hb xm[qs
濉溪縣	sv[dm xi[da xm[qs
遂溪縣	sv[bz xi[da xm[qs
睢縣	sv[mv xm[qs
隨縣	sv[eu xm[qs
睢陽區	sv[mv yh[eo qu[ki
綏陽縣	sv[sa yh[eo xm[qs
綏中縣	sv[sa vs[ku xm[qs
隨州市	sv[eu vz[dp ui[wj
孫吳縣	sy[zx wu[kt xm[qs
索縣	so[uy xm[qs
塔城地區	ta[tc ig[tw di[ty qu[ki
塔城市	ta[tc ig[tw ui[wj
塔河縣	ta[tc he[dk xm[qs
塔什庫爾干塔吉克自治縣	ta[tc ui[ru ku[gi er[dx gj[hu ta[tc ji[uk ke[ge zi[pm vi[ds xm[qs
泰安市	td[su an[gn ui[wj
臺安縣	td[sk an[gn xm[qs
太白縣	td[dd bd[po xm[qs
太倉市	td[dd ch[re ui[wj
臺兒莊區	td[sk er[pv vl[gt qu[ki
太谷區	td[dd gu[bk qu[ki
太和區	td[dd he[hk qu[ki
太和縣	td[dd he[hk xm[qs
泰和縣	td[su he[hk xm[qs
太湖縣	td[dd hu[dg xm[qs
臺江區	td[sk jl[dg qu[ki
臺江縣	td[sk jl[dg xm[qs
太康縣	td[dd kh[gx xm[qs
泰來縣	td[su ld[hm xm[qs
泰寧縣	td[su nk[gd xm[qs
太平區	td[dd pk[hb qu[ki
太僕寺旗	td[dd pu[rb si[tc qi[fr
臺前縣	td[sk qm[bo xm[qs
泰山區	td[su uj[uk qu[ki
台山市	td[sk uj[uk ui[wj
泰順縣	td[su uy[iy xm[qs
臺灣省	td[sk wj[dy ug[xm
泰興市	td[su xk[xb ui[wj
太原市	td[dd yr[ib ui[wj
台州市	td[sk vz[dp ui[wj
泰州市	td[su vz[dp ui[wj
太子河區	td[dd zi[lh he[dk qu[ki
郯城縣	tj[he ig[tw xm[qs
唐河縣	th[gx he[dk xm[qs
唐山市	th[gx uj[uk ui[wj
湯旺縣	th[dv wh[ow xm[qs
唐縣	th[gx xm[qs
湯陰縣	th[dv yb[eo xm[qs
湯原縣	th[dv yr[ib xm[qs
洮北區	tc[dv bw[ub qu[ki
桃城區	tc[av ig[tw qu[ki
桃江縣	tc[av jl[dg xm[qs
洮南市	tc[dv nj[uk ui[wj
桃山區	tc[av uj[uk qu[ki
桃源縣	tc[av yr[di xm[qs
特克斯縣	te[nt ke[ge si[qj xm[qs
騰衝市	tg[ob is[dv ui[wj
藤縣	tg[co xm[qs
滕州市	tg[ob vz[dp ui[wj
天長市	tm[hd ih[ph ui[wj
天等縣	tm[hd dg[vt xm[qs
田東縣	tm[wu ds[qx xm[qs
天峨縣	tm[hd ee[up xm[qs
天河區	tm[hd he[dk qu[ki
田家庵區	tm[wu jx[gu an[gd qu[ki
天津市	tm[hd jb[dy ui[wj
天峻縣	tm[hd jy[us xm[qs
田林縣	tm[wu lb[aa xm[qs
天門市	tm[hd mf[du ui[wj
天寧區	tm[hd nk[gd qu[ki
天橋區	tm[hd qn[ap qu[ki
天全縣	tm[hd qr[rw xm[qs
天山區	tm[hd uj[uk qu[ki
天水市	tm[hd uv[uu ui[wj
天台縣	tm[hd td[sk xm[qs
天心區	tm[hd xb[dv qu[ki
天涯區	tm[hd ya[di qu[ki
田陽區	tm[wu yh[eo qu[ki
天元區	tm[hd yr[ee qu[ki
天鎮縣	tm[hd vf[ju xm[qs
天柱縣	tm[hd vu[ad xm[qs
天祝藏族自治縣	tm[hd vu[uk zh[cw zu[fr zi[pm vi[ds xm[qs
鐵東區	tp[jp ds[qx qu[ki
鐵鋒區	tp[jp fg[jw qu[ki
鐵力市	tp[jp li[vp ui[wj
鐵嶺市	tp[jp lk[ur ui[wj
鐵嶺縣	tp[jp lk[ur xm[qs
鐵門關市	tp[jp mf[du gr[bt ui[wj
鐵山港區	tp[jp uj[uk gh[dg qu[ki
鐵山區	tp[jp uj[uk qu[ki
鐵西區	tp[jp xi[hk qu[ki
亭湖區	tk[wd hu[dg qu[ki
同安區	ts[kh an[gn qu[ki
桐柏縣	ts[ak bd[ab xm[qs
桐城市	ts[ak ig[tw ui[wj
通城縣	ts[sz ig[tw xm[qs
通川區	ts[sz ir[pu qu[ki
銅川市	ts[jk ir[pu ui[wj
通道侗族自治縣	ts[sz dc[bz ds[rk zu[fr zi[pm vi[ds xm[qs
同德縣	ts[kh de[ru xm[qs
銅鼓縣	ts[jk gu[uu xm[qs
銅官區	ts[jk gr[gu qu[ki
潼關縣	ts[dl gr[bt xm[qs
通海縣	ts[sz hd[dr xm[qs
通河縣	ts[sz he[dk xm[qs
通化市	ts[sz hx[rq ui[wj
通化縣	ts[sz hx[rq xm[qs
同江市	ts[kh jl[dg ui[wj
通江縣	ts[sz jl[dg xm[qs
銅梁區	ts[jk ll[da qu[ki
通遼市	ts[sz ln[lz ui[wj
銅陵市	ts[jk lk[et ui[wj
桐廬縣	ts[ak lu[gh xm[qs
潼南區	ts[dl nj[uk qu[ki
同仁市	ts[kh rf[re ui[wj
銅仁市	ts[jk rf[re ui[wj
銅山區	ts[jk uj[uk qu[ki
通山縣	ts[sz uj[uk xm[qs
通渭縣	ts[sz ww[dt xm[qs
桐鄉市	ts[ak xl[sp ui[wj
同心縣	ts[kh xb[dv xm[qs
通許縣	ts[sz xu[yw xm[qs
通榆縣	ts[sz yu[ar xm[qs
通州區	ts[sz vz[dp qu[ki
桐梓縣	ts[ak zi[al xm[qs
頭屯河區	tz[dd ty[hk he[dk qu[ki
吐魯番市	tu[kt lu[yo fj[pt ui[wj
圖們市	tu[ww mf[rm ui[wj
土默特右旗	tu[uh mo[hq te[nt yz[uk qi[fr
土默特左旗	tu[uh mo[hq te[nt zo[ug qi[fr
圖木舒克市	tu[ww mu[ub uu[ry ke[ge ui[wj
突泉縣	tu[xq qr[bu xm[qs
團風縣	tr[wc fg[ji xm[qs
屯昌縣	ty[hk ih[oo xm[qs
屯留區	ty[hk lq[pt qu[ki
屯溪區	ty[hk xi[da qu[ki
托克托縣	to[fp ke[ge to[fp xm[qs
托克遜縣	to[fp ke[ge xy[zz xm[qs
托里縣	to[fp li[ot xm[qs
瓦房店市	wa[hv fh[hf dm[gb ui[wj
萬安縣	wj[hv an[gn xm[qs
萬柏林區	wj[hv bo[ab lb[aa qu[ki
宛城區	wj[gx ig[tw qu[ki
萬年縣	wj[hv nm[rn xm[qs
萬寧市	wj[hv nk[gd ui[wj
萬全區	wj[hv qr[rw qu[ki
萬榮縣	wj[hv rs[ca xm[qs
萬山區	wj[hv uj[uk qu[ki
萬秀區	wj[hv xq[hn qu[ki
萬源市	wj[hv yr[di ui[wj
萬載縣	wj[hv zd[ti xm[qs
灣沚區	wj[dy vi[dv qu[ki
萬州區	wj[hv vz[dp qu[ki
旺蒼縣	wh[ow ch[cr xm[qs
望城區	wh[ww ig[tw qu[ki
望都縣	wh[ww du[te xm[qs
望花區	wh[ww hx[cr qu[ki
望江縣	wh[ww jl[dg xm[qs
望奎縣	wh[ww kv[dt xm[qs
望謨縣	wh[ww mo[yc xm[qs
汪清縣	wh[dw qk[df xm[qs
王益區	wh[su yi[bm qu[ki
衛濱區	ww[eh bb[dg qu[ki
渭濱區	ww[dt bb[dg qu[ki
圍場滿族蒙古族自治縣	ww[ww ih[tv mj[dc zu[fr mg[ch gu[uk zu[fr zi[pm vi[ds xm[qs
渭城區	ww[dt ig[tw qu[ki
濰城區	ww[ds ig[tw qu[ki
衛東區	ww[eh ds[qx qu[ki
魏都區	ww[hg du[te qu[ki
濰坊市	ww[ds fh[tf ui[wj
威海市	ww[wh hd[dr ui[wj
衛輝市	ww[eh hv[xg ui[wj
渭南市	ww[dt nj[uk ui[wj
威寧彝族回族苗族自治縣	ww[wh nk[gd yi[vm zu[fr hv[wk zu[fr mn[ct zu[fr zi[pm vi[ds xm[qs
微山縣	ww[ru uj[uk xm[qs
巍山彝族回族自治縣	ww[uh uj[uk yi[vm zu[fr hv[wk zu[fr zi[pm vi[ds xm[qs
尉氏縣	ww[uc ui[pq xm[qs
維西傈僳族自治縣	ww[sv xi[hk li[rx su[rx zu[fr zi[pm vi[ds xm[qs
威縣	ww[wh xm[qs
魏縣	ww[hg xm[qs
威信縣	ww[wh xb[ry xm[qs
未央區	ww[ha yh[kd qu[ki
威遠縣	ww[wh yr[ez xm[qs
渭源縣	ww[dt yr[di xm[qs
文安縣	wf[wi an[gn xm[qs
文昌市	wf[wi ih[oo ui[wj
文成縣	wf[wi ig[wv xm[qs
汶川縣	wf[dw ir[pu xm[qs
文登區	wf[wi dg[dd qu[ki
文峰區	wf[wi fg[uw qu[ki
溫江區	wf[do jl[dg qu[ki
溫嶺市	wf[do lk[ur ui[wj
溫泉縣	wf[do qr[bu xm[qs
文山市	wf[wi uj[uk ui[wj
文山壯族苗族自治州	wf[wi uj[uk vl[du zu[fr mn[ct zu[fr zi[pm vi[ds vz[dp
汶上縣	wf[dw uh[bh xm[qs
文聖區	wf[wi ug[yt qu[ki
文水縣	wf[wi uv[uu xm[qs
溫宿縣	wf[do su[gr xm[qs
聞喜縣	wf[me xi[uk xm[qs
文縣	wf[wi xm[qs
溫縣	wf[do xm[qs
溫州市	wf[do vz[dp ui[wj
甕安縣	wg[bw an[gn xm[qs
翁牛特旗	wg[bx nq[pf te[nt qi[fr
翁源縣	wg[bx yr[di xm[qs
臥龍區	wo[kb ls[yp qu[ki
武安市	wu[hv an[gn ui[wj
吳堡縣	wu[kt bc[rt xm[qs
武昌區	wu[hv ih[oo qu[ki
五常市	wu[hu ih[xk ui[wj
婺城區	wu[yn ig[tw qu[ki
武城縣	wu[hv ig[tw xm[qs
務川仡佬族苗族自治縣	wu[wl ir[pu ge[rr lc[rt zu[fr mn[ct zu[fr zi[pm vi[ds xm[qs
吳川市	wu[kt ir[pu ui[wj
武川縣	wu[hv ir[pu xm[qs
烏翠區	wu[bv cv[xw qu[ki
五大連池市	wu[hu da[hr lm[iz ii[dy ui[wj
烏達區	wu[bv da[dz qu[ki
烏當區	wu[bv dh[xx qu[ki
無棣縣	wu[ee di[ax xm[qs
武定縣	wu[hv dk[gp xm[qs
武都區	wu[hv du[te qu[ki
烏爾禾區	wu[bv er[dx he[pa qu[ki
五峰土家族自治縣	wu[hu fg[uw tu[uh jx[gu zu[fr zi[pm vi[ds xm[qs
武岡市	wu[hv gh[ki ui[wj
舞鋼市	wu[rx gh[jk ui[wj
武功縣	wu[hv gs[gl xm[qs
烏海市	wu[bv hd[dr ui[wj
武漢市	wu[hv hj[dy ui[wj
五河縣	wu[hu he[dk xm[qs
武侯區	wu[hv hz[rv qu[ki
蕪湖市	wu[ce hu[dg ui[wj
五華區	wu[hu hx[ru qu[ki
五華縣	wu[hu hx[ru xm[qs
無極縣	wu[ee ji[aj xm[qs
伍家崗區	wu[rw jx[gu gh[uk qu[ki
五家渠市	wu[hu jx[gu qu[da ui[wj
吳江區	wu[kt jl[dg qu[ki
武江區	wu[hv jl[dg qu[ki
武進區	wu[hv jb[ez qu[ki
烏拉特後旗	wu[bv la[fl te[nt hz[pk qi[fr
烏拉特前旗	wu[bv la[fl te[nt qm[bo qi[fr
烏拉特中旗	wu[bv la[fl te[nt vs[ku qi[fr
烏蘭察布市	wu[bv lj[bs ia[gx bu[uj ui[wj
烏蘭浩特市	wu[bv lj[bs hc[dn te[nt ui[wj
烏蘭縣	wu[bv lj[bs xm[qs
五蓮縣	wu[hu lm[ci xm[qs
武陵區	wu[hv lk[et qu[ki
武陵源區	wu[hv lk[et yr[di qu[ki
武隆區	wu[hv ls[ew qu[ki
烏魯木齊市	wu[bv lu[yo mu[ub qi[wp ui[wj
烏魯木齊縣	wu[bv lu[yo mu[ub qi[wp xm[qs
武鳴區	wu[hv mk[kn qu[ki
武寧縣	wu[hv nk[gd xm[qs
武平縣	wu[hv pk[hb xm[qs
吳起縣	wu[kt qi[zk xm[qs
烏恰縣	wu[bv qx[xr xm[qs
武強縣	wu[hv ql[gk xm[qs
吳橋縣	wu[kt qn[ap xm[qs
武清區	wu[hv qk[df qu[ki
巫山縣	wu[gr uj[uk xm[qs
武山縣	wu[hv uj[uk xm[qs
烏審旗	wu[bv uf[go qi[fr
武勝縣	wu[hv ug[op xm[qs
烏什縣	wu[bv ui[ru xm[qs
烏蘇市	wu[bv su[cl ui[wj
五臺縣	wu[hu td[sk xm[qs
五通橋區	wu[hu ts[sz qn[ap qu[ki
無為市	wu[ee ww[dl ui[wj
武威市	wu[hv ww[wh ui[wj
無錫市	wu[ee xi[jo ui[wj
巫溪縣	wu[gr xi[da xm[qs
武鄉縣	wu[hv xl[sp xm[qs
吳興區	wu[kt xk[xb qu[ki
武宣縣	wu[hv xr[gh xm[qs
武穴市	wu[hv xt[gb ui[wj
舞陽縣	wu[rx yh[eo xm[qs
武夷山市	wu[hv yi[hg uj[uk ui[wj
武義縣	wu[hv yi[di xm[qs
武邑縣	wu[hv yi[kb xm[qs
五原縣	wu[hu yr[ib xm[qs
婺源縣	wu[yn yr[di xm[qs
五寨縣	wu[hu vd[ga xm[qs
五指山市	wu[hu vi[fb uj[uk ui[wj
武陟縣	wu[hv vi[ev xm[qs
吳中區	wu[kt vs[ku qu[ki
吳忠市	wu[kt vs[vx ui[wj
梧州市	wu[aw vz[dp ui[wj
西安區	xi[hk an[gn qu[ki
西安市	xi[hk an[gn ui[wj
西昌市	xi[hk ih[oo ui[wj
西城區	xi[hk ig[tw qu[ki
西充縣	xi[hk is[we xm[qs
西疇縣	xi[hk iz[tf xm[qs
淅川縣	xi[da ir[pu xm[qs
喜德縣	xi[uk de[ru xm[qs
西峰區	xi[hk fg[uw qu[ki
息烽縣	xi[zx fg[hw xm[qs
西豐縣	xi[hk fg[su xm[qs
西崗區	xi[hk gh[uk qu[ki
西工區	xi[hk gs[hu qu[ki
西固區	xi[hk gu[wg qu[ki
細河區	xi[st he[dk qu[ki
西和縣	xi[hk he[hk xm[qs
溪湖區	xi[da hu[dg qu[ki
西湖區	xi[hk hu[dg qu[ki
西華縣	xi[hk hx[ru xm[qs
西吉縣	xi[hk ji[uk xm[qs
錫林郭勒盟	xi[jo lb[aa go[we le[gl mg[om
錫林浩特市	xi[jo lb[aa hc[dn te[nt ui[wj
西林縣	xi[hk lb[aa xm[qs
西陵區	xi[hk lk[et qu[ki
西盟佤族自治縣	xi[hk mg[om wa[rw zu[fr zi[pm vi[ds xm[qs
西寧市	xi[hk nk[gd ui[wj
西平縣	xi[hk pk[hb xm[qs
西青區	xi[hk qk[fo qu[ki
西區	xi[hk qu[ki
西塞山區	xi[hk sd[gt uj[uk qu[ki
西沙區	xi[hk ua[dx qu[ki
西山區	xi[hk uj[uk qu[ki
錫山區	xi[jo uj[uk qu[ki
西市區	xi[hk ui[wj qu[ki
西雙版納傣族自治州	xi[hk ul[yy bj[pp na[sk dd[rs zu[fr zi[pm vi[ds vz[dp
習水縣	xi[vd uv[uu xm[qs
浠水縣	xi[di uv[uu xm[qs
西烏珠穆沁旗	xi[hk wu[bv vu[wp mu[hb qb[dx qi[fr
西夏區	xi[hk xx[ew qu[ki
西峽縣	xi[hk xx[uj xm[qs
息縣	xi[zx xm[qs
隰縣	xi[eo xm[qs
西鄉塘區	xi[hk xl[sp th[tg qu[ki
西鄉縣	xi[hk xl[sp xm[qs
西秀區	xi[hk xq[hn qu[ki
昔陽縣	xi[go yh[eo xm[qs
西藏自治區	xi[hk zh[cw zi[pm vi[ds qu[ki
下城區	xx[hb ig[tw qu[ki
夏河縣	xx[ew he[dk xm[qs
下花園區	xx[hb hx[cr yr[we qu[ki
峽江縣	xx[uj jl[dg xm[qs
夏津縣	xx[ew jb[dy xm[qs
下陸區	xx[hb lu[ef qu[ki
廈門市	xx[ie mf[du ui[wj
霞浦縣	xx[yk pu[df xm[qs
霞山區	xx[yk uj[uk qu[ki
夏縣	xx[ew xm[qs
夏邑縣	xx[ew yi[kb xm[qs
咸安區	xm[wh an[gn qu[ki
咸豐縣	xm[wh fg[su xm[qs
仙居縣	xm[ru ju[ug xm[qs
咸寧市	xm[wh nk[gd ui[wj
仙桃市	xm[ru tc[av ui[wj
獻縣	xm[uq xm[qs
咸陽市	xm[wh yh[eo ui[wj
仙遊縣	xm[ru yz[df xm[qs
翔安區	xl[yx an[gn qu[ki
相城區	xl[am ig[tw qu[ki
薌城區	xl[cs ig[tw qu[ki
襄城區	xl[wk ig[tw qu[ki
項城市	xl[gy ig[tw ui[wj
鄉城縣	xl[sp ig[tw xm[qs
襄城縣	xl[wk ig[tw xm[qs
湘東區	xl[da ds[qx qu[ki
襄都區	xl[wk dz[te qu[ki
香坊區	xl[ho fh[tf qu[ki
襄汾縣	xl[wk ff[df xm[qs
祥符區	xl[uy fu[vr qu[ki
香港特別行政區	xl[ho gh[dg te[nt bp[kd xk[rh vg[hw qu[ki
香格里拉市	xl[ho ge[aw li[ot la[fl ui[wj
香河縣	xl[ho he[dk xm[qs
鑲黃旗	xl[jw hl[gy qi[fr
鄉寧縣	xl[sp nk[gd xm[qs
湘橋區	xl[da qn[ap qu[ki
相山區	xl[am uj[uk qu[ki
象山區	xl[dk uj[uk qu[ki
象山縣	xl[dk uj[uk xm[qs
響水縣	xl[kp uv[uu xm[qs
湘潭市	xl[da tj[dx ui[wj
湘潭縣	xl[da tj[dx xm[qs
湘西土家族苗族自治州	xl[da xi[hk tu[uh jx[gu zu[fr mn[ct zu[fr zi[pm vi[ds vz[dp
湘鄉市	xl[da xl[sp ui[wj
向陽區	xl[pk yh[eo qu[ki
襄陽市	xl[wk yh[eo ui[wj
湘陰縣	xl[da yb[eo xm[qs
襄垣縣	xl[wk yr[th xm[qs
祥雲縣	xl[uy yy[es xm[qs
襄州區	xl[wk vz[dp qu[ki
香洲區	xl[ho vz[dd qu[ki
象州縣	xl[dk vz[dp xm[qs
孝昌縣	xn[tz ih[oo xm[qs
小店區	xn[ub dm[gb qu[ki
孝感市	xn[tz gj[wx ui[wj
小金縣	xn[ub jb[rw xm[qs
孝南區	xn[tz nj[uk qu[ki
蕭山區	xn[cx uj[uk qu[ki
猇亭區	xn[[ tk[wd qu[ki
蕭縣	xn[cx xm[qs
孝義市	xn[tz yi[di ui[wj
謝家集區	xp[yu jx[gu ji[va qu[ki
謝通門縣	xp[yu ts[sz mf[du xm[qs
新安縣	xb[lj an[gn xm[qs
新巴爾虎右旗	xb[lj ba[ku er[dx hu[hj yz[uk qi[fr
新巴爾虎左旗	xb[lj ba[ku er[dx hu[hj zo[ug qi[fr
新北區	xb[lj bw[ub qu[ki
新賓滿族自治縣	xb[lj bb[gq mj[dc zu[fr zi[pm vi[ds xm[qs
新蔡縣	xb[lj cd[cx xm[qs
新昌縣	xb[lj ih[oo xm[qs
新城區	xb[lj ig[tw qu[ki
忻城縣	xb[xj ig[tw xm[qs
信都區	xb[ry du[te qu[ki
新都區	xb[lj du[te qu[ki
信豐縣	xb[ry fg[su xm[qs
新豐縣	xb[lj fg[su xm[qs
忻府區	xb[xj fu[gr qu[ki
新撫區	xb[lj fu[fe qu[ki
新幹縣	xb[lj gj[hu xm[qs
新和縣	xb[lj he[hk xm[qs
新河縣	xb[lj he[dk xm[qs
新華區	xb[lj hx[ru qu[ki
新化縣	xb[lj hx[rq xm[qs
新晃侗族自治縣	xb[lj hl[ox ds[rk zu[fr zi[pm vi[ds xm[qs
新會區	xb[lj hv[re qu[ki
辛集市	xb[lu ji[va ui[wj
新建區	xb[lj jm[yj qu[ki
新疆維吾爾自治區	xb[lj jl[gh ww[sv wu[wk er[dx zi[pm vi[ds qu[ki
新絳縣	xb[lj jl[sw xm[qs
新津區	xb[lj jb[dy qu[ki
新樂市	xb[lj le[px ui[wj
新龍縣	xb[lj ls[yp xm[qs
新羅區	xb[lj lo[sx qu[ki
新密市	xb[lj mi[gu ui[wj
新民市	xb[lj mb[kv ui[wj
新寧縣	xb[lj nk[gd xm[qs
新平彝族傣族自治縣	xb[lj pk[hb yi[vm zu[fr dd[rs zu[fr zi[pm vi[ds xm[qs
新邱區	xb[lj qq[qe qu[ki
新榮區	xb[lj rs[ca qu[ki
新邵縣	xb[lj uc[de xm[qs
新市區	xb[lj ui[wj qu[ki
新泰市	xb[lj td[su ui[wj
新田縣	xb[lj tm[wu xm[qs
新吳區	xb[lj wu[kt qu[ki
新縣	xb[lj xm[qs
新鄉市	xb[lj xl[sp ui[wj
新鄉縣	xb[lj xl[sp xm[qs
新興區	xb[lj xk[xb qu[ki
新興縣	xb[lj xk[xb xm[qs
信陽市	xb[ry yh[eo ui[wj
新野縣	xb[lj ye[oy xm[qs
信宜市	xb[ry yi[gq ui[wj
新沂市	xb[lj yi[dj ui[wj
新餘市	xb[lj yu[re ui[wj
新源縣	xb[lj yr[di xm[qs
新鄭市	xb[lj vg[be ui[wj
信州區	xb[ry vz[dp qu[ki
新洲區	xb[lj vz[dd qu[ki
忻州市	xb[xj vz[dp ui[wj
興安盟	xk[xb an[gn mg[om
興安區	xk[xb an[gn qu[ki
興安縣	xk[xb an[gn xm[qs
興賓區	xk[xb bb[gq qu[ki
興城市	xk[xb ig[tw ui[wj
興國縣	xk[xb go[ww xm[qs
興海縣	xk[xb hd[dr xm[qs
興和縣	xk[xb he[hk xm[qs
杏花嶺區	xk[ak hx[cr lk[ur qu[ki
興化市	xk[xb hx[rq ui[wj
興隆臺區	xk[xb ls[ew td[sk qu[ki
興隆縣	xk[xb ls[ew xm[qs
興寧區	xk[xb nk[gd qu[ki
興寧市	xk[xb nk[gd ui[wj
興平市	xk[xb pk[hb ui[wj
興慶區	xk[xb qk[gd qu[ki
興仁市	xk[xb rf[re ui[wj
興山區	xk[xb uj[uk qu[ki
興山縣	xk[xb uj[uk xm[qs
邢臺市	xk[ke td[sk ui[wj
行唐縣	xk[rh th[gx xm[qs
興文縣	xk[xb wf[wi xm[qs
興縣	xk[xb xm[qs
滎陽市	xk[cu yh[eo ui[wj
興業縣	xk[xb ye[ub xm[qs
興義市	xk[xb yi[di ui[wj
雄縣	xs[uv xm[qs
秀峰區	xq[hn fg[uw qu[ki
休寧縣	xq[ra nk[gd xm[qs
秀山土家族苗族自治縣	xq[hn uj[uk tu[uh jx[gu zu[fr mn[ct zu[fr zi[pm vi[ds xm[qs
修水縣	xq[ru uv[uu xm[qs
修文縣	xq[ru wf[wi xm[qs
修武縣	xq[ru wu[hv xm[qs
岫巖滿族自治縣	xq[uy yj[ue mj[dc zu[fr zi[pm vi[ds xm[qs
秀英區	xq[hn yk[ck qu[ki
秀嶼區	xq[hn yu[uh qu[ki
秀洲區	xq[hn vz[dd qu[ki
許昌市	xu[yw ih[oo ui[wj
徐彙區	xu[rr hv[dk qu[ki
漵浦縣	xu[dr pu[df xm[qs
徐水區	xu[rr uv[uu qu[ki
徐聞縣	xu[rr wf[me xm[qs
盱眙縣	xu[me yi[ms xm[qs
敘永縣	xu[ry ys[dv xm[qs
敘州區	xu[ry vz[dp qu[ki
徐州市	xu[rr vz[dp ui[wj
宣城市	xr[gh ig[tw ui[wj
宣恩縣	xr[gh en[wx xm[qs
宣漢縣	xr[gh hj[dy xm[qs
宣化區	xr[gh hx[rq qu[ki
宣威市	xr[gh ww[wh ui[wj
玄武區	xr[wy wu[hv qu[ki
宣州區	xr[gh vz[dp qu[ki
薛城區	xt[cp ig[tw qu[ki
尋甸回族彝族自治縣	xy[xc dm[bt hv[wk zu[fr yi[vm zu[fr zi[pm vi[ds xm[qs
循化撒拉族自治縣	xy[rp hx[rq sa[fg la[fl zu[fr zi[pm vi[ds xm[qs
遜克縣	xy[zz ke[ge xm[qs
尋烏縣	xy[xc wu[bv xm[qs
浚縣	xy[ds xm[qs
潯陽區	xy[dx yh[eo qu[ki
旬陽縣	xy[bo yh[eo xm[qs
旬邑縣	xy[bo yi[kb xm[qs
雅安市	ya[yv an[gn ui[wj
亞東縣	ya[hy ds[qx xm[qs
雅江縣	ya[yv jl[dg xm[qs
牙克石市	ya[hv ke[ge ui[ek ui[wj
崖州區	ya[ui vz[dp qu[ki
延安市	yj[pj an[gn ui[wj
延邊朝鮮族自治州	yj[pj bm[lz ic[uo xm[yy zu[fr zi[pm vi[ds vz[dp
鹽邊縣	yj[tm bm[lz xm[qs
延長縣	yj[pj ih[ph xm[qs
郾城區	yj[ke ig[tw qu[ki
鹽城市	yj[tm ig[tw ui[wj
鹽池縣	yj[tm ii[dy xm[qs
延川縣	yj[pj ir[pu xm[qs
鹽都區	yj[tm du[te qu[ki
雁峰區	yj[ir fg[uw qu[ki
沿河土家族自治縣	yj[dj he[dk tu[uh jx[gu zu[fr zi[pm vi[ds xm[qs
鹽湖區	yj[tm hu[dg qu[ki
延吉市	yj[pj ji[uk ui[wj
雁江區	yj[ir jl[dg qu[ki
延津縣	yj[pj jb[dy xm[qs
鹽津縣	yj[tm jb[dy xm[qs
閻良區	yj[md ll[dg qu[ki
炎陵縣	yj[hh lk[et xm[qs
鄢陵縣	yj[he lk[et xm[qs
延平區	yj[pj pk[hb qu[ki
焉耆回族自治縣	yj[hh qi[to hv[wk zu[fr zi[pm vi[ds xm[qs
延慶區	yj[pj qk[gd qu[ki
雁山區	yj[ir uj[uk qu[ki
鹽山縣	yj[tm uj[uk xm[qs
硯山縣	yj[ej uj[uk xm[qs
鉛山縣	yj[jj uj[uk xm[qs
偃師市	yj[rk ui[uh ui[wj
延壽縣	yj[pj uz[fc xm[qs
雁塔區	yj[ir ta[tc qu[ki
煙臺市	yj[hw td[sk ui[wj
沿灘區	yj[dj tj[dy qu[ki
鹽田區	yj[tm tm[wu qu[ki
鹽亭縣	yj[tm tk[wd xm[qs
鹽源縣	yj[tm yr[di xm[qs
兗州區	yj[ls vz[dp qu[ki
漾濞彝族自治縣	yh[db bi[dz yi[vm zu[fr zi[pm vi[ds xm[qs
陽城縣	yh[eo ig[tw xm[qs
陽春市	yh[eo iy[so ui[wj
陽東區	yh[eo ds[qx qu[ki
陽高縣	yh[eo gc[wk xm[qs
陽穀縣	yh[eo gu[bk xm[qs
陽江市	yh[eo jl[dg ui[wj
楊陵區	yh[av lk[et qu[ki
陽明區	yh[eo mk[oo qu[ki
楊浦區	yh[av pu[df qu[ki
陽曲縣	yh[eo qu[ou xm[qs
陽泉市	yh[eo qr[bu ui[wj
陽山縣	yh[eo uj[uk xm[qs
陽朔縣	yh[eo uo[no xm[qs
陽西縣	yh[eo xi[hk xm[qs
洋縣	yh[dy xm[qs
陽信縣	yh[eo xb[ry xm[qs
陽新縣	yh[eo xb[lj xm[qs
陽原縣	yh[eo yr[ib xm[qs
揚中市	yh[fv vs[ku ui[wj
揚州市	yh[fv vz[dp ui[wj
姚安縣	yc[nv an[gn xm[qs
堯都區	yc[qh du[te qu[ki
瑤海區	yc[wa hd[dr qu[ki
耀州區	yc[xx vz[dp qu[ki
葉城縣	ye[ku ig[tw xm[qs
葉集區	ye[ku ji[va qu[ki
葉縣	ye[ku xm[qs
義安區	yi[di an[gn qu[ki
依安縣	yi[ry an[gn xm[qs
宜賓市	yi[gq bb[gq ui[wj
宜昌市	yi[gq ih[oo ui[wj
嶧城區	yi[uy ig[tw qu[ki
驛城區	yi[my ig[tw qu[ki
宜城市	yi[gq ig[tw ui[wj
翼城縣	yi[xt ig[tw xm[qs
伊川縣	yi[rx ir[pu xm[qs
宜川縣	yi[gq ir[pu xm[qs
伊春市	yi[rx iy[so ui[wj
宜春市	yi[gq iy[so ui[wj
宜都市	yi[gq du[te ui[wj
宜豐縣	yi[gq fg[su xm[qs
宜黃縣	yi[gq hl[gy xm[qs
弋江區	yi[qd jl[dg qu[ki
伊金霍洛旗	yi[rx jb[rw ho[yv lo[dw qi[fr
宜君縣	yi[gq jy[xk xm[qs
依蘭縣	yi[ry lj[bs xm[qs
伊犁哈薩克自治州	yi[rx li[hn ha[kr sa[ce ke[ge zi[pm vi[ds vz[dp
宜良縣	yi[gq ll[dg xm[qs
彝良縣	yi[vm ll[dg xm[qs
夷陵區	yi[hg lk[et qu[ki
儀隴縣	yi[rd ls[ey xm[qs
義馬市	yi[di ma[vv ui[wj
伊美區	yi[rx mw[bw qu[ki
易門縣	yi[ob mf[du xm[qs
沂南縣	yi[dj nj[uk xm[qs
伊寧市	yi[rx nk[gd ui[wj
伊寧縣	yi[rx nk[gd xm[qs
沂水縣	yi[dj uv[uu xm[qs
伊通滿族自治縣	yi[rx ts[sz mj[dc zu[fr zi[pm vi[ds xm[qs
義烏市	yi[di wu[bv ui[wj
伊吾縣	yi[rx wu[wk xm[qs
義縣	yi[di xm[qs
易縣	yi[ob xm[qs
黟縣	yi[hx xm[qs
宜興市	yi[gq xk[xb ui[wj
宜秀區	yi[gq xq[hn qu[ki
益陽市	yi[bm yh[eo ui[wj
宜陽縣	yi[gq yh[eo xm[qs
弋陽縣	yi[qd yh[eo xm[qs
沂源縣	yi[dj yr[di xm[qs
宜章縣	yi[gq vh[lo xm[qs
儀徵市	yi[rd vg[rh ui[wj
伊州區	yi[rx vz[dp qu[ki
宜州區	yi[gq vz[dp qu[ki
銀川市	yb[jg ir[pu ui[wj
殷都區	yb[pj du[te qu[ki
銀海區	yb[jg hd[dr qu[ki
印江土家族苗族自治縣	yb[pe jl[dg tu[uh jx[gu zu[fr mn[ct zu[fr zi[pm vi[ds xm[qs
印臺區	yb[pe td[sk qu[ki
鄞州區	yb[ne vz[dp qu[ki
銀州區	yb[jg vz[dp qu[ki
應城市	yk[gx ig[tw ui[wj
英德市	yk[ck de[ru ui[wj
潁東區	yk[by ds[qx qu[ki
英吉沙縣	yk[ck ji[uk ua[dx xm[qs
迎江區	yk[pz jl[dg qu[ki
盈江縣	yk[nm jl[dg xm[qs
滎經縣	yk[cu jk[ss xm[qs
營口市	yk[ck kz[uv ui[wj
潁泉區	yk[by qr[bu qu[ki
英山縣	yk[ck uj[uk xm[qs
營山縣	yk[ck uj[uk xm[qs
潁上縣	yk[by uh[bh xm[qs
鷹手營子礦區	yk[gn uz[su yk[ck zi[lh kl[eg qu[ki
鷹潭市	yk[gn tj[dx ui[wj
應縣	yk[gx xm[qs
迎澤區	yk[pz ze[dy qu[ki
潁州區	yk[by vz[dp qu[ki
永安市	ys[dv an[gn ui[wj
永昌縣	ys[dv ih[oo xm[qs
永城市	ys[dv ig[tw ui[wj
永川區	ys[dv ir[pu qu[ki
永春縣	ys[dv iy[so xm[qs
永德縣	ys[dv de[ru xm[qs
永登縣	ys[dv dg[dd xm[qs
永定區	ys[dv dk[gp qu[ki
永豐縣	ys[dv fg[su xm[qs
永福縣	ys[dv fu[uh xm[qs
永和縣	ys[dv he[hk xm[qs
永濟市	ys[dv ji[dw ui[wj
永吉縣	ys[dv ji[uk xm[qs
永嘉縣	ys[dv jx[ul xm[qs
永靖縣	ys[dv jk[lf xm[qs
永康市	ys[dv kh[gx ui[wj
永年區	ys[dv nm[rn qu[ki
邕寧區	ys[vk nk[gd qu[ki
永寧縣	ys[dv nk[gd xm[qs
永平縣	ys[dv pk[hb xm[qs
埇橋區	ys[[ qn[ap qu[ki
永清縣	ys[dv qk[df xm[qs
永仁縣	ys[dv rf[re xm[qs
永善縣	ys[dv uj[yk xm[qs
永勝縣	ys[dv ug[op xm[qs
永壽縣	ys[dv uz[fc xm[qs
永順縣	ys[dv uy[iy xm[qs
永泰縣	ys[dv td[su xm[qs
永新縣	ys[dv xb[lj xm[qs
永興縣	ys[dv xk[xb xm[qs
永修縣	ys[dv xq[ru xm[qs
永州市	ys[dv vz[dp ui[wj
友好區	yz[uy hc[nz qu[ki
右江區	yz[uk jl[dg qu[ki
尤溪縣	yz[yd xi[da xm[qs
攸縣	yz[ru xm[qs
遊仙區	yz[df xm[ru qu[ki
酉陽土家族苗族自治縣	yz[xh yh[eo tu[uh jx[gu zu[fr mn[ct zu[fr zi[pm vi[ds xm[qs
友誼縣	yz[uy yi[yg xm[qs
右玉縣	yz[uk yu[wd xm[qs
裕安區	yu[yb an[gn qu[ki
渝北區	yu[dr bw[ub qu[ki
雨城區	yu[hk ig[tw qu[ki
禹城市	yu[pk ig[tw ui[wj
虞城縣	yu[hk ig[tw xm[qs
榆次區	yu[ar ci[dd qu[ki
于都縣	yu[eu du[te xm[qs
魚峰區	yu[dt fg[uw qu[ki
餘干縣	yu[re gj[hu xm[qs
餘杭區	yu[re hh[aw qu[ki
于洪區	yu[eu hs[dg qu[ki
雨湖區	yu[hk hu[dg qu[ki
裕華區	yu[yb hx[ru qu[ki
雨花區	yu[hk hx[cr qu[ki
雨花臺區	yu[hk hx[cr td[sk qu[ki
玉環市	yu[wd hr[wb ui[wj
禹會區	yu[pk hv[re qu[ki
餘江區	yu[re jl[dg qu[ki
尉犁縣	yu[uc li[hn xm[qs
榆林市	yu[ar lb[aa ui[wj
玉林市	yu[wd lb[aa ui[wj
玉龍納西族自治縣	yu[wd ls[yp na[sk xi[hk zu[fr zi[pm vi[ds xm[qs
玉門市	yu[wd mf[du ui[wj
裕民縣	yu[yb mb[kv xm[qs
鬱南縣	yu[ue nj[uk xm[qs
玉屏侗族自治縣	yu[wd pk[ub ds[rk zu[fr zi[pm vi[ds xm[qs
餘慶縣	yu[re qk[gd xm[qs
玉泉區	yu[wd qr[bu qu[ki
雨山區	yu[hk uj[uk qu[ki
玉山縣	yu[wd uj[uk xm[qs
榆社縣	yu[ar ue[ut xm[qs
榆樹市	yu[ar uu[ay ui[wj
玉樹市	yu[wd uu[ay ui[wj
玉樹藏族自治州	yu[wd uu[ay zh[cw zu[fr zi[pm vi[ds vz[dp
渝水區	yu[dr uv[uu qu[ki
魚臺縣	yu[dt td[sk xm[qs
于田縣	yu[eu tm[wu xm[qs
玉田縣	yu[wd tm[wu xm[qs
禹王臺區	yu[pk wh[su td[sk qu[ki
玉溪市	yu[wd xi[da ui[wj
盂縣	yu[em xm[qs
蔚縣	yu[cu xm[qs
榆陽區	yu[ar yh[eo qu[ki
餘姚市	yu[re yc[nv ui[wj
渝中區	yu[dr vs[ku qu[ki
榆中縣	yu[ar vs[ku xm[qs
玉州區	yu[wd vz[dp qu[ki
禹州市	yu[pk vz[dp ui[wj
遠安縣	yr[ez an[gn xm[qs
元寶區	yr[ee bc[gw qu[ki
元寶山區	yr[ee bc[gw uj[uk qu[ki
源城區	yr[di ig[tw qu[ki
源匯區	yr[di hv[dk qu[ki
元江哈尼族彝族傣族自治縣	yr[ee jl[dg ha[kr ni[ub zu[fr yi[vm zu[fr dd[rs zu[fr zi[pm vi[ds xm[qs
沅江市	yr[de jl[dg ui[wj
沅陵縣	yr[de lk[et xm[qs
元謀縣	yr[ee mz[yg xm[qs
原平市	yr[ib pk[hb ui[wj
垣曲縣	yr[th qu[ou xm[qs
元氏縣	yr[ee ui[pq xm[qs
元陽縣	yr[ee yh[eo xm[qs
原陽縣	yr[ib yh[eo xm[qs
原州區	yr[ib vz[dp qu[ki
袁州區	yr[tk vz[dp qu[ki
越城區	yt[zh ig[tw qu[ki
嶽池縣	yt[qu ii[dy xm[qs
月湖區	yt[ke hu[dg qu[ki
嶽麓區	yt[qu lu[ag qu[ki
嶽普湖縣	yt[qu pu[bo hu[dg xm[qs
樂清市	yt[px qk[df ui[wj
嶽塘區	yt[qu th[tg qu[ki
嶽西縣	yt[qu xi[hk xm[qs
越西縣	yt[zh xi[hk xm[qs
越秀區	yt[zh xq[hn qu[ki
岳陽樓區	yt[qu yh[eo lz[am qu[ki
岳陽市	yt[qu yh[eo ui[wj
岳陽縣	yt[qu yh[eo xm[qs
雲安區	yy[es an[gn qu[ki
云城區	yy[es ig[tw qu[ki
運城市	yy[ez ig[tw ui[wj
鄆城縣	yy[ge ig[tw xm[qs
雲浮市	yy[es fu[da ui[wj
雲岡區	yy[es gh[ki qu[ki
運河區	yy[ez he[dk qu[ki
雲和縣	yy[es he[hk xm[qs
雲龍區	yy[es ls[yp qu[ki
雲龍縣	yy[es ls[yp xm[qs
雲夢縣	yy[es mg[ax xm[qs
雲南省	yy[es nj[uk ug[xm
云溪區	yy[es xi[da qu[ki
鄖西縣	yy[ke xi[hk xm[qs
雲縣	yy[es xm[qs
雲霄縣	yy[es xn[yx xm[qs
雲巖區	yy[es yj[ue qu[ki
鄖陽區	yy[ke yh[eo qu[ki
雲陽縣	yy[es yh[eo xm[qs
雲州區	yy[es vz[dp qu[ki
雜多縣	za[ja do[xx xm[qs
贊皇縣	zj[nb hl[bw xm[qs
棗強縣	zc[cd ql[gk xm[qs
棗陽市	zc[cd yh[eo ui[wj
棗莊市	zc[cd vl[gt ui[wj
澤庫縣	ze[dy ku[gi xm[qs
澤普縣	ze[dy pu[bo xm[qs
澤州縣	ze[dy vz[dp xm[qs
增城區	zg[tb ig[tw qu[ki
曾都區	zg[bo du[te qu[ki
札達縣	va[av da[dz xm[qs
扎賚諾爾區	va[fv ld[lb no[yc er[dx qu[ki
扎賚特旗	va[fv ld[lb te[nt qi[fr
扎蘭屯市	va[fv lj[bs ty[hk ui[wj
扎魯特旗	va[fv lu[yo te[nt qi[fr
扎囊縣	va[fv nh[hk xm[qs
柞水縣	va[av uv[uu xm[qs
湛河區	vj[dq he[dk qu[ki
沾化區	vj[db hx[rq qu[ki
湛江市	vj[dq jl[dg ui[wj
站前區	vj[lb qm[bo qu[ki
沾益區	vj[db yi[bm qu[ki
張北縣	vh[gi bw[ub xm[qs
張店區	vh[gi dm[gb qu[ki
章貢區	vh[lo gs[gb qu[ki
張家川回族自治縣	vh[gi jx[gu ir[pu hv[wk zu[fr zi[pm vi[ds xm[qs
張家港市	vh[gi jx[gu gh[dg ui[wj
張家界市	vh[gi jx[gu jp[tr ui[wj
張家口市	vh[gi jx[gu kz[uv ui[wj
漳平市	vh[dl pk[hb ui[wj
漳浦縣	vh[dl pu[df xm[qs
章丘區	vh[lo qq[jh qu[ki
樟樹市	vh[al uu[ay ui[wj
張灣區	vh[gi wj[dy qu[ki
彰武縣	vh[lp wu[hv xm[qs
漳縣	vh[dl xm[qs
張掖市	vh[gi ye[fw ui[wj
漳州市	vh[dl vz[dp ui[wj
長子縣	vh[ph zi[lh xm[qs
詔安縣	vc[yd an[gn xm[qs
肇東市	vc[hy ds[qx ui[wj
昭化區	vc[od hx[rq qu[ki
昭覺縣	vc[od jt[xj xm[qs
召陵區	vc[dk lk[et qu[ki
昭平縣	vc[od pk[hb xm[qs
肇慶市	vc[hy qk[gd ui[wj
昭蘇縣	vc[od su[cl xm[qs
昭通市	vc[od ts[sz ui[wj
趙縣	vc[zi xm[qs
昭陽區	vc[od yh[eo qu[ki
招遠市	vc[fd yr[ez ui[wj
肇源縣	vc[hy yr[di xm[qs
肇州縣	vc[hy vz[dp xm[qs
柘城縣	ve[ae ig[tw xm[qs
浙江省	ve[df jl[dg ug[xm
柘榮縣	ve[ae rs[ca xm[qs
振安區	vf[fi an[gn qu[ki
鎮安縣	vf[ju an[gn xm[qs
鎮巴縣	vf[ju ba[ku xm[qs
貞豐縣	vf[bb fg[su xm[qs
鎮海區	vf[ju hd[dr qu[ki
湞江區	vf[db jl[dg qu[ki
鎮江市	vf[ju jl[dg ui[wj
鎮康縣	vf[ju kh[gx xm[qs
鎮賚縣	vf[ju ld[lb xm[qs
鎮寧布依族苗族自治縣	vf[ju nk[gd bu[uj yi[ry zu[fr mn[ct zu[fr zi[pm vi[ds xm[qs
鎮坪縣	vf[ju pk[tp xm[qs
鎮平縣	vf[ju pk[hb xm[qs
振興區	vf[fi xk[xb qu[ki
鎮雄縣	vf[ju xs[uv xm[qs
鎮原縣	vf[ju yr[ib xm[qs
鎮遠縣	vf[ju yr[ez xm[qs
鎮沅彝族哈尼族拉祜族自治縣	vf[ju yr[de yi[vm zu[fr ha[kr ni[ub zu[fr la[fl hu[ug zu[fr zi[pm vi[ds xm[qs
正安縣	vg[hv an[gn xm[qs
正定縣	vg[hv dk[gp xm[qs
政和縣	vg[hw he[hk xm[qs
正藍旗	vg[hv lj[cu qi[fr
正寧縣	vg[hv nk[gd xm[qs
正鑲白旗	vg[hv xl[jw bd[po qi[fr
蒸湘區	vg[cl xl[da qu[ki
正陽縣	vg[hv yh[eo xm[qs
鄭州市	vg[be vz[dp ui[wj
志丹縣	vi[ux dj[kw xm[qs
治多縣	vi[ds do[xx xm[qs
芝罘區	vi[cv fu[sb qu[ki
芷江侗族自治縣	vi[cv jl[dg ds[rk zu[fr zi[pm vi[ds xm[qs
枝江市	vi[au jl[dg ui[wj
織金縣	vi[sk jb[rw xm[qs
仲巴縣	vs[rv ba[ku xm[qs
中方縣	vs[ku fh[dw xm[qs
中江縣	vs[ku jl[dg xm[qs
鐘樓區	vs[jv lz[am qu[ki
中牟縣	vs[ku mu[sn xm[qs
中寧縣	vs[ku nk[gd xm[qs
中山區	vs[ku uj[uk qu[ki
鐘山區	vs[jv uj[uk qu[ki
中山市	vs[ku uj[uk ui[wj
鐘山縣	vs[jv uj[uk xm[qs
中衛市	vs[ku ww[eh ui[wj
忠縣	vs[vx xm[qs
鍾祥市	vs[jv xl[uy ui[wj
中陽縣	vs[ku yh[eo xm[qs
中原區	vs[ku yr[ib qu[ki
中站區	vs[ku vj[lb qu[ki
周村區	vz[kt cy[ac qu[ki
周口市	vz[kt kz[uv ui[wj
周寧縣	vz[kt nk[gd xm[qs
舟曲縣	vz[pk qu[ou xm[qs
舟山市	vz[pk uj[uk ui[wj
周至縣	vz[kt vi[ht xm[qs
諸城市	vu[yt ig[tw ui[wj
珠海市	vu[wp hd[dr ui[wj
珠暉區	vu[wp hv[og qu[ki
諸暨市	vu[yt ji[go ui[wj
駐馬店市	vu[md ma[vv dm[gb ui[wj
珠山區	vu[wp uj[uk qu[ki
竹山縣	vu[rr uj[uk xm[qs
竹溪縣	vu[rr xi[da xm[qs
株洲市	vu[ap vz[dd ui[wj
莊河市	vl[gt he[dk ui[wj
莊浪縣	vl[gt lh[dl xm[qs
準格爾旗	vy[dv ge[aw er[dx qi[fr
涿鹿縣	vo[du lu[gb xm[qs
卓尼縣	vo[bo ni[ub xm[qs
涿州市	vo[du vz[dp ui[wj
卓資縣	vo[bo zi[db xm[qs
淄博市	zi[dv bo[uf ui[wj
子長市	zi[lh ih[ph ui[wj
淄川區	zi[dv ir[pu qu[ki
自貢市	zi[pm gs[gb ui[wj
秭歸縣	zi[hp gv[ux xm[qs
紫金縣	zi[vy jb[rw xm[qs
自流井區	zi[pm lq[dw jk[ep qu[ki
梓潼縣	zi[al ts[dl xm[qs
資溪縣	zi[db xi[da xm[qs
資興市	zi[db xk[xb ui[wj
資陽區	zi[db yh[eo qu[ki
資陽市	zi[db yh[eo ui[wj
紫陽縣	zi[vy yh[eo xm[qs
資源縣	zi[db yr[di xm[qs
紫云苗族布依族自治縣	zi[vy yy[es mn[ct zu[fr bu[uj yi[ry zu[fr zi[pm vi[ds xm[qs
資中縣	zi[db vs[ku xm[qs
子洲縣	zi[lh vz[dd xm[qs
樅陽縣	zs[ar yh[eo xm[qs
鄒城市	zz[de ig[tw ui[wj
鄒平市	zz[de pk[hb ui[wj
遵化市	zy[bz hx[rq ui[wj
遵義市	zy[bz yi[di ui[wj
左貢縣	zo[ug gs[gb xm[qs
左權縣	zo[ug qr[ay xm[qs
左雲縣	zo[ug yy[es xm[qs
