阿多諾	aa[ek do[xx no[yc
阿爾都塞	aa[ek er[dx du[te sd[gt
阿加德米	aa[ek jx[lk de[ru mi[ba
阿賴耶識	aa[ek ld[hd ye[ee ui[yk
阿里斯托勒斯	aa[ek li[ot si[qj to[fp le[gl si[qj
阿摩尼阿斯	aa[ek mo[gf ni[ub aa[ek si[qj
阿摩尼阿斯薩卡斯	aa[ek mo[gf ni[ub aa[ek si[qj sa[ce ka[ub si[qj
阿那克薩戈拉	aa[ek na[ve ke[ge sa[ce ge[qp la[fl
阿那克西曼德	aa[ek na[ve ke[ge xi[hk mj[os de[ru
阿納克西曼德	aa[ek na[sk ke[ge xi[hk mj[os de[ru
阿那克西美尼	aa[ek na[ve ke[ge xi[hk mw[bw ni[ub
阿納克西美尼	aa[ek na[sk ke[ge xi[hk mw[bw ni[ub
阿那克西米尼	aa[ek na[ve ke[ge xi[hk mi[ba ni[ub
阿菩黎阿黎	aa[ek pu[cl li[hr aa[ek li[hr
阿屯	aa[ek ty[hk
愛比克泰德	ai[au bi[bb ke[ge td[su de[ru
愛非斯	ai[au fw[su si[qj
艾菲索斯	ai[ci fw[cf so[uy si[qj
愛力	ai[au li[vp
愛利亞派	ai[au li[hd ya[hy pd[dp
愛利亞學派	ai[au li[hd ya[hy xt[xz pd[dp
艾思奇	ai[ci si[tx qi[dk
愛無尋差	ai[au wu[ee xy[xc ia[yg
愛智	ai[au vi[uo
安般守意	an[gn bj[vj uz[gc yi[lx
暗極則光	an[ol ji[aj ze[bd gl[xe
安年柯夫	an[gn nm[rn ke[ak fu[er
安貧樂道	an[gn pb[fb le[px dc[bz
安時處順	an[gn ui[oc iu[wb uy[iy
安世高	an[gn ui[nv gc[wk
安提斯泰尼	an[gn ti[fo si[qj td[su ni[ub
安性樂命	an[gn xk[xp le[px mk[rh
案兆察跡	an[ga vc[eu ia[gx ji[yz
奧伏赫變	ao[pd fu[rq he[tt bm[yy
奧古斯丁	ao[pd gu[uk si[qj dk[hu
奧勒留	ao[pd le[gl lq[pt
八不中道	ba[pd bu[eu vs[ku dc[bz
罷黜百家	ba[st iu[hi bd[eo jx[gu
巴枯寧	ba[ku ku[ag nk[gd
巴曼尼得斯篇	ba[ku mj[os ni[ub de[ro si[qj pm[vh
巴門尼德	ba[ku mf[du ni[ub de[ru
巴門尼德畢達哥拉斯	ba[ku mf[du ni[ub de[ru bi[bu da[dz ge[kk la[fl si[qj
八識	ba[pd ui[yk
八正	ba[pd vg[hv
八正道	ba[pd vg[hv dc[bz
百代同道	bd[eo dd[rq ts[kh dc[bz
白狗黑	bd[po gz[qb hw[sd
捭闔術	bd[fb he[mt uu[ad
白馬非馬	bd[po ma[vv fw[su ma[vv
百姓日用之學	bd[eo xk[np ri[wh ys[ou vi[dv xt[xz
百戰不殆	bd[eo vj[bg bu[eu dd[hs
班固	bj[wd gu[wg
般舟三昧	bj[vj vz[pk sj[hh mw[oh
抱法處勢	bc[fb fa[dt iu[wb ui[fl
葆光	bc[cr gl[xe
保教非尊孔	bc[rk jn[tw fw[su zy[bc ks[zv
鮑敬言	bc[yb jk[cw yj[we
抱朴子	bc[fb pu[ab zi[lh
包世臣	bc[bk ui[nv if[ku
鮑威爾	bc[yb ww[wh er[dx
葆真	bc[cr vf[uj
被繼承	bw[yp ji[sm ig[lu
貝萊	bw[kr ld[cl
被譽為	bw[yp yu[xy ww[dl
本根	bf[ah gf[ag
本寂	bf[ah ji[gu
本覺	bf[ah jt[xj
本末	bf[ah mo[ha
本然	bf[ah rj[xd
本始	bf[ah ui[ns
本體	bf[ah ti[ra
本無	bf[ah wu[ee
本心	bf[ah xb[dv
本原	bf[ah yr[ib
本質換出一般	bf[ah vi[pu hr[fd iu[ck yi[hh bj[vj
彼岸世界	bi[rp an[ui ui[nv jp[tr
畢達哥拉斯學派	bi[bu da[dz ge[kk la[fl si[qj xt[xz pd[dp
比德	bi[bb de[ru
辟穀	bi[ul gu[bk
壁觀	bi[ut gr[yj
必開心意	bi[xp kd[hc xb[dv yi[lx
比量	bi[bb ll[oh
必然王國	bi[xp rj[xd wh[su go[ww
必然性	bi[xp rj[xd xk[xp
彼是相因	bi[rp ui[op xl[am yb[wd
比相生	bi[bb xl[am ug[pf
彼亦一是非	bi[rp yi[wy yi[hh ui[op fw[su
蔽於一曲闇於大理	bi[cb yu[eu yi[hh qu[ou an[[ yu[eu da[hr li[wo
畢沅	bi[bu yr[de
裨灶	bi[yb zc[ht
辨對待	bm[ld dv[yc dd[rt
變非不變	bm[yy fw[su bu[eu bm[yy
變故易常	bm[yy gu[gw yi[ob ih[xk
變古愈盡	bm[yy gu[uk yu[rx jb[ud
辨合	bm[ld he[rh
變化氣質	bm[yy hx[rq qi[rh vi[pu
遍計所執性	bm[hz ji[yu so[pj vi[fj xk[xp
便民愈甚	bm[rh mb[kv yu[rx uf[qv
變器衛道	bm[yy qi[kq ww[eh dc[bz
辯說	bm[ly uo[yb
辯無勝	bm[ly wu[ee ug[op
辯者二十一事	bm[ly ve[to er[hh ui[hu yi[hh ui[hk
辯證否定觀	bm[ly vg[yh fz[bk dk[gp gr[yj
辯證唯物主義	bm[ly vg[yh ww[kv wu[nb vu[dw yi[di
表詮	bn[fy qr[yr
表現出	bn[fy xm[wj iu[ck
別材	bp[kd cd[ac
別名	bp[kd mk[xk
別趣	bp[kd qu[ze
別同異	bp[kd ts[kh yi[kc
別宥	bp[kd yz[gu
並稱為	bk[bk ig[hd ww[dl
冰炭不同器而久	bk[du tj[uu bu[eu ts[kh qi[kq er[ek jq[xd
博愛	bo[uf ai[au
博愛哲學	bo[uf ai[au ve[fk xt[xz
撥本塞源	bo[fv bf[ah sd[gt yr[di
伯恩施坦	bo[rb en[wx ui[fr tj[to
波菲利	bo[dp fw[cf li[hd
帛和	bo[bj he[hk
柏拉圖主義	bo[ab la[fl tu[ww vu[dw yi[di
波羅蜜	bo[dp lo[sx mi[gi
剝落物慾	bo[xd lo[cd wu[nb yu[bd
般若	bo[vj re[cu
般若無知	bo[vj re[cu wu[ee vi[uk
博通能用	bo[uf ts[sz ng[sb ys[ou
博文約禮	bo[uf wf[wi yt[sb li[uv
波昔東尼	bo[dp xi[go ds[qx ni[ub
博學篤志	bo[uf xt[xz du[vm vi[ux
伯陽父	bo[rb yh[eo fu[bi
伯陽甫	bo[rb yh[eo fu[uo
博約	bo[uf yt[sb
不必擔心	bu[eu bi[xp dj[fo xb[dv
不誠無物	bu[eu ig[yw wu[ee wu[nb
布袋和尚	bu[uj dd[ry he[hk uh[xk
不得經同	bu[eu de[ro jk[ss ts[kh
不動心	bu[eu ds[el xb[dv
不二	bu[eu er[hh
不二法門	bu[eu er[hh fa[dt mf[du
布哈林	bu[uj ha[kr lb[aa
不可使知之	bu[eu ke[dk ui[rh vi[uk vi[dv
不可知論	bu[eu ke[dk vi[uk ly[yr
不可知之事	bu[eu ke[dk vi[uk vi[dv ui[hk
不空	bu[eu ks[xg
布洛赫	bu[uj lo[dw he[tt
不平則鳴	bu[eu pk[hb ze[bd mk[kn
不譴是非以與世俗處	bu[eu qm[yv ui[op fw[su yi[sr yu[hv ui[nv su[rb iu[wb
不忍人之心	bu[eu rf[dx rf[pd vi[dv xb[dv
卜商	bu[ud uh[lk
卜筮	bu[ud ui[vg
不是而然	bu[eu ui[op er[ek rj[xd
不似之似	bu[eu si[rs vi[dv si[rs
不徒耳目	bu[eu tu[rz er[hu mu[we
不為而成	bu[eu ww[dl er[ek ig[wv
不行而知	bu[eu xk[rh er[ek vi[uk
不學未必為長夜	bu[eu xt[xz ww[ha bi[xp ww[dl vh[ph ye[wr
不依賴於	bu[eu yi[ry ld[hd yu[eu
不以人助天	bu[eu yi[sr rf[pd vu[ql tm[hd
不豫則廢	bu[eu yu[yd ze[bd fw[gv
不再存在	bu[eu zd[hk cy[uz zd[ut
不真空	bu[eu vf[uj ks[xg
不知廉恥	bu[eu vi[uk lm[gb ii[ev
不知所以因而自因	bu[eu vi[uk so[pj yi[sr yb[wd er[ek zi[pm yb[wd
不知亦能行	bu[eu vi[uk yi[wy ng[sb xk[rh
不知之知	bu[eu vi[uk vi[dv vi[uk
不知之知與不識之知	bu[eu vi[uk vi[dv vi[uk yu[hv bu[eu ui[yk vi[dv vi[uk
蔡墨	cd[cx mo[ht
才情	cd[hu qk[xf
蔡尚思	cd[cx uh[xk si[tx
蔡沈	cd[cx uf[dg
才性	cd[hu xk[xp
才性合	cd[hu xk[xp he[rh
才性離	cd[hu xk[xp li[wk
才性四本	cd[hu xk[xp si[we bf[ah
才性四本論	cd[hu xk[xp si[we bf[ah ly[yr
才性同	cd[hu xk[xp ts[kh
才性異	cd[hu xk[xp yi[kc
才性異同	cd[hu xk[xp yi[kc ts[kh
才性之辨	cd[hu xk[xp vi[dv bm[ld
才性之學	cd[hu xk[xp vi[dv xt[xz
蔡邕	cd[cx ys[vk
蔡元定	cd[cx yr[ee dk[gp
蔡元培	cd[cx yr[ee pw[tl
參兩	cj[sd ll[hk
參天兩地	cj[sd tm[hd ll[hk di[ty
參伍之道	cj[sd wu[rw vi[dv dc[bz
參驗	cj[sd yj[mr
倉廩實而知禮節	ch[re lb[gw ui[gd er[ek vi[uk li[uv jp[ce
曹褒	cc[ho bc[wr
曹端	cc[ho dr[lu
操術	cc[fk uu[ad
曹思文	cc[ho si[tx wf[wi
曹植	cc[ho vi[au
側隱之心	ce[rb yb[ed vi[dv xb[dv
曾琦	cg[bo qi[wd
察類	ia[gx lw[md
剎那	ia[id na[ve
察身以知天	ia[gx uf[pu yi[sr vi[uk tm[hd
察識端倪	ia[gx ui[yk dr[lu ni[rj
禪定	ij[ub dk[gp
禪機	ij[ub ji[aj
產生矛盾	ij[lp ug[pf mc[yp dy[pu
闡提	ij[mb ti[fo
纏子	ij[sg zi[lh
禪宗美學	ij[ub zs[ge mw[bw xt[xz
昌必有衰	ih[oo bi[xp yz[uo uk[wk
常變	ih[xk bm[yy
長春真人	ih[ph iy[so vf[uj rf[pd
常道	ih[xk dc[bz
常德	ih[xk de[ru
長沮	ih[ph ju[dq
常名	ih[xk mk[xk
常權	ih[xk qr[ay
常統常變	ih[xk ts[sw ih[xk bm[yy
常無有	ih[xk wu[ee yz[uo
朝徹	ic[uo ie[rq
晁錯	ic[ov co[jg
陳白沙	if[eq bd[po ua[dx
陳熾	if[eq ii[hk
陳淳	if[eq iy[dw
陳獨秀	if[eq du[qi xq[hn
陳傅良	if[eq fu[rf ll[dg
陳鼓應	if[eq gu[uu yk[gx
陳煥章	if[eq hr[hd vh[lo
陳榥	if[eq hl[[
陳家康	if[eq jx[gu kh[gx
陳建	if[eq jm[yj
塵芥六合	if[xt jp[cr lu[wb he[rh
陳景元	if[eq jk[ow yr[ee
陳九川	if[eq jq[pv ir[pu
陳澧	if[eq li[dq
陳立	if[eq li[lh
陳立夫	if[eq li[lh fu[er
陳亮	if[eq ll[wj
陳龍川	if[eq ls[yp ir[pu
陳駢	if[eq pm[mb
陳啟天	if[eq qi[hk tm[hd
陳虯	if[eq qq[iv
陳銓	if[eq qr[jr
陳確	if[eq qt[ed
陳榮捷	if[eq rs[ca jp[fh
沉思冥想	if[dg si[tx mk[go xl[ax
陳天華	if[eq tm[hd hx[ru
陳同甫	if[eq ts[kh fu[uo
陳摶	if[eq tr[fe
讖緯	if[yr ww[sw
陳唯實	if[eq ww[kv ui[gd
陳獻章	if[eq xm[uq vh[lo
陳祥道	if[eq xl[uy dc[bz
陳櫻寧	if[eq yk[ab nk[gd
陳元暉	if[eq yr[ee hv[og
陳仲	if[eq vs[rv
陳朱之辯	if[eq vu[ph vi[dv bm[ly
程端禮	ig[hk dr[lu li[uv
程端蒙	ig[hk dr[lu mg[ch
懲忿窒欲	ig[rx ff[fx vi[xh yu[bd
承負	ig[lu fu[db
成公綏	ig[wv gs[bs sv[sa
澄觀	ig[dd gr[yj
程顥	ig[hk hc[oy
澄懷味象	ig[dd hk[xb ww[kh xl[dk
成極	ig[wv ji[aj
成己成物	ig[wv ji[kv ig[wv wu[nb
程門立雪	ig[hk mf[du li[lh xt[yx
誠明	ig[yw mk[oo
程明道	ig[hk mk[oo dc[bz
成天地者氣也	ig[wv tm[hd di[ty ve[to qi[rh ye[vu
程廷祚	ig[hk tk[qj zo[uv
乘物遊心	ig[qb wu[nb yz[df xb[dv
成心	ig[wv xb[dv
成玄英	ig[wv xr[wy yk[ck
程瑤田	ig[hk yc[wa tm[wu
誠意	ig[yw yi[lx
程頤	ig[hk yi[ky
程伊川	ig[hk yi[rx ir[pu
成於樂	ig[wv yu[eu le[px
成中英	ig[wv vs[ku yk[ck
尺棰不盡	ii[ud iv[ai bu[eu jb[ud
持戒	ii[ft jp[gc
崇本息末	is[ug bf[ah xi[zx mo[ha
崇本抑末	is[ug bf[ah yi[fp mo[ha
沖決網羅	is[dv jt[dv wh[ki lo[sx
充滿瑕疵	is[we mj[dc xx[wk ci[bv
衝氣	is[dv qi[rh
崇尚知識	is[ug uh[xk vi[uk ui[yk
蹱事增華	is[[ ui[hk zg[tb hx[ru
充實之美	is[we ui[gd vi[dv mw[bw
崇有	is[ug yz[uo
處靜	iu[wb jk[fd
楚狂接輿	iu[ap kl[qw jp[fl yu[pb
觸類是道	iu[di lw[md ui[op dc[bz
出世間	iu[ck ui[nv jm[mo
儲泳	iu[ry ys[dd
傳神	ir[re uf[uo
傳神記	ir[re uf[uo ji[yk
創造的科學	il[rd zc[nz de[bb ke[hd xt[xz
純客觀法	iy[st ke[gw gr[yj fa[dt
純思維	iy[st si[tx ww[sv
慈悲	ci[bx bw[fx
雌節	ci[vv jp[ce
辭讓之心	ci[ql rh[yu vi[dv xb[dv
雌雄剛柔之辨	ci[vv xs[uv gh[kd rz[ya vi[dv bm[ld
此亦一是非	ci[vb yi[wy yi[hh ui[op fw[su
猝然念得	cu[qw rj[xd nm[rx de[ro
崔浩	cv[uv hc[dn
崔憬	cv[uv jk[xo
粹靈之氣	cv[mw lk[xh vi[dv qi[rh
崔適	cv[uv ui[qz
崔寔	cv[uv ui[[
崔述	cv[uv uu[az
存神	cy[uz uf[uo
存思	cy[uz si[tx
存天理	cy[uz tm[hd li[wo
存想	cy[uz xl[ax
存心	cy[uz xb[dv
存疑主義	cy[uz yi[bs vu[dw yi[di
大辯	da[hr bm[ly
大別名	da[hr bp[kd mk[xk
大膽假設小心求證	da[hr dj[oo jx[rk ue[yj xn[ub xb[dv qq[hu vg[yh
達道	da[dz dc[bz
大盜不止	da[hr dc[dm bu[eu vi[uh
打倒孔家店	da[fd dc[rh ks[zv jx[gu dm[gb
達德	da[dz de[ru
大動力	da[hr ds[el li[vp
大共名	da[hr gs[gb mk[xk
大故	da[hr gu[gw
大九州說	da[hr jq[pv vz[dp uo[yb
大理	da[hr li[wo
達理明義	da[dz li[wo mk[oo yi[di
大美	da[hr mw[bw
達名	da[dz mk[xk
達摩	da[dz mo[gf
大貧小貧說	da[hr pb[fb xn[ub pb[fb uo[yb
大巧	da[hr qn[gk
大清明	da[hr qk[df mk[oo
達生	da[dz ug[pf
達視洞聽	da[dz ui[uj ds[dk tk[kj
大體	da[hr ti[ra
大同	da[hr ts[kh
大同異	da[hr ts[kh yi[kc
大小戴	da[hr xn[ub dd[tt
大小俱足	da[hr xn[ub ju[rj zu[kv
大小夏侯	da[hr xn[ub xx[ew hz[rv
大心	da[hr xb[dv
大衍義	da[hr yj[rd yi[di
大衍之數	da[hr yj[rd vi[dv uu[mw
大一統	da[hr yi[hh ts[sw
大音	da[hr yb[lo
大用流行	da[hr ys[ou lq[dw xk[rh
大丈夫	da[hr vh[hi fu[er
大知大覺	da[hr vi[uk da[hr jn[xj
大中之道	da[hr vs[ku vi[dv dc[bz
戴奧真尼斯	dd[tt ao[pd vf[uj ni[ub si[qj
代表人物	dd[rq bn[fy rf[pd wu[nb
戴德	dd[tt de[ru
戴東原	dd[tt ds[qx yr[ib
戴季陶	dd[tt ji[hz tc[eb
戴逵	dd[tt kv[tz
戴聖	dd[tt ug[yt
戴望	dd[tt wh[ww
戴震	dd[tt vf[yi
單名與兼名	dj[bo mk[xk yu[hv jm[bh mk[xk
丹書	dj[kw uu[vv
擔水砍柴無非妙道	dj[fo uv[uu kj[ed id[va wu[ee fw[su mn[nx dc[bz
當然	dh[xx rj[xd
道安	dc[bz an[gn
道本器末	dc[bz bf[ah qi[kq mo[ha
道不可變	dc[bz bu[eu ke[dk bm[yy
道綽	dc[bz io[sb
道德革命	dc[bz de[ru ge[nk mk[rh
道德天尊	dc[bz de[ru tm[hd zy[bc
道德完善	dc[bz de[ru wj[ge uj[yk
道德修養	dc[bz de[ru xq[ru yh[yp
道德原則	dc[bz de[ru yr[ib ze[bd
道德哲學	dc[bz de[ru ve[fk xt[xz
道法	dc[bz fa[dt
道法自然	dc[bz fa[dt zi[pm rj[xd
道紀	dc[bz ji[sk
道即是藝	dc[bz ji[ge ui[op yi[cv
道稽萬理	dc[bz ji[hy wj[hv li[wo
倒見	dc[rh jm[ke
道理	dc[bz li[wo
道理相應	dc[bz li[wo xl[am yk[gx
道器	dc[bz qi[kq
道生	dc[bz ug[pf
道生頓悟義	dc[bz ug[pf dy[ty wu[xw yi[di
道生法	dc[bz ug[pf fa[dt
道術	dc[bz uu[ad
道樞	dc[bz uu[ak
道體器用	dc[bz ti[ra qi[kq ys[ou
道統說	dc[bz ts[sw uo[yb
道心	dc[bz xb[dv
道宣	dc[bz xr[gh
道一	dc[bz yi[hh
盜亦有道	dc[dm yi[wy yz[uo dc[bz
導引	dc[kc yb[gu
道在物中	dc[bz zd[ut wu[nb vs[ku
德本財末	de[ru bf[ah cd[bc mo[ha
得本知末	de[ro bf[ah vi[uk mo[ha
德操	de[ru cc[fk
德勒斯	de[ru le[gl si[qj
德力	de[ru li[vp
德里達	de[ru li[ot da[dz
德謨克利特	de[ru mo[yc ke[ge li[hd te[nt
德虐相成	de[ru nt[hk xl[am ig[wv
德清	de[ru qk[df
德先生	de[ru xm[ne ug[pf
得象忘言	de[ro xl[dk wh[wx yj[we
德行	de[ru xk[rh
德性之知	de[ru xk[xp vi[dv vi[uk
得意忘象	de[ro yi[lx wh[wx xl[dk
德治	de[ru vi[ds
德智主義	de[ru vi[uo vu[dw yi[di
登高必自卑	dg[dd gc[wk bi[xp zi[pm bw[bu
鄧陵氏	dg[ye lk[et ui[pq
鄧陵子	dg[ye lk[et zi[lh
鄧牧	dg[ye mu[nw
鄧析	dg[ye xi[aj
鄧析子	dg[ye xi[aj zi[lh
鄧顯鶴	dg[ye xm[oy he[gn
鄧演達	dg[ye yj[dg da[dz
鄧以蟄	dg[ye yi[sr ve[fi
狄奧根尼	di[qh ao[pd gf[ag ni[ub
迪奧吉尼士	di[yz ao[pd ji[uk ni[ub ui[uh
地道	di[ty dc[bz
狄德羅	di[qh de[ru lo[sx
第歐根尼	di[vg ou[kd gf[ag ni[ub
敵我分明	di[qw wo[pf ff[bd mk[oo
第一哲學	di[vg yi[hh ve[fk xt[xz
地有常數	di[ty yz[uo ih[xk uu[mw
地中海沿岸	di[ty vs[ku hd[dr yj[dj an[ui
電氣	dm[ov qi[rh
丁福保	dk[hu fu[uh bc[rk
定慧	dk[gp hv[fx
定名與虛位	dk[gp mk[xk yu[hv xu[hy ww[rl
丁文江	dk[hu wf[wi jl[dg
丁子有尾	dk[hu zi[lh yz[uo ww[um
動必有機	ds[el bi[xp yz[uo ji[aj
動的邏輯	ds[el de[bb lo[sz ji[ik
動的文明	ds[el de[bb wf[wi mk[oo
東方神祕主義	ds[qx fh[dw uf[uo mi[hx vu[dw yi[di
動非自外	ds[el fw[su zi[pm wd[xb
動靜互涵	ds[el jk[fd hu[hv hj[dl
動靜皆動	ds[el jk[fd jp[bb ds[el
董無心	ds[cp wu[ee xb[dv
東西文化論戰	ds[qx xi[hk wf[wi hx[rq ly[yr vj[bg
動心忍性	ds[el xb[dv rf[dx xk[xp
動則成昏	ds[el ze[bd ig[wv hy[uo
董仲舒	ds[cp vs[rv uu[ry
鬥爭性	dz[du vg[dx xk[xp
杜弼	du[at bi[ge
杜光庭	du[at gl[xe tk[gq
杜國庠	du[at go[ww xl[gy
獨化	du[qi hx[rq
獨化於玄冥之境	du[qi hx[rq yu[eu xr[wy mk[go vi[dv jk[tl
獨立存在	du[qi li[lh cy[uz zd[ut
杜林	du[at lb[aa
獨生而無所資借	du[qi ug[pf er[ek wu[ee so[pj zi[db jp[rg
杜守素	du[at uz[gc su[fy
杜順	du[at uy[iy
獨頭無明	du[qi tz[dd wu[ee mk[oo
獨頭意識	du[qi tz[dd yi[lx ui[yk
杜武庫	du[at wu[hv ku[gi
獨心	du[qi xb[dv
獨性	du[qi xk[xp
篤行	du[vm xk[rh
獨知獨覺	du[qi vi[uk du[qi jt[xj
端木賜	dr[lu mu[ub ci[bo
對待	dv[yc dd[rt
對奪	dv[yc do[dc
對戡法	dv[yc kj[qg fa[dt
對抗性矛盾	dv[yc kh[fw xk[xp mc[yp dy[pu
對立起來	dv[yc li[lh qi[zk ld[hm
對立統一	dv[yc li[lh ts[sw yi[hh
對生	dv[yc ug[pf
對物	dv[yc wu[nb
對應詞彙	dv[yc yk[gx ci[yv hv[dk
對爭	dv[yc vg[dx
頓超直悟	dy[ty ic[zd vi[uj wu[xw
鈍根	dy[jt gf[ag
頓漸之爭	dy[ty jm[di vi[dv vg[dx
遁天背情	dy[pz tm[hd bw[bo qk[xf
頓悟	dy[ty wu[xw
多元認識論	do[xx yr[ee rf[yr ui[yk ly[yr
多中一	do[xx vs[ku yi[hh
鵝湖之會	ee[pn hu[dg vi[dv hv[re
恩培多克勒	en[wx pw[tl do[xx ke[ge le[gl
二柄	er[hh bk[ah
二諦	er[hh di[yl
二而一	er[hh er[ek yi[hh
耳目之官	er[hu mu[we vi[dv gr[gu
耳目之實	er[hu mu[we vi[dv ui[gd
兒說	er[[ uo[yb
二無一	er[hh wu[ee yi[hh
而指非指	er[ek vi[fb fw[su vi[fb
法度	fa[dt du[gn
法后王	fa[dt hz[pk wh[su
法界	fa[dt jp[tr
法界緣起	fa[dt jp[tr yr[sv qi[zk
法琳	fa[dt lb[wa
法律篇	fa[dt lv[ry pm[vh
法生於義	fa[dt ug[pf yu[eu yi[di
法式	fa[dt ui[qg
法術勢	fa[dt uu[ad ui[fl
法順	fa[dt uy[iy
法天貴真	fa[dt tm[hd gv[vb vf[uj
法統	fa[dt ts[sw
法顯	fa[dt xm[oy
法先王	fa[dt xm[ne wh[su
發現真理	fa[vy xm[wj vf[uj li[wo
法象	fa[dt xl[dk
法相	fa[dt xl[am
法性	fa[dt xk[xp
法演	fa[dt yj[dg
法眼	fa[dt yj[mg
法藏	fa[dt zh[cw
發展哲學	fa[vy vj[ug ve[fk xt[xz
法哲學	fa[dt ve[fk xt[xz
法執	fa[dt vi[fj
泛愛萬物	fj[dp ai[au wj[hv wu[nb
反本	fj[py bf[ah
樊遲	fj[ad ii[uz
範疇	fj[cd iz[tf
犯而不校	fj[qe er[ek bu[eu jn[al
反覆	fj[py fu[ro
反覆問答	fj[py fu[ro wf[mk da[vr
反觀	fj[py gr[yj
泛架構主義	fj[dp jx[la gz[ab vu[dw yi[di
反經行權	fj[py jk[ss xk[rh qr[ay
范蠡	fj[cd li[vi
煩惱障	fj[hy nc[xw vh[el
反求諸己	fj[py qq[hu vu[yt ji[kv
反求自識	fj[py qq[hu zi[pm ui[yk
反身而誠	fj[py uf[pu er[ek ig[yw
範壽康	fj[cd uz[fc kh[gx
范文瀾	fj[cd wf[wi lj[dm
凡物必合	fj[jd wu[nb bi[xp he[rh
樊須	fj[ad xu[py
樊遜	fj[ad xy[zz
反衍	fj[py yj[rd
反因	fj[py yb[wd
反映論	fj[py yk[ok ly[yr
反者道之動	fj[py ve[to dc[bz vi[dv ds[el
範縝	fj[cd vf[su
范仲淹	fj[cd vs[rv yj[dd
方苞	fh[dw bc[cb
方便	fh[dw bm[rh
放達	fh[fw da[dz
方東美	fh[dw ds[qx mw[bw
方東樹	fh[dw ds[qx uu[ay
方會	fh[dw hv[re
方術	fh[dw uu[ad
防微杜漸	fh[ef ww[ru du[at jm[di
方孝孺	fh[dw xn[tz ru[zy
方以智	fh[dw yi[sr vi[uo
方植之	fh[dw vi[au vi[dv
非常激烈	fw[su ih[xk ji[db lp[hd
非道弘人	fw[su dc[bz hs[gs rf[pd
斐德羅篇篇	fw[fw de[ru lo[sx pm[vh pm[vh
斐多篇	fw[fw do[xx pm[vh
費爾巴哈	fw[fb er[dx ba[ku ha[kr
非攻	fw[su gs[gw
非樂	fw[su le[px
斐利布斯篇	fw[fw li[hd bu[uj si[qj pm[vh
菲力帕斯篇	fw[cf li[vp pa[jb si[qj pm[vh
非量	fw[su ll[oh
菲羅索菲亞	fw[cf lo[sx so[uy fw[cf ya[hy
費密	fw[fb mi[gu
非命	fw[su mk[rh
非命尚力	fw[su mk[rh uh[xk li[vp
飛鳥之景未嘗動	fw[vp nn[nh vi[dv jk[ow ww[ha ih[xe ds[el
非耦	fw[su ou[lo
非氣質無以見性	fw[su qi[rh vi[pu wu[ee yi[sr jm[ke xk[xp
廢然之靜	fw[gv rj[xd vi[dv jk[fd
非人者必有以易之	fw[su rf[pd ve[to bi[xp yz[uo yi[sr yi[ob vi[dv
飛昇	fw[vp ug[pc
非聖無法	fw[su ug[yt wu[ee fa[dt
非湯武而薄周孔	fw[su th[dv wu[hv er[ek bo[cd vz[kt ks[zv
非以其名也	fw[su yi[sr qi[cb mk[xk ye[vu
費直	fw[fb vi[uj
非宗教精神	fw[su zs[ge jn[tw jk[mf uf[uo
分理	ff[bd li[wo
分命	ff[bd mk[rh
憤世嫉俗	ff[xu ui[nv ji[nb su[rb
分知分行	ff[bd vi[uk ff[bd hh[rh
奉常處變	fg[sf ih[xk iu[wb bm[yy
馮定	fg[dm dk[gp
風骨	fg[ji gu[ko
馮桂芬	fg[dm gv[at ff[cf
風教	fg[ji jn[tw
馮契	fg[dm qi[fd
奉天法古	fg[sf tm[hd fa[dt gu[uk
馮文潛	fg[dm wf[wi qm[de
馮友蘭	fg[dm yz[uy lj[bs
佛法	fo[rf fa[dt
佛性	fo[rf xk[xp
拂塵看淨	fu[ff if[xt kj[fm jk[dd
傅嘏	fu[rf gu[gk
富貴在錢	fu[gh gv[vb zd[ut qm[jj
富貴在天	fu[gh gv[vb zd[ut tm[hd
傅立葉	fu[rf li[lh ye[ku
符籙	fu[vr lu[vx
負面	fu[db mm[ew
覆命	fu[ro mk[rh
符命	fu[vr mk[rh
傅青主	fu[rf qk[fo vu[dw
符瑞	fu[vr rv[wu
傅山	fu[rf uj[uk
伏勝	fu[rq ug[op
伏生	fu[rq ug[pf
服食	fu[oe ui[rl
符書	fu[vr uu[vv
傅斯年	fu[rf si[qj nm[rn
傅偉勳	fu[rf ww[rw xy[kl
復性	fu[ro xk[xp
傅玄	fu[rf xr[wy
符驗	fu[vr yj[mr
傅奕	fu[rf yi[yd
負陰而抱陽	fu[db yb[eo er[ek bc[fb yh[eo
付之天均	fu[rc vi[dv tm[hd jy[tb
蓋公	gd[bm gs[bs
改過遷善	gd[kw go[cz qm[qz uj[yk
概念	gd[ag nm[rx
概念範疇	gd[ag nm[rx fj[cd iz[tf
蓋天說	gd[bm tm[hd uo[yb
概要觀點	gd[ag yc[xn gr[yj dm[bd
改正朔	gd[kw vg[hv uo[no
感觀	gj[wx gr[yj
幹吉	gj[hu ji[uk
感覺和理性	gj[wx jt[xj he[hk li[wo xk[xp
感覺靈敏	gj[wx jt[xj lk[xh mb[rw
幹室	gj[hu ui[gh
感相	gj[wx xl[am
感興	gj[wx xk[xb
感性認識	gj[wx xk[xp rf[yr ui[yk
敢咬敢鬥	gj[vw yc[kl gj[vw dz[du
剛柔	gh[kd rz[ya
剛毅木訥	gh[kd yi[lj mu[ub ne[yk
高岸為谷	gc[wk an[ui ww[dl gu[bk
高度發展	gc[wk du[gn fa[vy vj[ug
高爾吉亞	gc[wk er[dx ji[uk ya[hy
高爾吉亞篇	gc[wk er[dx ji[uk ya[hy pm[vh
高拱	gc[wk gs[fg
高亨	gc[wk hg[wl
高攀龍	gc[wk pj[ad ls[yp
高清海	gc[wk qk[df hd[dr
高相	gc[wk xl[am
高誘	gc[wk yz[yh
告子	gc[nk zi[lh
個別特徵	ge[ru bp[kd te[nt vg[rh
革不必世	ge[nk bu[eu bi[xp ui[nv
革故鼎新	ge[nk gu[gw dk[mv xb[lj
格合外內	ge[aw he[rh wd[xb nw[kr
葛洪	ge[co hs[dg
葛蘭西	ge[co lj[bs xi[hk
革命	ge[nk mk[rh
革命性	ge[nk mk[rh xk[xp
格式	ge[aw ui[qg
革天	ge[nk tm[hd
格物	ge[aw wu[nb
格物致知	ge[aw wu[nb vi[hw vi[uk
格心	ge[aw xb[dv
葛玄	ge[co xr[wy
格義	ge[aw yi[di
格致	ge[aw vi[hw
格致相因	ge[aw vi[hw xl[am yb[wd
根本變化	gf[ag bf[ah bm[yy hx[rq
根本原因	gf[ag bf[ah yr[ib yb[wd
根由	gf[ag yz[ou
耿定向	gg[eh dk[gp xl[pk
更化	gg[ho hx[rq
更有名	gg[ho yz[uo mk[xk
耕戰	gg[le vj[bg
公案	gs[bs an[ga
共比量	gs[gb bi[bb ll[oh
公德	gs[bs de[ru
龔定庵	gs[yg dk[gp an[gd
公都子	gs[bs dz[te zi[lh
工夫所至	gs[hu fu[er so[pj vi[ht
恭敬之心	gs[gx jk[cw vi[dv xb[dv
恭寬信敏惠	gs[gx kr[gc xb[ry mb[rw hv[hx
公例	gs[bs li[rh
功利	gs[gl li[hd
公孟子	gs[bs mg[zm zi[lh
共名與別名	gs[gb mk[xk yu[hv bp[kd mk[xk
功能	gs[gl ng[sb
弓矢從的	gs[kv ui[rd cs[rr de[bb
攻守異勢與攻取異術	gs[gw uz[gc yi[kc ui[fl yu[hv gs[gw qu[ey yi[kc uu[ad
公輸班	gs[bs uu[ir bj[wd
公孫丑	gs[bs sy[zx iz[vu
公孫弘	gs[bs sy[zx hs[gs
公孫龍	gs[bs sy[zx ls[yp
公孫龍子	gs[bs sy[zx ls[yp zi[lh
公孫尼子	gs[bs sy[zx ni[ub zi[lh
公孫僑	gs[bs sy[zx qn[rp
公孫鞅	gs[bs sy[zx yh[gk
公西赤	gs[bs xi[hk ii[ty
共相	gs[gb xl[am
公心	gs[bs xb[dv
公性	gs[bs xk[xp
躬行踐履	gs[ug xk[rh jm[zj lv[ur
公性在獨性中	gs[bs xk[xp zd[ut du[qi xk[xp vs[ku
公羊高	gs[bs yh[bs gc[wk
公羊三世說	gs[bs yh[bs sj[hh ui[nv uo[yb
公冶長	gs[bs ye[ds ih[ph
公因	gs[bs yb[wd
功用	gs[gl ys[ou
公眾利益	gs[bs vs[rr li[hd yi[bm
龔自珍	gs[yg zi[pm vf[wr
狗非犬	gz[qb fw[su qr[dd
鉤深致遠	gz[jb uf[dg vi[hw yr[ez
古典希臘哲學	gu[uk dm[kb xi[iu la[og ve[fk xt[xz
古典政治學	gu[uk dm[kb vg[hw vi[ds xt[xz
古風時代	gu[uk fg[ji ui[oc dd[rq
顧歡	gu[iy hr[yd
孤駒未嘗有母	gu[zp ju[mb ww[ha ih[xe yz[uo mu[vv
顧愷之	gu[iy kd[xu vi[dv
穀梁赤	gu[[ ll[da ii[ty
穀神	gu[bk uf[uo
故生	gu[gw ug[pf
顧亭林	gu[iy tk[wd lb[aa
古希臘城邦	gu[uk xi[iu la[og ig[tw bh[fe
古希臘羅馬哲學	gu[uk xi[iu la[og lo[sx ma[vv ve[fk xt[xz
古希臘思想	gu[uk xi[iu la[og si[tx xl[ax
古希臘思想家	gu[uk xi[iu la[og si[tx xl[ax jx[gu
古希臘文	gu[uk xi[iu la[og wf[wi
古希臘文化	gu[uk xi[iu la[og wf[wi hx[rq
古希臘哲學家	gu[uk xi[iu la[og ve[fk xt[xz jx[gu
顧憲成	gu[iy xm[gn ig[wv
顧炎武	gu[iy yj[hh wu[hv
固有知識	gu[wg yz[uo vi[uk ui[yk
卦辭	gx[tb ci[ql
卦氣	gx[tb qi[rh
寡慾	gx[gf yu[bd
怪異行為	gk[xy yi[kc xk[rh ww[dl
管敬仲	gr[vg jk[cw vs[rv
管理國家	gr[vg li[wo go[ww jx[gu
觀念上層建築	gr[yj nm[rx uh[bh cg[ue jm[yj vu[vg
官無常貴	gr[gu wu[ee ih[xk gv[vb
觀物之異以知天意	gr[yj wu[nb vi[dv yi[kc yi[sr vi[uk tm[hd yi[lx
觀象制器	gr[yj xl[dk vi[nd qi[kq
管夷吾	gr[vg yi[hg wu[wk
關尹	gr[bt yb[xp
關尹子	gr[bt yb[xp zi[lh
管仲	gr[vg vs[rv
管子	gr[vg zi[lh
光氣	gl[xe qi[rh
規不可以為圓	gv[ej bu[eu ke[dk yi[sr ww[dl yr[wk
龜長於蛇	gv[do ih[ph yu[eu ue[ig
歸根	gv[ux gf[ag
貴公去私	gv[vb gs[bs qu[ts si[hs
鬼谷子	gv[be gu[bk zi[lh
貴己	gv[vb ji[kv
歸寂	gv[ux ji[gu
鬼謀	gv[be mz[yg
貴齊	gv[vb qi[wp
貴柔守雌	gv[vb rz[ya uz[gc ci[vv
鬼神	gv[be uf[uo
貴生重己	gv[vb ug[pf vs[ph ji[kv
貴無	gv[vb wu[ee
貴無論	gv[vb wu[ee ly[yr
貴一賤二	gv[vb yi[hh jm[bj er[hh
貴因	gv[vb yb[wd
貴知不貴行	gv[vb vi[uk bu[eu gv[vb xk[rh
貴族政治理想	gv[vb zu[fr vg[hw vi[ds li[wo xl[ax
國粹	go[ww cv[mw
國故學	go[ww gu[gw xt[xz
過極失當	go[cz ji[aj ui[pe dh[xx
國家機器	go[ww jx[gu ji[aj qi[kq
郭沫若	go[we mo[dh ro[cu
郭璞	go[we pu[wy
郭慶藩	go[we qk[gd fj[cd
郭象	go[we xl[dk
過猶不及	go[cz yz[qy bu[eu ji[pv
過則舍矣	go[cz ze[bd ue[rg yi[su
郭子玄	go[we zi[lh xr[wy
哈貝馬斯	ha[kr bw[kr ma[vv si[qj
韓昌黎	hj[uw ih[oo li[hr
漢傳因明	hj[dy ir[re yb[wd mk[oo
邯鄲學步	hj[ge dj[be xt[xz bu[vu
韓非	hj[uw fw[su
韓非子	hj[uw fw[su zi[lh
韓康伯	hj[uw kh[gx bo[rb
漢盛於周	hj[dy ug[wm yu[eu vz[kt
韓檀	hj[uw tj[aw
韓退之	hj[uw tv[gz vi[dv
涵養操存	hj[dl yh[yp cc[fk cy[uz
韓嬰	hj[uw yk[bn
韓愈	hj[uw yu[rx
郝大通	hc[te da[hr ts[sz
浩然之氣	hc[dn rj[xd vi[dv qi[rh
昊天	hc[ot tm[hd
好質惡飾	hc[nz vi[pu ee[hx ui[ur
何伯齋	he[rk bo[rb vd[we
何承天	he[rk ig[lu tm[hd
和而不流	he[hk er[ek bu[eu lq[dw
和而不同	he[hk er[ek bu[eu ts[kh
合二而一	he[rh er[hh er[ek yi[hh
合法性	he[rh fa[dt xk[xp
呵佛罵祖	he[kk fo[rf ma[km zu[uq
何干之	he[rk gj[hu vi[dv
鶡冠子	he[[ gr[ge zi[lh
何基	he[rk ji[qt
赫拉克利特	he[tt la[fl ke[ge li[hd te[nt
和樂如一	he[hk le[px ru[nk yi[hh
合理利己主義	he[rh li[wo li[hd ji[kv vu[dw yi[di
合理內核	he[rh li[wo nw[kr he[aw
合理性	he[rh li[wo xk[xp
賀麟	he[lb lb[gm
闔闢	he[mt pi[ul
何啟	he[rk qi[hk
和氣	he[hk qi[rh
河上公	he[dk uh[bh gs[bs
何紹基	he[rk uc[sd ji[qt
和實生物	he[hk ui[gd ug[pf wu[nb
何塘	he[rk th[tg
何廷仁	he[rk tk[qj rf[re
合同	he[rh ts[kh
和同	he[hk ts[kh
合同異	he[rh ts[kh yi[kc
合外內之道	he[rh wd[xb nw[kr vi[dv dc[bz
和為貴	he[hk ww[dl gv[vb
何心隱	he[rk xb[dv yb[ed
何休	he[rk xq[ra
何晏	he[rk yj[og
合一衍萬	he[rh yi[hh yj[rd wj[hv
黑格爾	hw[sd ge[aw er[dx
很相似	hf[rg xl[am si[rs
恆轉	hg[xh vr[ie
洪北江	hs[dg bw[ub jl[dg
洪範九疇	hs[dg fj[cd jq[pv iz[tf
洪亮吉	hs[dg ll[wj ji[uk
洪謙	hs[dg qm[yb
弘忍	hs[gs rf[dx
洪仁玕	hs[dg rf[re gj[wg
洪秀全	hs[dg xq[hn qr[rw
弘一	hs[gs yi[hh
厚生	hz[io ug[pf
侯外廬	hz[rv wd[xb lu[gh
厚自尊貴之風	hz[io zi[pm zy[bc gv[vb vi[dv fg[ji
胡安定	hu[go an[gn dk[gp
胡安國	hu[go an[gn go[ww
胡承諾	hu[go ig[lu no[yc
胡廣	hu[go gl[di
胡宏	hu[go hs[gu
胡居仁	hu[go ju[ug rf[re
胡禮垣	hu[go li[uv yr[th
胡母輔之	hu[go mu[vv fu[if vi[dv
胡秋原	hu[go qq[hh yr[ib
胡繩	hu[go ug[sk
胡適	hu[go ui[qz
戶樞不蠹	hu[du uu[ak bu[eu du[hi
胡文定	hu[go wf[wi dk[gp
胡五峰	hu[go wu[hu fg[uw
胡寅	hu[go yb[gh
互有	hu[hv yz[uo
胡瑗	hu[go yr[wa
胡直	hu[go vi[uj
化醇	hx[rq iy[yw
化待	hx[rq dd[rt
化工	hx[rq gs[hu
華佗	hx[ru to[rg
化性起偽	hx[rq xk[xp qi[zk ww[rd
懷海	hk[xb hd[dr
懷讓	hk[xb rh[yu
懷疑主義	hk[xb yi[bs vu[dw yi[di
幻化	hr[yv hx[rq
桓寬	hr[ah kr[gc
桓譚	hr[ah tj[yx
桓團	hr[ah tr[wc
環淵	hr[wb yr[dp
環中	hr[wb vs[ku
黃白朮	hl[gy bd[po uu[ad
黃道周	hl[gy dc[bz vz[kt
黃帝	hl[gy di[lj
黃東發	hl[gy ds[qx fa[vy
黃幹	hl[gy gj[[
皇極	hl[bw ji[aj
皇侃	hl[bw kj[rk
黃老	hl[gy lc[tb
黃老道德之術	hl[gy lc[tb dc[bz de[ru vi[dv uu[ad
黃梨洲	hl[gy li[ha vz[dd
黃繚	hl[gy ln[sd
黃凌霜	hl[gy lk[dt ul[ya
黃龍三關	hl[gy ls[yp sj[hh gr[bt
黃枬森	hl[gy nj[[ sf[aa
皇上帝	hl[bw uh[bh di[lj
黃石龍	hl[gy ui[ek ls[yp
皇天	hl[bw tm[hd
黃綰	hl[gy wj[sg
黃震	hl[gy vf[yi
黃宗	hl[gy zs[ge
黃宗羲	hl[gy zs[ge xi[bh
惠棟	hv[hx ds[aq
慧觀	hv[fx gr[yj
會合宗教	hv[re he[rh zs[ge jn[tw
回互不回互	hv[wk hu[hv bu[eu hv[wk hu[hv
慧寂	hv[fx ji[gu
慧皎	hv[fx jn[bl
慧琳	hv[fx lb[wa
慧南	hv[fx nj[uk
惠能	hv[hx ng[sb
慧能	hv[fx ng[sb
誨人不倦	hv[yr rf[pd bu[eu jr[rb
惠施	hv[hx ui[fr
慧思	hv[fx si[tx
慧文	hv[fx wf[wi
回憶說	hv[wk yi[xv uo[yb
譭譽之名	hv[jj yu[xy vi[dv mk[xk
慧遠	hv[fx yr[ez
會眾合一	hv[re vs[rr he[rh yi[hh
惠子	hv[hx zi[lh
渾沌	hy[dg dy[dt
渾論	hy[dg ly[yr
魂魄	hy[eg po[bg
魂氣	hy[eg qi[rh
渾天說	hy[dg tm[hd uo[yb
魂知	hy[eg vi[uk
火不熱	ho[dp bu[eu re[fd
獲得幸福	ho[cq de[ro xk[tb fu[uh
活動能力	ho[dq ds[el ng[sb li[vp
禍福相倚	ho[uk fu[uh xl[am yi[rd
霍克海默	ho[yv ke[ge hd[dr mo[hq
火氣一也	ho[dp qi[rh yi[hh ye[vu
或使	ho[gk ui[rh
火一元論	ho[dp yi[hh yr[ee ly[yr
火運水火	ho[dp yy[ez uv[uu ho[dp
汲黯	ji[dj an[hl
基本矛盾	ji[qt bf[ah mc[yp dy[pu
基本內核	ji[qt bf[ah nw[kr he[aw
基本取向	ji[qt bf[ah qu[ey xl[pk
基本問題	ji[qt bf[ah wf[mk ti[oy
激變論	ji[db bm[yy ly[yr
吉藏	ji[uk ch[cw
姬旦	ji[nk dj[oh
疾得成佛	ji[bu de[ro ig[wv fo[rf
即動而求靜	ji[ge ds[el er[ek qq[hu jk[fd
基督教神學	ji[qt du[um jn[tw uf[uo xt[xz
基督教神學觀念	ji[qt du[um jn[tw uf[uo xt[xz gr[yj nm[rx
基督教文論	ji[qt du[um jn[tw wf[wi ly[yr
極而反	ji[aj er[ek fj[py
機鋒	ji[aj fg[jw
極高明而道中庸	ji[aj gc[wk mk[oo er[ek dc[bz vs[ku ys[gx
既濟	ji[gj ji[dw
積漸	ji[hk jm[di
積久貫通	ji[hk jq[xd gr[mb ts[sz
嵇康	ji[hy kh[gx
極樂世界	ji[aj le[px ui[nv jp[tr
季梁	ji[hz ll[da
濟兩明一	ji[dw ll[hk mk[oo yi[hh
季路	ji[hz lu[zw
即民見天	ji[ge mb[kv jm[ke tm[hd
即其本體	ji[ge qi[cb bf[ah ti[ra
譏誚嘲諷	ji[yj qn[yx ic[ku fg[yf
極權主義國家	ji[aj qr[ay vu[dw yi[di go[ww jx[gu
計然	ji[yu rj[xd
雞三足	ji[yn sj[hh zu[kv
繼善成性	ji[sm uj[yk ig[wv xk[xp
即身成佛	ji[ge uf[pu ig[wv fo[rf
極深究幾	ji[aj uf[dg jq[xj ji[pv
稽實定數	ji[hy ui[gd dk[gp uu[mw
嵇叔夜	ji[hy uu[uy ye[wr
積水成淵	ji[hk uv[uu ig[wv yr[dp
己所不欲	ji[kv so[pj bu[eu yu[bd
基提翁的芝諾	ji[qt ti[fo wg[bx de[bb vi[cv no[yc
積土成山	ji[hk tu[uh ig[wv uj[uk
即萬物之自虛	ji[ge wj[hv wu[nb vi[dv zi[pm xu[hy
極微	ji[aj ww[ru
即物窮理	ji[ge wu[nb qs[xl li[wo
即物實測	ji[ge wu[nb ui[gd ce[db
機心	ji[aj xb[dv
疾虛妄	ji[bu xu[hy wh[wn
寄言出意	ji[gd yj[we iu[ck yi[lx
集義所生	ji[va yi[di so[pj ug[pf
濟有者皆有	ji[dw yz[uo ve[to jp[bb yz[uo
己欲達而達人	ji[kv yu[bd da[dz er[ek da[dz rf[pd
己欲立而立人	ji[kv yu[bd li[lh er[ek li[lh rf[pd
季真	ji[hz vf[uj
及知而後知	ji[pv vi[uk er[ek hz[pk vi[uk
寂知揭體	ji[gu vi[uk jp[fo ti[ra
嵇中散	ji[hy vs[ku sj[gw
架構	jx[la gz[ab
賈逵	jx[xb kv[tz
假名	jx[rk mk[xk
賈思勰	jx[xb si[tx xp[lt
假物	jx[rk wu[nb
假象見意	jx[rk xl[dk jm[ke yi[lx
賈誼	jx[xb yi[yg
加一倍法	jx[lk yi[hh bw[rl fa[dt
假有	jx[rk yz[uo
兼愛	jm[bh ai[au
堅白同異	jm[ut bd[po ts[kh yi[kc
兼別	jm[bh bp[kd
減擔	jm[dw dj[fo
見獨	jm[ke du[qi
見分	jm[ke ff[bd
漸化	jm[di hx[rq
見利思義	jm[ke li[hd si[tx yi[di
見理於事	jm[ke li[wo yu[eu ui[hk
兼名	jm[bh mk[xk
減少獸性	jm[dw uc[xp uz[bh xk[xp
鑑識	jm[uj ui[yk
健順	jm[ry uy[iy
見體	jm[ke ti[ra
漸悟	jm[di wu[xw
見侮不辱	jm[ke wu[rr bu[eu ru[ic
見賢思齊	jm[ke xm[ub si[tx qi[wp
兼相愛	jm[bh xl[am ai[au
間相勝	jm[mo xl[am ug[op
踐形	jm[zj xk[kp
見性成佛	jm[ke xk[xp ig[wv fo[rf
兼以易別	jm[bh yi[sr yi[ob bp[kd
賤有	jm[bj yz[uo
鑑真	jm[uj vf[uj
江藩	jl[dg fj[cd
蔣介石	jl[cd jp[rp ui[ek
講課筆記	jl[ye ke[yo bi[vm ji[yk
江天驥	jl[dg tm[hd ji[mb
蔣維喬	jl[cd ww[sv qn[pp
焦竑	jn[vd hs[lu
交會地	jn[li hv[re di[ty
交輪幾	jn[li ly[ir ji[pv
教條主義	jn[tw tn[wa vu[dw yi[di
交相利	jn[li xl[am li[hd
教相判釋	jn[tw xl[am pj[bd ui[py
教學方法	jn[tw xt[xz fh[dw fa[dt
教學過程	jn[tw xt[xz go[cz ig[hk
教學理論	jn[tw xt[xz li[wo ly[yr
教學思想	jn[tw xt[xz si[tx xl[ax
焦循	jn[vd xy[rp
解蔽	jp[dd bi[cb
潔宮	jp[du gs[gk
階級鬥爭	jp[er ji[sj dz[du vg[dx
階級分析法	jp[er ji[sj ff[bd xi[aj fa[dt
階級結構	jp[er ji[sj jp[su gz[ab
階級性	jp[er ji[sj xk[xp
階級意識	jp[er ji[sj yi[lx ui[yk
戒律	jp[gc lv[ry
桀溺	jp[xa ni[dg
竭天成能	jp[lo tm[hd ig[wv ng[sb
解脫	jp[dd to[ob
接習	jp[fl xi[vd
解衣般礴	jp[dd yi[wy bj[vj bo[ec
節用	jp[ce ys[ou
接輿	jp[fl yu[pb
節慾反性	jp[ce yu[bd fj[py xk[xp
節葬	jp[ce zh[ch
接子	jp[fl zi[lh
盡地力	jb[ud di[ty li[vp
金剛智	jb[rw gh[kd vi[uo
禁攻寢兵	jb[ae gs[gw qb[gd bk[qb
進化論	jb[ez hx[rq ly[yr
盡見	jb[ud jm[ke
金履祥	jb[rw lv[ur xl[uy
今日適越而昔來	jb[rd ri[wh ui[qz yt[zh er[ek xi[go ld[hm
盡善盡美	jb[ud uj[yk jb[ud mw[bw
盡天地古今皆二	jb[ud tm[hd di[ty gu[uk jb[rd jp[bb er[hh
盡心知性	jb[ud xb[dv vi[uk xk[xp
儘性	jb[ud xk[xp
禁慾主義	jb[ae yu[bd vu[dw yi[di
金嶽霖	jb[rw yt[qu lb[ya
敬德保民	jk[cw de[ru bc[rk mb[kv
靜篤	jk[fd du[vm
京房	jk[wk fh[hf
靜觀	jk[fd gr[yj
敬鬼神而遠之	jk[cw gv[be uf[uo er[ek yr[ez vi[dv
淨化	jk[dd hx[rq
經濟鬥爭	jk[ss ji[dw dz[du vg[dx
經濟範疇	jk[ss ji[dw fj[cd iz[tf
經濟基礎	jk[ss ji[dw ji[qt iu[ei
經濟哲學	jk[ss ji[dw ve[fk xt[xz
境界	jk[tl jp[tr
敬靜工夫	jk[cw jk[fd gs[hu fu[er
精氣	jk[mf qi[rh
經權	jk[ss qr[ay
精神	jk[mf uf[uo
精神居形體	jk[mf uf[uo ju[ug xk[kp ti[ra
精神科學	jk[mf uf[uo ke[hd xt[xz
精神修養	jk[mf uf[uo xq[ru yh[yp
經世應務	jk[ss ui[nv yk[gx wu[wl
經世致用	jk[ss ui[nv vi[hw ys[ou
精爽	jk[mf ul[di
淨土	jk[dd tu[uh
靜為躁君	jk[fd ww[dl zc[zk jy[xk
經學即理學	jk[ss xt[xz ji[ge li[wo xt[xz
經驗	jk[ss yj[mr
經驗論	jk[ss yj[mr ly[yr
經驗主義	jk[ss yj[mr vu[dw yi[di
驚異感	jk[xw yi[kc gj[wx
精義入神以致用	jk[mf yi[di ru[pd uf[uo yi[sr vi[hw ys[ou
靜因之道	jk[fd yb[wd vi[dv dc[bz
經院派	jk[ss yr[eg pd[dp
經院哲學	jk[ss yr[eg ve[fk xt[xz
靜則生慧	jk[fd ze[bd ug[pf hv[fx
境者心造	jk[tl ve[to xb[dv zc[nz
景中情	jk[ow vs[ku qk[xf
九經	jq[pv jk[ss
究竟覺	jq[xj jk[lo jt[xj
九句因	jq[pv ju[bk yb[wd
鳩摩羅什	jq[jn mo[gf lo[sx uf[ru
九品蓮臺	jq[pv pb[kk lm[ci td[sk
九守	jq[pv uz[gc
九思	jq[pv si[tx
九天	jq[pv tm[hd
居安思危	ju[ug an[gn si[tx ww[de
舉本統末	ju[xf bf[ah ts[sw mo[ha
矩不方	ju[uk bu[eu fh[dw
俱分進化	ju[rj ff[bd jb[ez hx[rq
居敬	ju[ug jk[cw
具體而微	ju[jb ti[ra er[ek ww[ru
舉一反三	ju[xf yi[hh fj[py sj[hh
絕待	jt[sd dd[rt
絕地天通	jt[sd di[ty tm[hd ts[sz
絕對不會	jt[sd dv[yc bu[eu hv[re
絕對真理	jt[sd dv[yc vf[uj li[wo
絕跡玄會	jt[sd ji[yz xr[wy hv[re
絕仁棄義	jt[sd rf[re qi[wc yi[di
絕聖棄智	jt[sd ug[yt qi[wc vi[uo
絕羨欲	jt[sd xm[bd yu[bd
覺性	jt[xj xk[xp
覺照	jt[xj vc[od
君臣共治	jy[xk if[ku gs[gb vi[ds
君臣無常位	jy[xk if[ku wu[ee ih[xk ww[rl
均衡論	jy[tb hg[rd ly[yr
君火	jy[xk ho[dp
君民一體	jy[xk mb[kv yi[hh ti[ra
君權神授	jy[xk qr[ay uf[uo uz[fa
君為天下之大害	jy[xk ww[dl tm[hd xx[hb vi[dv da[hr hd[gf
君相道合	jy[xk xl[am dc[bz he[rh
君形者	jy[xk xk[kp ve[to
君子喻於義	jy[xk zi[lh yu[kr yu[eu yi[di
開明自營	kd[hc mk[oo zi[pm yk[ck
開物成務	kd[hc wu[nb ig[wv wu[wl
康南海	kh[gx nj[uk hd[dr
康僧會	kh[gx sg[rb hv[re
康有為	kh[gx yz[uo ww[dl
康與之	kh[gx yu[hv vi[dv
考茨基	kc[tk ci[cd ji[qt
克堤拉斯篇	ke[ge di[to la[fl si[qj pm[vh
科爾施	ke[hd er[dx ui[fr
客觀實在性	ke[gw gr[yj ui[gd zd[ut xk[xp
客觀唯心主義	ke[gw gr[yj ww[kv xb[dv vu[dw yi[di
克己復禮	ke[ge ji[kv fu[ro li[uv
克己盡物	ke[ge ji[kv jb[ud wu[nb
克雷安德	ke[ge lw[yt an[gn de[ru
克力同篇	ke[ge li[vp ts[kh pm[vh
科林斯	ke[hd lb[aa si[qj
克呂西波	ke[ge lv[kk xi[hk bo[dp
可能性	ke[dk ng[sb xk[xp
克勤	ke[ge qb[nl
科西克	ke[hd xi[hk ke[ge
客形	ke[gw xk[kp
科學的人生觀	ke[hd xt[xz de[bb rf[pd ug[pf gr[yj
科學神	ke[hd xt[xz uf[uo
科學實驗的方法	ke[hd xt[xz ui[gd yj[mr de[bb fh[dw fa[dt
科學性	ke[hd xt[xz xk[xp
科學與玄學論戰	ke[hd xt[xz yu[hv xr[wy xt[xz ly[yr vj[bg
科學之科學	ke[hd xt[xz vi[dv ke[hd xt[xz
可知論	ke[dk vi[uk ly[yr
孔安國	ks[zv an[gn go[ww
孔穿	ks[zv ir[xy
孔鮒	ks[zv fu[yr
孔伋	ks[zv ji[[
孔丘	ks[zv qq[jh
空想社會主義	ks[xg xl[ax ue[ut hv[re vu[dw yi[di
孔顏樂處	ks[zv yj[ly le[px iu[wb
孔穎達	ks[zv yk[by da[dz
空有	ks[xg yz[uo
孔子	ks[zv zi[lh
口辯	kz[uv bm[ly
寇謙之	kz[ge qm[yb vi[dv
苦行主義	ku[cg xk[rh vu[dw yi[di
曠達	kl[og da[dz
狂狷	kl[qw jr[qk
況謂之名	kl[dk ww[yt vi[dv mk[xk
揆端推類	kv[fd dr[lu tv[fv lw[md
窺基	kv[xe ji[qt
拉布里奧拉	la[fl bu[uj li[ot ao[pd la[fl
拉爾修	la[fl er[dx xq[ru
拉法格	la[fl fa[dt ge[aw
賴其力者生	ld[hd qi[cb li[vp ve[to ug[pf
萊茵報	ld[cl yb[cw bc[fe
蘭普薩古	lj[bs pu[bo sa[ce gu[uk
老聃	lc[tb dj[ek
老萊子	lc[tb ld[cl zi[lh
勞力者治於人	lc[cl li[vp ve[to vi[ds yu[eu rf[pd
勞思光	lc[cl si[tx gl[xe
勞心者治人	lc[cl xb[dv ve[to vi[ds rf[pd
老子	lc[tb zi[lh
了別	le[vu bp[kd
樂觀其反	le[px gr[yj qi[cb fj[py
樂廣	le[px gl[di
樂鉅公	le[px ju[kk gs[bs
樂利主義	le[px li[hd vu[dw yi[di
樂天知命	le[px tm[hd vi[uk mk[rh
雷非天怒	lw[yt fw[su tm[hd nu[nx
類固不必可推知也	lw[md gu[wg bu[eu bi[xp ke[dk tv[fv vi[uk ye[vu
類固相召	lw[md gu[wg xl[am vc[dk
類名	lw[md mk[xk
類同	lw[md ts[kh
雷為火	lw[yt ww[dl ho[dp
李翱	li[az ao[bx
理本氣末	li[wo bf[ah qi[rh mo[ha
理稟	li[wo bk[we
李卜克內西	li[az bu[ud ke[ge nw[kr xi[hk
理乘氣功	li[wo ig[qb qi[rh gs[gl
理存於欲	li[wo cy[uz yu[eu yu[bd
李達	li[az da[dz
立大本	li[lh da[hr bf[ah
李大釗	li[az da[hr vc[jd
李侗	li[az ds[rk
李耳	li[az er[hu
李二曲	li[az er[hh qu[ou
李豐	li[az fg[su
李復	li[az fu[ro
利根	li[hd gf[ag
理根於氣	li[wo gf[ag yu[eu qi[rh
李塨	li[az gs[[
李覯	li[az gz[gj
李光地	li[az gl[xe di[ty
李含光	li[az hj[rk gl[xe
利合	li[hd he[rh
力黑	li[vp hw[sd
李華	li[az hx[ru
李璜	li[az hl[wg
李季	li[az ji[hz
理跡	li[wo ji[yz
離堅白	li[wk jm[ut bd[po
力今勝古	li[vp jb[rd ug[op gu[uk
理具於心	li[wo ju[jb yu[eu xb[dv
李克	li[az ke[ge
李悝	li[az kv[xo
理論的科學	li[wo ly[yr de[bb ke[hd xt[xz
理論基礎	li[wo ly[yr ji[qt iu[ei
理昧	li[wo mw[oh
力命	li[vp mk[rh
理明	li[wo mk[oo
力牧	li[vp mu[nw
理念的世界	li[wo nm[rx de[bb ui[nv jp[tr
理念論	li[wo nm[rx ly[yr
理念世界	li[wo nm[rx ui[nv jp[tr
理氣	li[wo qi[rh
理氣合一	li[wo qi[rh he[rh yi[hh
理氣同異	li[wo qi[rh ts[kh yi[kc
李筌	li[az qr[vr
立人極	li[lh rf[pd ji[aj
李善蘭	li[az uj[yk lj[bs
理生氣	li[wo ug[pf qi[rh
理事	li[wo ui[hk
理勢	li[wo ui[fl
李石岑	li[az ui[ek cf[ur
歷史的方法	li[il ui[ki de[bb fh[dw fa[dt
歷史範疇	li[il ui[ki fj[cd iz[tf
理勢合一	li[wo ui[fl he[rh yi[hh
歷史民族	li[il ui[ki mb[kv zu[fr
歷史唯物主義	li[il ui[ki ww[kv wu[nb vu[dw yi[di
理事無礙	li[wo ui[hk wu[ee ai[eo
李恕谷	li[az uu[nx gu[bk
李叔同	li[az uu[uy ts[kh
李斯	li[az si[qj
理統	li[wo ts[sw
李通玄	li[az ts[sz xr[wy
歷物十事	li[il wu[nb ui[hu ui[hk
理先氣後	li[wo xm[ne qi[rh hz[pk
理想國	li[wo xl[ax go[ww
立象盡意	li[lh xl[dk jb[ud yi[lx
離心無境	li[wk xb[dv wu[ee jk[tl
理性發展	li[wo xk[xp fa[vy vj[ug
理性方案	li[wo xk[xp fh[dw an[ga
理性具體	li[wo xk[xp ju[jb ti[ra
理性認識	li[wo xk[xp rf[yr ui[yk
力行哲學	li[vp xk[rh ve[fk xt[xz
理性主義者	li[wo xk[xp vu[dw yi[di ve[to
李旴江	li[az xu[[ jl[dg
李延平	li[az yj[pj pk[hb
理義	li[wo yi[di
禮義	li[uv yi[di
禮儀	li[uv yi[rd
理一分殊	li[wo yi[hh ff[bd uu[hp
禮義廉恥	li[uv yi[di lm[gb ii[ev
麗以淫	li[hk yi[sr yb[da
麗以則	li[hk yi[sr ze[bd
利用	li[hd ys[ou
李顒	li[az ys[[
利用安身以崇德	li[hd ys[ou an[gn uf[pu yi[sr is[ug de[ru
理有窮通	li[wo yz[uo qs[xl ts[sz
李籲	li[az yu[[
理欲	li[wo yu[bd
理源	li[wo yr[di
禮樂教化	li[uv yt[px jn[tw hx[rq
理載於氣	li[wo zd[ti yu[eu qi[rh
李澤厚	li[az ze[dy hz[io
李贄	li[az vi[fb
理知	li[wo vi[uk
禮之用	li[uv vi[dv ys[ou
李之藻	li[az vi[dv zc[cd
理主氣從	li[wo vu[dw qi[rh cs[rr
李卓吾	li[az vo[bo wu[wk
煉丹	lm[hq dj[kw
聯合體	lm[eb he[rh ti[ra
連環可解也	lm[iz hr[wb ke[dk jp[dd ye[vu
煉氣	lm[hq qi[rh
煉形	lm[hq xk[kp
連珠	lm[iz vu[wp
連珠式	lm[iz vu[wp ui[qg
連珠體	lm[iz vu[wp ti[ra
兩點論	ll[hk dm[bd ly[yr
兩端貴先	ll[hk dr[lu gv[vb xm[ne
兩故化	ll[hk gu[gw hx[rq
良貴	ll[dg gv[vb
兩行	ll[hk hh[rh
良价	ll[dg jx[rr
兩可之說	ll[hk ke[dk vi[dv uo[yb
量論	ll[oh ly[yr
良能	ll[dg ng[sb
梁啟超	ll[da qi[hk ic[zd
梁啟雄	ll[da qi[hk xs[uv
梁丘賀	ll[da qq[jh he[lb
梁任公	ll[da rf[rq gs[bs
兩刃相割	ll[hk rf[dd xl[am ge[gd
梁汝元	ll[da ru[dn yr[ee
量時制誼	ll[oh ui[oc vi[nd yi[yg
梁漱溟	ll[da uu[dh mk[dg
兩儀	ll[hk yi[rd
良知	ll[dg vi[uk
量智	ll[oh vi[uo
良知現成	ll[dg vi[uk xm[wj ig[wv
廖平	ln[gx pk[hb
列禦寇	lp[hd yu[rw kz[ge
列子	lp[hd zi[lh
林同濟	lb[aa ts[kh ji[dw
林則徐	lb[aa ze[bd xu[rr
靈寶天尊	lk[xh bc[gw tm[hd zy[bc
靈府	lk[xh fu[gr
靈魂	lk[xh hy[eg
靈明	lk[xh mk[oo
靈氣	lk[xh qi[rh
靈人	lk[xh rf[pd
凌曙	lk[dt uu[os
靈臺	lk[xh td[sk
凌廷堪	lk[dt tk[qj kj[tq
靈祐	lk[xh yz[uu
劉安	lq[wd an[gn
劉寶楠	lq[wd bc[gw nj[au
劉賓客	lq[wd bb[gq ke[gw
六柄	lq[wb bk[ah
劉伯溫	lq[wd bo[rb wf[do
劉敞	lq[wd ih[xw
六塵	lq[wb if[xt
六道	lq[wb dc[bz
六德	lq[wb de[ru
劉德仁	lq[wd de[ru rf[re
六度	lq[wb du[gn
六分	lq[wb ff[bd
劉逢祿	lq[wd fg[wz lu[ux
六府	lq[wb fu[gr
六根	lq[wb gf[ag
柳河東	lq[ap he[dk ds[qx
六極	lq[wb ji[aj
劉基	lq[wd ji[qt
留基伯	lq[pt ji[qt bo[rb
劉蕺山	lq[wd ji[ck uj[uk
六境	lq[wb jk[tl
六經皆史	lq[wb jk[ss jp[bb ui[ki
六經未必為太陽	lq[wb jk[ss ww[ha bi[xp ww[dl td[dd yh[eo
六經注我	lq[wb jk[ss vu[dd wo[pf
劉峻	lq[wd jy[us
六理	lq[wb li[wo
劉伶	lq[wd lk[rr
六美	lq[wb mw[bw
劉夢得	lq[wd mg[ax de[ro
六逆	lq[wb ni[nz
六氣	lq[wb qi[rh
六趣	lq[wb qu[ze
劉劭	lq[wd uc[dl
劉少奇	lq[wd uc[xp qi[dk
劉申叔	lq[wd uf[ou uu[uy
六識	lq[wb ui[yk
劉師培	lq[wd ui[uh pw[tl
六十四卦	lq[wb ui[hu si[we gx[tb
劉述先	lq[wd uu[az xm[ne
流水不腐	lq[dw uv[uu bu[eu fu[gk
六順	lq[wb uy[iy
劉文敏	lq[wd wf[wi mb[rw
劉熙載	lq[wd xi[kd zd[ti
柳下惠	lq[ap xx[hb hv[hx
劉獻廷	lq[wd xm[uq tk[qj
劉向	lq[wd xl[pk
六相緣起	lq[wb xl[am yr[sv qi[zk
六相圓融	lq[wb xl[am yr[wk rs[hi
劉孝標	lq[wd xn[tz bn[ae
劉勰	lq[wd xp[lt
劉歆	lq[wd xb[ld
流行時間	lq[dw xk[rh ui[oc jm[mo
劉絢	lq[wd xr[sb
六爻	lq[wb yc[ii
劉義慶	lq[wd yi[di qk[gd
劉因	lq[wd yb[wd
劉毓松	lq[wd yu[rw ss[ab
劉禹錫	lq[wd yu[pk xi[jo
劉知幾	lq[wd vi[uk ji[pv
劉晝	lq[wd vz[uo
柳子厚	lq[ap zi[lh hz[io
柳宗元	lq[ap zs[ge yr[ee
劉宗周	lq[wd zs[ge vz[kt
龍虎	ls[yp hu[hj
隆正	ls[ew vg[hv
魯班	lu[yo bj[wd
魯褒	lu[yo bc[wr
盧藏用	lu[bu ch[cw ys[ou
陸沉	lu[ef if[dg
陸德明	lu[ef de[ru mk[oo
盧格	lu[bu ge[aw
陸績	lu[ef ji[sf
陸賈	lu[ef jx[xb
陸九齡	lu[ef jq[pv lk[vr
陸九韶	lu[ef jq[pv uc[ld
陸九淵	lu[ef jq[pv yr[dp
盧卡奇	lu[bu ka[ub qi[dk
盧克萊修	lu[bu ke[ge ld[cl xq[ru
陸隴其	lu[ef ls[ey qi[cb
鹿門子	lu[gb mf[du zi[lh
盧森堡	lu[bu sf[aa bc[rt
魯勝	lu[yo ug[op
陸世儀	lu[ef ui[nv yi[rd
魯問	lu[yo wf[mk
陸象山	lu[ef xl[dk uj[uk
陸修靜	lu[ef xq[ru jk[fd
魯迅	lu[yo xy[vz
魯仲連	lu[yo vs[rv lm[iz
亂極則治	lr[qv ji[aj ze[bd vi[ds
卵有毛	lr[pe yz[uo mc[sv
略知	lt[tw vi[uk
輪不碾地	ly[ir bu[eu nm[eu di[ty
輪迴	ly[ir hv[wk
倫理	ly[rr li[wo
倫理學	ly[rr li[wo xt[xz
羅從彥	lo[sx cs[rr yj[lp
羅光	lo[sx gl[xe
羅含	lo[sx hj[rk
羅洪先	lo[sx hs[dg xm[ne
落花之辨	lo[cd hx[cr vi[dv bm[ld
羅克汀	lo[sx ke[ge tk[dd
羅馬時期	lo[sx ma[vv ui[oc qi[qo
羅欽順	lo[sx qb[jd uy[iy
羅汝芳	lo[sx ru[dn fh[cf
羅隱	lo[sx yb[ed
羅整庵	lo[sx vg[hh an[gd
呂本中	lv[kk bf[ah vs[ku
呂不韋	lv[kk bu[eu ww[hh
呂才	lv[kk cd[hu
呂澂	lv[kk ig[[
呂大臨	lv[kk da[hr lb[uv
呂大愚	lv[kk da[hr yu[ox
呂東萊	lv[kk ds[qx ld[cl
呂公著	lv[kk gs[bs vu[ct
呂坤	lv[kk ky[to
呂留良	lv[kk lq[pt ll[dg
呂柟	lv[kk nj[[
慮求	lv[hx qq[hu
履事	lv[ur ui[hk
呂晚村	lv[kk wj[od cy[ac
呂希哲	lv[kk xi[iu ve[fk
呂振羽	lv[kk vf[fi yu[xx
呂祖謙	lv[kk zu[uq qm[yb
馬丹陽	ma[vv dj[kw yh[eo
馬端臨	ma[vv dr[lu lb[uv
馬爾庫塞	ma[vv er[dx ku[gi sd[gt
馬浮	ma[vv fu[da
馬建忠	ma[vv jm[yj vs[vx
馬可	ma[vv ke[dk
馬融	ma[vv rs[hi
馬有卵	ma[vv yz[uo lr[pe
馬祖道一	ma[vv zu[uq dc[bz yi[hh
麥加拉學派	md[fw jx[lk la[fl xt[xz pd[dp
麥裡梭	md[fw li[ot so[as
曼海姆	mj[os hd[dr mu[nm
滿空皆火	mj[dc ks[xg jp[bb ho[dp
毛萇	mc[sv ih[ci
矛盾	mc[yp dy[pu
矛盾之說	mc[yp dy[pu vi[dv uo[yb
毛公	mc[sv gs[bs
毛亨	mc[sv hg[wl
毛奇齡	mc[sv qi[dk lk[vr
毛澤東	mc[sv ze[dy ds[qx
美刺	mw[bw ci[cd
美的根源	mw[bw di[bb gf[ag yr[di
美善相樂	mw[bw uj[yk xl[am le[px
梅文鼎	mw[ar wf[wi dk[mv
美質不飾	mw[bw vi[pu bu[eu ui[ur
每種現象	mw[rm vs[hv xm[wj xl[dk
夢幻人世	mg[ax hr[yv rf[pd ui[nv
孟軻	mg[zm ke[ik
孟勝	mg[zm ug[op
孟喜	mg[zm xi[uk
蒙莊	mg[ch vl[gt
孟子	mg[zm zi[lh
米利都	mi[ba li[hd dz[te
米利都人	mi[ba li[hd dz[te rf[pd
米利都學派	mi[ba li[hd dz[te xt[xz pd[dp
米特林	mi[ba te[nt lb[aa
妙明真心	mn[nx mk[oo vf[uj xb[dv
妙悟	mn[nx wu[xw
妙葉	mn[nx ye[ku
滅度	mp[hh du[gn
民胞物與	mb[kv bc[ob wu[nb yu[hv
民本	mb[kv bf[ah
民本君末	mb[kv bf[ah jy[xk mo[ha
民貴君輕	mb[kv gv[vb jy[xk qk[is
民可使由之	mb[kv ke[dk ui[rh yz[ou vi[dv
民生	mb[kv ug[pf
民生史觀	mb[kv ug[pf ui[ki gr[yj
民生哲學	mb[kv ug[pf ve[fk xt[xz
閔損	mb[mw sy[fk
民無終賤	mb[kv wu[ee vs[sw jm[bj
民之所欲	mb[kv vi[dv so[pj yu[bd
民主君客	mb[kv vu[dw jy[xk ke[gw
閔子騫	mb[mw zi[lh qm[gm
名辯	mk[xk bm[ly
明辨	mk[oo bm[ld
命不可勉	mk[rh bu[eu ke[dk mm[dl
明誠	mk[oo ig[yw
明誠合一	mk[oo ig[yw he[rh yi[hh
明恥	mk[oo ii[ev
名達	mk[xk da[dz
明膽異氣	mk[oo dj[oo yi[kc qi[rh
明道不計功	mk[oo dc[bz bu[eu ji[yu gs[gl
明法審令	mk[oo fa[dt uf[go lk[rd
明分使群	mk[oo ff[bd ui[rh qy[xy
名各順於天	mk[xk ge[wk uy[iy yu[eu tm[hd
明故	mk[oo gu[gw
明鬼	mk[oo gv[be
冥極之知	mk[go ji[aj vi[dv vi[uk
明鑑	mk[oo jm[uj
名教	mk[xk jn[tw
名教出於自然	mk[xk jn[tw iu[ck yu[eu zi[pm rj[xd
名教即自然	mk[xk jn[tw ji[ge zi[pm rj[xd
名教之樂	mk[xk jn[tw vi[dv le[px
名教自然之辨	mk[xk jn[tw zi[pm rj[xd vi[dv bm[ld
名理	mk[xk li[wo
冥然自合	mk[go rj[xd zi[pm he[rh
名色	mk[xk se[db
明善誠身	mk[oo uj[yk ig[yw uf[pu
名勝	mk[xk ug[op
名生於真	mk[xk ug[pf yu[eu vf[uj
名士	mk[xk ui[uh
名實	mk[xk ui[gd
名實耦	mk[xk ui[gd ou[lo
名實相應	mk[xk ui[gd xl[am yk[gx
名實之辯	mk[xk ui[gd vi[dv bm[ly
命題	mk[rh ti[oy
明體達用之學	mk[oo ti[ra da[dz ys[ou vi[dv xt[xz
命物之名	mk[rh wu[nb vi[dv mk[xk
明心見性	mk[oo xb[dv jm[ke xk[xp
溟涬	mk[dg xk[[
冥行妄作	mk[go xk[rh wh[wn zo[rv
名有三科	mk[xk yz[uo sj[hh ke[hd
命迂	mk[rh yu[ez
明於天人之分	mk[oo yu[eu tm[hd rf[pd vi[dv ff[bd
明哲保身	mk[oo ve[fk bc[rk uf[pu
名逐物而遷	mk[xk vu[uz wu[nb er[ek qm[qz
墨翟	mo[ht di[xv
墨籙	mo[ht lu[vx
末那識	mo[ha na[ve ui[yk
莫破質點	mo[co po[ep vi[pu dm[bd
莫若以明	mo[co ro[cu yi[sr mk[oo
莫紹揆	mo[co uc[sd kv[fd
莫為	mo[co ww[dl
墨子	mo[ht zi[lh
某些特徵	mz[ga xp[ve te[nt vg[rh
牟子	mz[sn zi[lh
牟宗三	mz[sn zs[ge sj[hh
目不見	mu[we bu[eu jm[ke
目識	mu[we ui[yk
穆斯林哲學	mu[hb si[qj lb[aa ve[fk xt[xz
木桶裡	mu[ub ts[as li[ot
目想	mu[we xl[ax
納甲	na[sk jx[ou
南無	na[uk mo[ee
拿證據來	na[rf vg[yh ju[fu ld[hm
南方無窮而有窮	nj[uk fh[dw wu[ee qs[xl er[ek yz[uo qs[xl
難自然好學論	nj[yv zi[pm rj[xd hc[nz xt[xz ly[yr
腦氣筋	nc[ow qi[rh jb[vo
腦髓說	nc[ow sv[gu uo[yb
腦昔芬尼	nc[ow xi[go ff[cf ni[ub
內成	nw[kr ig[wv
內丹	nw[kr dj[kw
內界立法	nw[kr jp[tr li[lh fa[dt
內美	nw[kr mw[bw
內聖外王	nw[kr ug[yt wd[xb wh[su
內視	nw[kr ui[uj
內視反聽	nw[kr ui[uj fj[py tk[kj
內史興	nw[kr ui[ki xk[xb
內外交相成之道	nw[kr wd[xb jn[li xl[am ig[wv vi[dv dc[bz
內外相須	nw[kr wd[xb xl[am xu[py
內外之合	nw[kr wd[xb vi[dv he[rh
內心世界	nw[kr xb[dv ui[nv jp[tr
內省	nw[kr xk[xm
內學	nw[kr xt[xz
內遊	nw[kr yz[df
內籀	nw[kr vz[vf
能必副所	ng[sb bi[xp fu[hd so[pj
能參	ng[sb cj[sd
能動性	ng[sb ds[el xk[xp
能立	ng[sb li[lh
能破	ng[sb po[ep
能所	ng[sb so[pj
能知	ng[sb vi[uk
能知必能行	ng[sb vi[uk bi[xp ng[sb xk[rh
逆教	ni[nz jn[tw
念念生滅	nm[rx nm[rx ug[pf mp[hh
聶豹	np[ey bc[pb
涅槃	np[do pj[va
牛僧孺	nq[pf sg[rb ru[zy
歐布里德	ou[kd bu[uj li[ot de[ru
歐克裡德	ou[kd ke[ge li[ot de[ru
耦立	ou[lo li[lh
偶其類	ou[ro qi[cb lw[md
偶然	ou[ro rj[xd
偶然性	ou[ro rj[xd xk[xp
歐文	ou[kd wf[wi
歐陽德	ou[kd yh[eo de[ru
歐陽建	ou[kd yh[eo jm[yj
歐陽漸	ou[kd yh[eo jm[di
歐陽竟無	ou[kd yh[eo jk[lo wu[ee
歐陽修	ou[kd yh[eo xq[ru
耦中有耦	ou[lo vs[ku yz[uo ou[lo
偶自生	ou[ro zi[pm ug[pf
判教	pj[bd jn[tw
潘尼提烏	pj[dp ni[ub ti[fo wu[bv
潘平格	pj[dp pk[hb ge[aw
潘師正	pj[dp ui[uh vg[hv
潘用微	pj[dp ys[ou ww[ru
潘梓年	pj[dp zi[al nm[rn
龐鴻	ph[gy hs[dn
龐樸	ph[gy pu[ab
庖丁解牛	pc[gb dk[hu jp[dd nq[pf
裴徽	pw[fy hv[ru
裴頠	pw[fy ww[[
彭定求	pg[up dk[gp qq[hu
捧喝	pg[fs he[ko
彭康	pg[up kh[gx
彭蒙	pg[up mg[ch
彭紹升	pg[up uc[sd ug[pc
彭曉	pg[up xn[oq
彭允初	pg[up yy[se iu[yd
譬稱	pi[uy ig[hd
否極泰來	pi[bk ji[aj td[su ld[hm
皮日休	pi[vp ri[wh xq[ra
皮錫瑞	pi[vp xi[jo rv[wu
平待	pk[hb dd[rt
平旦之氣	pk[hb dj[oh vi[dv qi[rh
平等	pk[hb dg[vt
評判的態度	pk[yp pj[bd de[bb td[dx du[gn
憑虛構象	pk[rj xu[hy gz[ab xl[dk
破對待	po[ep dv[yc dd[rt
破邪顯正	po[ep xp[ye xm[oy vg[hv
破心中賊	po[ep xb[dv vs[ku zw[bg
破作兩片	po[ep zo[rv ll[hk pm[pu
普列漢諾夫	pu[bo lp[hd hj[dy no[yc fu[er
普魯東	pu[bo lu[yo ds[qx
普羅克洛斯	pu[bo lo[sx ke[ge lo[dw si[qj
普羅泰戈拉	pu[bo lo[sx td[su ge[qp la[fl
普羅提諾	pu[bo lo[sx ti[fo no[yc
普納路亞	pu[bo na[sk lu[zw ya[hy
樸素辯證法	pu[ab su[fy bm[ly vg[yh fa[dt
樸素唯物主義	pu[ab su[fy ww[kv wu[nb vu[dw yi[di
菩提	pu[cl ti[fo
菩提達摩	pu[cl ti[fo da[dz mo[gf
菩提樹	pu[cl ti[fo uu[ay
普通科學	pu[bo ts[sz ke[hd xt[xz
普通人民	pu[bo ts[sz rf[pd mb[kv
氣本	qi[rh bf[ah
氣稟	qi[rh bk[we
氣稟有定	qi[rh bk[we yz[uo dk[gp
岐伯	qi[uu bo[rb
其大千裡	qi[cb da[hr qm[pu li[ot
漆雕開	qi[da dn[kv kd[hc
七法	qi[hv fa[dt
氣化	qi[rh hx[rq
氣化即道	qi[rh hx[rq ji[ge dc[bz
器可變	qi[kq ke[dk bm[yy
啟蒙運動	qi[hk mg[ch yy[ez ds[el
氣母	qi[rh mu[vv
七氣	qi[hv qi[rh
七情	qi[hv qk[xf
齊是非	qi[wp ui[op fw[su
器世間	qi[kq ui[nv jm[mo
齊死生	qi[wp si[hx ug[pf
契嵩	qi[fd ss[uw
其他階級	qi[cb ta[ry jp[er ji[sj
器體道用	qi[kq ti[ra dc[bz ys[ou
齊萬物	qi[wp wj[hv wu[nb
氣萬則理萬	qi[rh wj[hv ze[bd li[wo wj[hv
齊萬致	qi[wp wj[hv vi[hw
七緯	qi[hv ww[sw
齊物	qi[wp wu[nb
齊物我	qi[wp wu[nb wo[pf
氣須形而知	qi[rh xu[py xk[kp er[ek vi[uk
氣一則理一	qi[rh yi[hh ze[bd li[wo yi[hh
氣有聚散無滅息	qi[rh yz[uo ju[ep sj[gw wu[ee mp[hh xi[zx
起源於	qi[zk yr[di yu[eu
氣運	qi[rh yy[ez
氣韻	qi[rh yy[lb
氣運決定論	qi[rh yy[ez jt[dv dk[gp ly[yr
齊澤克	qi[wp ze[dy ke[ge
氣者理之依	qi[rh ve[to li[wo vi[dv yi[ry
奇正相生	qi[dk vg[hv xl[am ug[pf
氣質	qi[rh vi[pu
氣質之性	qi[rh vi[pu vi[dv xk[xp
氣自然論	qi[rh zi[pm rj[xd ly[yr
錢德洪	qm[jj de[ru hs[dg
譴告	qm[yv gc[nk
乾坤	qm[ur ky[to
乾坤並建	qm[ur ky[to bk[bk jm[yj
錢穆	qm[jj mu[hb
前識	qm[bo ui[yk
遷想妙得	qm[qz xl[ax mn[nx de[ro
遣相證性	qm[vz xl[am vg[yh xk[xp
強調理性	ql[gk dn[yk li[wo xk[xp
強力從事	ql[gk li[vp cs[rr ui[hk
強物就我	ql[gk wu[nb jq[wy wo[pf
巧轉	qn[gk vr[ie
切問近思	qp[qd wf[mk jb[jz si[tx
禽滑釐	qb[rw hx[dg li[[
親民	qb[la mb[kv
親下手一番	qb[la xx[hb uz[su yi[hh fj[pt
親知	qb[la vi[uk
情采	qk[xf cd[aa
青出於蘭而青於蘭	qk[fo iu[ck yu[eu lj[bs er[ek qk[fo yu[eu lj[bs
輕賤唐虞而笑大禹	qk[is jm[bj th[gx yu[hk er[ek xn[vp da[hr yu[pk
清靜無為	qk[df jk[fd wu[ee ww[dl
青年黑格爾派	qk[fo nm[rn hw[sd ge[aw er[dx pd[dp
清談	qk[df tj[yh
情偽相感	qk[xf ww[rd xl[am gj[wx
輕物重生	qk[is wu[nb is[ph ug[pf
清虛一大	qk[df xu[hy yi[hh da[hr
情慾寡淺	qk[xf yu[bd gx[gf qm[dj
情中景	qk[xf vs[ku jk[ow
窮達	qs[xl da[dz
窮理盡性	qs[xl li[wo jb[ud xk[xp
窮神知化	qs[xl uf[uo vi[uk hx[rq
窮通	qs[xl ts[sz
窮形盡相	qs[xl xk[kp jb[ud xl[am
邱處機	qq[qe iu[wb ji[aj
丘處機	qq[jh iu[wb ji[aj
求放心	qq[hu fh[fw xb[dv
邱漢生	qq[qe hj[dy ug[pf
邱濬	qq[qe jy[db
去和取同	qu[ts he[hk qu[ey ts[kh
去解釋	qu[ts jp[dd ui[py
取境	qu[ey jk[tl
去九界	qu[ts jq[pv jp[tr
去苦求樂	qu[ts ku[cg qq[hu le[px
屈平	qu[ui pk[hb
瞿秋白	qu[mv qq[hh bd[po
去人慾	qu[ts rf[pd yu[bd
趨時更新	qu[zd ui[oc gg[ho xb[lj
瞿世英	qu[mv ui[nv yk[ck
取實責名	qu[ey ui[gd ze[fb mk[xk
取象形器	qu[ey xl[dk xk[kp qi[kq
屈原	qu[ui yr[ib
犬可以為羊	qr[dd ke[dk yi[sr ww[dl yh[bs
全盤否定	qr[rw pj[vm fz[bk dk[gp
犬儒	qr[dd ru[ry
犬儒理念	qr[dd ru[ry li[wo nm[rx
犬儒學派	qr[dd ru[ry xt[xz pd[dp
犬儒學者	qr[dd ru[ry xt[xz ve[to
犬儒主義	qr[dd ru[ry vu[dw yi[di
犬儒主義學派	qr[dd ru[ry vu[dw yi[di xt[xz pd[dp
犬儒主義者	qr[dd ru[ry vu[dw yi[di ve[to
全性保真	qr[rw xk[xp bc[rk vf[uj
全增嘏	qr[rw zg[tb gu[gk
全祖望	qr[rw zu[uq wh[ww
群己	qy[xy ji[kv
群有以至虛為宗	qy[xy yz[uo yi[sr vi[ht xu[hy ww[dl zs[ge
群眾觀點	qy[xy vs[rr gr[yj dm[bd
群眾路線	qy[xy vs[rr lu[zw xm[sj
冉求	rj[kt qq[hu
冉雍	rj[kt ys[ws
冉有	rj[kt yz[uo
讓生於有餘	rh[yu ug[pf yu[eu yz[uo yu[re
饒魯	rc[uq lu[yo
人道	rf[pd dc[bz
人道有為	rf[pd dc[bz yz[uo ww[dl
人道之知	rf[pd dc[bz vi[dv vi[uk
任德	rf[rq de[ru
人定勝天	rf[pd dk[gp ug[op tm[hd
任耳目而定情實	rf[rq er[hu mu[we er[ek dk[gp qk[xf ui[gd
人非利不生	rf[pd fw[su li[hd bu[eu ug[pf
人副天數	rf[pd fu[hd tm[hd uu[mw
人極	rf[pd ji[aj
任繼愈	rf[rq ji[sm yu[rx
人皆可以為堯舜	rf[pd jp[bb ke[dk yi[sr ww[dl yc[qh uy[ax
人爵	rf[pd jt[ag
人口因素	rf[pd kz[uv yb[wd su[fy
人類感官	rf[pd lw[md gj[wx gr[gu
人類互助原則	rf[pd lw[md hu[hv vu[ql yr[ib ze[bd
人類進化之時期	rf[pd lw[md jb[ez hx[rq vi[dv ui[oc qi[qo
人類生命	rf[pd lw[md ug[pf mk[rh
人理	rf[pd li[wo
刃利之喻	rf[dd li[hd vi[dv yu[kr
人倫	rf[pd ly[rr
人馬之喻	rf[pd ma[vv vi[dv yu[kr
人謀	rf[pd mz[yg
人能	rf[pd ng[sb
人能弘道	rf[pd ng[sb hs[gs dc[bz
人能勝乎天	rf[pd ng[sb ug[op hu[pb tm[hd
任情極性	rf[rq qk[xf ji[aj xk[xp
人神關係	rf[pd uf[uo gr[bt xi[py
仁聲	rf[re ug[um
人生觀論戰	rf[pd ug[pf gr[yj ly[yr vj[bg
認識的多元論	rf[yr ui[yk de[bb do[xx yr[ee ly[yr
認識論	rf[yr ui[yk ly[yr
人事為本	rf[pd ui[hk ww[dl bf[ah
任曙	rf[rq uu[os
人為天地萬物之盜說	rf[pd ww[dl tm[hd di[ty wj[hv wu[nb vi[dv dc[dm uo[yb
仁為天地萬物之源	rf[re ww[dl tm[hd di[ty wj[hv wu[nb vi[dv yr[di
人為萬物之靈	rf[pd ww[dl wj[hv wu[nb vi[dv lk[xh
人文	rf[pd wf[wi
人物品藻	rf[pd wu[nb pb[kk zc[cd
人心	rf[pd xb[dv
人性	rf[pd xk[xp
人性獸性同時發展	rf[pd xk[xp uz[bh xk[xp ts[kh ui[oc fa[vy vj[ug
人演	rf[pd yj[dg
人義	rf[pd yi[di
仁義	rf[re yi[di
仁義禮智	rf[re yi[di li[uv vi[uo
仁以通為第一義	rf[re yi[sr ts[sz ww[dl di[vg yi[hh yi[di
人慾	rf[pd yu[bd
人慾橫流說	rf[pd yu[bd hg[ag lq[dw uo[yb
仁者愛人	rf[re ve[to ai[au rf[pd
仁政	rf[re vg[hw
任卓宣	rf[rq vo[bo xr[gh
人自己	rf[pd zi[pm ji[kv
人自身	rf[pd zi[pm uf[pu
日新	ri[wh xb[lj
日新之化	ri[wh xb[lj vi[dv hx[rq
容閎	rs[xr hs[mu
榮辱	rs[ca ru[ic
榮辱之分	rs[ca ru[ic vi[dv ff[bd
容肇祖	rs[xr vc[hy zu[uq
柔節	rz[ya jp[ce
柔羽勝剛強	rz[ya yu[xx ug[op gh[kd ql[gk
入德凝道	ru[pd de[ru nk[db dc[bz
入靜	ru[pd jk[fd
如來藏	ru[nk ld[hm zh[cw
汝南月旦	ru[dn nj[uk yt[ke dj[oh
阮德如	rr[ee de[ru ru[nk
阮籍	rr[ee ji[vl
阮嗣宗	rr[ee si[kv zs[ge
阮咸	rr[ee xm[wh
阮修	rr[ee xq[ru
阮元	rr[ee yr[ee
阮瞻	rr[ee vj[md
弱者道之用	ro[gg ve[to dc[bz vi[dv ys[ou
薩卡斯	sa[ce ka[ub si[qj
薩特	sa[ce te[nt
塞內卡	sd[gt nw[kr ka[ub
塞翁失馬	sd[gt wg[bx ui[pe ma[vv
賽先生	sd[gb xm[ne ug[pf
三寶	sj[hh bc[gw
三表	sj[hh bn[fy
三不朽	sj[hh bu[eu xq[ak
三才	sj[hh cd[hu
三材	sj[hh cd[ac
三乘	sj[hh ig[qb
三從四德	sj[hh cs[rr si[we de[ru
三達德	sj[hh da[dz de[ru
三大哲學家	sj[hh da[hr ve[fk xt[xz jx[gu
三盜	sj[hh dc[dm
三德	sj[hh de[ru
三諦偈	sj[hh di[yl ji[ro
三諦圓融	sj[hh di[yl yr[wk rs[hi
三法	sj[hh fa[dt
三法印	sj[hh fa[dt yb[pe
三綱	sj[hh gh[sk
三綱領八條目	sj[hh gh[sk lk[ry ba[pd tn[wa mu[we
三綱六紀	sj[hh gh[sk lq[wb ji[sk
三綱五常	sj[hh gh[sk wu[hu ih[xk
三個階段	sj[hh ge[ru jp[er dr[pj
三個階級	sj[hh ge[ru jp[er ji[sj
三皈依	sj[hh gv[bp yi[ry
三惑	sj[hh ho[gx
三極	sj[hh ji[aj
三即一	sj[hh ji[ge yi[hh
三界	sj[hh jp[tr
三界唯心	sj[hh jp[tr ww[kv xb[dv
三科	sj[hh ke[hd
三理	sj[hh li[wo
三昧	sj[hh mw[oh
三民主義	sj[hh mb[kv vu[dw yi[di
三名	sj[hh mk[xk
散名	sj[gw mk[xk
三能變	sj[hh ng[sb bm[yy
三年不窺園	sj[hh nm[rn bu[eu kv[xe yr[we
三千世間	sj[hh qm[pu ui[nv jm[mo
三清	sj[hh qk[df
三生	sj[hh ug[pf
三世	sj[hh ui[nv
三事	sj[hh ui[hk
三尸	sj[hh ui[kp
三世六別	sj[hh ui[nv lq[wb bp[kd
三世一時	sj[hh ui[nv yi[hh ui[oc
三統	sj[hh ts[sw
三畏	sj[hh ww[th
三物	sj[hh wu[nb
三無性	sj[hh wu[ee xk[xp
三性	sj[hh xk[xp
三性一際	sj[hh xk[xp yi[hh ji[ee
三凶	sj[hh xs[ik
三玄	sj[hh xr[wy
三學	sj[hh xt[xz
三言	sj[hh yj[we
三一	sj[hh yi[hh
三語椽	sj[hh yu[yw ir[av
三元	sj[hh yr[ee
三正	sj[hh vg[hv
三知三行	sj[hh vi[uk sj[hh hh[rh
三支作法	sj[hh vi[uy zo[rv fa[dt
三自性	sj[hh zi[pm xk[xp
桑弘羊	sh[ya hs[gs yh[bs
桑戶	sh[ya hu[du
色法	se[db fa[dt
色即是空	se[db ji[ge ui[op ks[xg
色空	se[db ks[xg
色諾芬	se[db no[yc ff[cf
色諾芬尼	se[db no[yc ff[cf ni[ub
僧朗	sg[rb lh[lo
僧詮	sg[rb qr[yr
僧叡	sg[rb rv[[
僧祐	sg[rb yz[uu
僧肇	sg[rb vc[hy
殺盜非殺人	ua[ia dc[dm fw[su ua[ia rf[pd
沙夫	ua[dx fu[er
殺身成仁	ua[ia uf[pu ig[wv rf[re
山出口	uj[uk iu[ck kz[uv
善導	uj[yk dc[kc
善動化物	uj[yk ds[el hx[rq wu[nb
善端	uj[yk dr[lu
善惡	uj[yk ee[hx
山巨源	uj[uk ju[kk yr[di
山濤	uj[uk tc[df
善無畏	uj[yk wu[ee ww[th
山與澤平	uj[uk yu[hv ze[dy pk[hb
上層建築	uh[bh cg[ue jm[yj vu[vg
上德	uh[bh de[ru
上帝	uh[bh di[lj
商君	uh[lk jy[xk
尚情無我	uh[xk qk[xf wu[ee wo[pf
尚同	uh[xk ts[kh
尚賢	uh[xk xm[ub
商鞅	uh[lk yh[gk
尚志	uh[xk vi[ux
上智下愚	uh[bh vi[uo xx[hb yu[ox
邵伯溫	uc[de bo[rb wf[do
邵康節	uc[de kh[gx jp[ce
少私寡慾	uc[xp si[hs gx[gf yu[bd
邵雍	uc[de ys[ws
少正卯	uc[xp vg[hv mc[pe
社會革命	ue[ut hv[re ge[nk mk[rh
社會函變說	ue[ut hv[re hj[lk bm[yy uo[yb
社會互助論	ue[ut hv[re hu[hv vu[ql ly[yr
社會環境	ue[ut hv[re hr[wb jk[tl
社會生活	ue[ut hv[re ug[pf ho[dq
社會物質生活條件	ue[ut hv[re wu[nb vi[pu ug[pf ho[dq tn[wa jm[rn
社會心理	ue[ut hv[re xb[dv li[wo
社會形態	ue[ut hv[re xk[kp td[dx
社會意識形式	ue[ut hv[re yi[lx ui[yk xk[kp ui[qg
社稷無常奉	ue[ut ji[ht wu[ee ih[xk fg[sf
捨生取義	ue[rg ug[pf qu[ey yi[di
舍英雄無歷史	ue[rg yk[ck xs[uv wu[ee li[il ui[ki
攝用歸體	ue[fe ys[ou gv[ux ti[ra
設準	ue[yj vy[dv
申不害	uf[ou bu[eu hd[gf
深察名號	uf[dg ia[gx mk[xk hc[kk
慎到	uf[xu dc[hd
神道設教	uf[uo dc[bz ue[yj jn[tw
慎獨	uf[xu du[qi
神而先知	uf[uo er[ek xm[ne vi[uk
深谷為陵	uf[dg gu[bk ww[dl lk[et
沈國模	uf[dg go[ww mo[ac
申韓	uf[ou hj[uw
神化	uf[uo hx[rq
沈煥	uf[dg hr[hd
神會	uf[uo hv[re
沈括	uf[dg ko[fq
神祕主義	uf[uo mi[hx vu[dw yi[di
神祕主義色彩	uf[uo mi[hx vu[dw yi[di se[db cd[ap
神妙萬物	uf[uo mn[nx wj[hv wu[nb
神明	uf[uo mk[oo
審名察形	uf[go mk[xk ia[gx xk[kp
審名定分	uf[go mk[xk dk[gp ff[bd
神明照物	uf[uo mk[oo vc[od wu[nb
神器	uf[uo qi[kq
神氣	uf[uo qi[rh
神人	uf[uo rf[pd
沈善登	uf[dg uj[yk dg[dd
審時	uf[go ui[oc
神識	uf[uo ui[yk
慎思	uf[xu si[tx
神似	uf[uo si[rs
神思	uf[uo si[tx
身外之物	uf[pu wd[xb vi[dv wu[nb
神悟	uf[uo wu[xw
神無方易無體	uf[uo wu[ee fh[dw yi[ob wu[ee ti[ra
神囂	uf[uo xn[ky
神秀	uf[uo xq[hn
神須形以存	uf[uo xu[py xk[kp yi[sr cy[uz
神學思考	uf[uo xt[xz si[tx kc[tk
沈有鼎	uf[dg yz[uo dk[mv
神與物遊	uf[uo yu[hv wu[nb yz[df
沈約	uf[dg yt[sb
神韻說	uf[uo yy[lb uo[yb
神者生之本	uf[uo ve[to ug[pf vi[dv bf[ah
沈志遠	uf[dg vi[ux yr[ez
慎子	uf[xu zi[lh
申子	uf[ou zi[lh
生產方式	ug[pf ij[lp fh[dw ui[qg
生產關係	ug[pf ij[lp gr[bt xi[py
生產力	ug[pf ij[lp li[vp
生產實踐	ug[pf ij[lp ui[gd jm[zj
生而知之	ug[pf er[ek vi[uk vi[dv
生非創有	ug[pf fw[su il[rd yz[uo
生化	ug[pf hx[rq
生活領域	ug[pf ho[dq lk[ry yu[tg
生活態度	ug[pf ho[dq td[dx du[gn
勝能	ug[op ng[sb
聖人不死	ug[yt rf[pd bu[eu si[hx
聖人創制立法	ug[yt rf[pd il[rd vi[nd li[lh fa[dt
聖人體無	ug[yt rf[pd ti[ra wu[ee
聖人無情	ug[yt rf[pd wu[ee qk[xf
聖人有情無累	ug[yt rf[pd yz[uo qk[xf wu[ee lw[ty
聖人有情與無情	ug[yt rf[pd yz[uo qk[xf yu[hv wu[ee qk[xf
聖人之辯	ug[yt rf[pd vi[dv bm[ly
生人之意	ug[pf rf[pd vi[dv yi[lx
生生	ug[pf ug[pf
生死輪迴	ug[pf si[hx ly[ir hv[wk
聲無哀樂	ug[um wu[ee ai[wk yt[px
生物之本	ug[pf wu[nb vi[dv bf[ah
生物之具	ug[pf wu[nb vi[dv ju[jb
聖西門	ug[yt xi[hk mf[du
聖賢	ug[yt xm[ub
生有涯而知無涯	ug[pf yz[uo ya[di er[ek vi[uk wu[ee ya[di
剩餘價值	ug[qd yu[re jx[rr vi[ru
生元	ug[pf yr[ee
生元有知論	ug[pf yr[ee yz[uo vi[uk ly[yr
生知	ug[pf vi[uk
史囂	ui[ki ao[[
事本禁末	ui[hk bf[ah jb[ae mo[ha
世必有革	ui[nv bi[xp yz[uo ge[nk
史伯	ui[ki bo[rb
時不可力	ui[oc bu[eu ke[dk li[vp
實叉難陀	ui[gd ia[yd nj[yv to[eg
實誠	ui[gd ig[yw
師承關係	ui[uh ig[lu gr[bt xi[py
施讎	ui[fr iz[vy
石徂徠	ui[ek cu[rq ld[rl
施存統	ui[fr cy[uz ts[sw
釋道十害	ui[py dc[bz ui[hu hd[gf
十地	ui[hu di[ty
施蒂納	ui[fr di[cl na[sk
是而不然	ui[op er[ek bu[eu rj[xd
是而然	ui[op er[ek rj[xd
十二因緣	ui[hu er[hh yb[wd yr[sv
是非莫辯	ui[op fw[su mo[co bm[ly
是非無定質	ui[op fw[su wu[ee dk[gp vi[pu
是非之慮	ui[op fw[su vi[dv lv[hx
是非之心	ui[op fw[su vi[dv xb[dv
事各順於名	ui[hk ge[wk uy[iy yu[eu mk[xk
始基	ui[ns ji[qt
實際	ui[gd ji[ee
世間	ui[nv jm[mo
實踐的科學	ui[gd jm[zj de[bb ke[hd xt[xz
施肩吾	ui[fr jm[ho wu[wk
實踐性	ui[gd jm[zj xk[xp
屍佼	ui[kp jn[rl
十戒	ui[hu jp[gc
尸解	ui[kp jp[dd
石介	ui[ek jp[rp
世界本原	ui[nv jp[tr bf[ah yr[ib
世界進化三時期	ui[nv jp[tr jb[ez hx[rq sj[hh ui[oc qi[qo
世界圖式	ui[nv jp[tr tu[ww ui[qg
世界萬物	ui[nv jp[tr wj[hv wu[nb
世界物質	ui[nv jp[tr wu[nb vi[pu
始覺	ui[ns jt[xj
石峻	ui[ek jy[us
士君子之辯	ui[uh jy[xk zi[lh vi[dv bm[ly
實歷	ui[gd li[il
十六字心傳	ui[hu lq[wb zi[gz xb[dv ir[re
實論	ui[gd ly[yr
史墨	ui[ki mo[ht
適偶之數	ui[qz ou[ro vi[dv uu[mw
適偶自然	ui[qz ou[ro zi[pm rj[xd
勢榮	ui[fl rs[ca
勢辱	ui[fl ru[ic
十如是	ui[hu ru[nk ui[op
十三虛無	ui[hu sj[hh xu[hy wu[ee
實事	ui[gd ui[hk
實事難形	ui[gd ui[hk nj[yv xk[kp
實事實功	ui[gd ui[hk ui[gd gs[gl
事事無礙	ui[hk ui[hk wu[ee ai[eo
世碩	ui[nv uo[ey
世俗藝術	ui[nv su[rb yi[cv uu[ad
釋太虛	ui[py td[dd xu[hy
石濤	ui[ek tc[df
施特勞斯	ui[fr te[nt lc[cl si[qj
實體	ui[gd ti[ra
實體即本心	ui[gd ti[ra ji[ge bf[ah xb[dv
施為	ui[fr ww[dl
師物	ui[uh wu[nb
實相	ui[gd xl[am
師心	ui[uh xb[dv
師心自用	ui[uh xb[dv zi[pm ys[ou
十玄門	ui[hu xr[wy mf[du
十玄緣起	ui[hu xr[wy yr[sv qi[zk
詩學	ui[yt xt[xz
實驗的方法	ui[gd yj[mr de[bb fh[dw fa[dt
詩言志	ui[yt yj[we vi[ux
十義	ui[hu yi[di
世異則事異	ui[nv yi[kc ze[bd ui[hk yi[kc
師夷之長技以制夷	ui[uh yi[hg vi[dv ih[ph ji[fu yi[sr vi[nd yi[hg
勢用	ui[fl ys[ou
實有	ui[gd yz[uo
事有常變	ui[hk yz[uo ih[xk bm[yy
實在	ui[gd zd[ut
實在界	ui[gd zd[ut jp[tr
識知	ui[yk vi[uk
適志	ui[qz vi[ux
實知	ui[gd vi[uk
時中	ui[oc vs[ku
屍子	ui[kp zi[lh
守度	uz[gc du[gn
收拾精神	uz[vw ui[fr jk[mf uf[uo
收心離境	uz[vw xb[dv li[wk jk[tl
獸性主義	uz[bh xk[xp vu[dw yi[di
守一	uz[gc yi[hh
守一存真	uz[gc yi[hh cy[uz vf[uj
數存勢生	uu[mw cy[uz ui[fl ug[pf
殊類	uu[hp lw[md
舒璘	uu[ry lb[[
殊氣相革	uu[hp qi[rh xl[am ge[nk
舒適環境	uu[ry ui[qz hr[wb jk[tl
數術	uu[mw uu[ad
術數	uu[ad uu[mw
叔孫通	uu[uy sy[zx ts[sz
數息觀	uu[mw xi[zx gr[yj
叔興	uu[uy xk[xb
書意	uu[vv yi[lx
率性	uk[wu xk[xp
雙方並重之旨	ul[yy fh[dw bk[bk vs[ph vi[dv vi[bo
水火	uv[uu ho[dp
水則覆舟	uv[uu ze[bd fu[xr vz[pk
水則載舟	uv[uu ze[bd zd[ti vz[pk
說明自然	uo[yb mk[oo zi[pm rj[xd
說知	uo[yb vi[uk
四賓主	si[we bb[gq vu[dw
思誠	si[tx ig[yw
四大	si[we da[hr
斯大林	si[qj da[hr lb[aa
四大學派	si[we da[hr xt[xz pd[dp
四德	si[we de[ru
私德	si[hs de[ru
四諦	si[we di[yl
四度	si[we du[gn
四端	si[we dr[lu
斯多噶學派	si[qj do[xx ga[kc xt[xz pd[dp
斯多葛主義	si[qj do[xx ge[co vu[dw yi[di
斯多亞派	si[qj do[xx ya[hy pd[dp
斯多亞學派	si[qj do[xx ya[hy xt[xz pd[dp
思而不學則殆	si[tx er[ek bu[eu xt[xz ze[bd dd[hs
四法界	si[we fa[dt jp[tr
死非消滅	si[hx fw[su xn[dx mp[hh
四分	si[we ff[bd
四界	si[we jp[tr
四句教	si[we ju[bk jn[tw
司空圖	si[vh ks[xg tu[ww
四料簡	si[we ln[md jm[vm
司馬彪	si[vh ma[vv bn[hp
司馬承禎	si[vh ma[vv ig[lu vf[ub
司馬光	si[vh ma[vv gl[xe
司馬遷	si[vh ma[vv qm[qz
司馬談	si[vh ma[vv tj[yh
俟命	si[rs mk[rh
私名	si[hs mk[xk
死生無命	si[hx ug[pf wu[ee mk[rh
死生有命	si[hx ug[pf yz[uo mk[rh
四通	si[we ts[sz
四維	si[we ww[sv
思維方式	si[tx ww[sv fh[dw ui[qg
思維能力	si[tx ww[sv ng[sb li[vp
四毋	si[we wu[vv
四無說	si[we wu[ee uo[yb
思無邪	si[tx wu[ee xp[ye
四象	si[we xl[dk
思想鬥爭	si[tx xl[ax dz[du vg[dx
思想者事實之母	si[tx xl[ax ve[to ui[hk ui[gd vi[dv mu[vv
思想政治	si[tx xl[ax vg[hw vi[ds
四心	si[we xb[dv
思修交盡	si[tx xq[ru jn[li jb[ud
私有制	si[hs yz[uo vi[nd
四照用	si[we vc[od ys[ou
宋鈃	ss[ga jm[[
宋榮	ss[ga rs[ca
宋榮子	ss[ga rs[ca zi[lh
宋翔鳳	ss[ga xl[yx fg[jy
宋應星	ss[ga yk[gx xk[op
蒐集材料	sz[fj ji[va cd[ac ln[md
俗諦	su[rb di[yl
蘇東坡	su[cl ds[qx po[tp
蘇格拉底	su[cl ge[aw la[fl di[gu
蘇格拉底時期	su[cl ge[aw la[fl di[gu ui[oc qi[qo
蘇秦	su[cl qb[sh
蘇軾	su[cl ui[iq
蘇洵	su[cl xy[db
蘇輿	su[cl yu[pb
蘇轍	su[cl ve[iw
隨處體認天理	sv[eu iu[wb ti[ra rf[yr tm[hd li[wo
隨泯統	sv[eu mb[dm ts[sw
孫臏	sy[zx bb[og
孫不二	sy[zx bu[eu er[hh
孫綽	sy[zx io[sb
孫復	sy[zx fu[ro
損跡返一	sy[fk ji[yz fj[pz yi[hh
損減執	sy[fk jm[dw vi[fj
孫奇逢	sy[zx qi[dk fg[wz
孫卿	sy[zx qk[pg
孫盛	sy[zx ug[wm
孫叔平	sy[zx uu[uy pk[hb
孫文	sy[zx wf[wi
孫武	sy[zx wu[hv
孫夏峰	sy[zx xx[ew fg[uw
孫星衍	sy[zx xk[op yj[rd
損益	sy[fk yi[bm
孫詒讓	sy[zx yi[ys rh[yu
孫逸仙	sy[zx yi[dz xm[ru
損有餘而補不足	sy[fk yz[uo yu[re er[ek bu[yb bu[eu zu[kv
孫中山	sy[zx vs[ku uj[uk
孫子	sy[zx zi[lh
所謂	so[pj ww[yt
所為有名	so[pj ww[dl yz[uo mk[xk
所以發能	so[pj yi[sr fa[vy ng[sb
所以跡	so[pj yi[sr ji[yz
所以立天地者水也	so[pj yi[sr li[lh tm[hd di[ty ve[to uv[uu ye[vu
所以然	so[pj yi[sr rj[xd
所以謂	so[pj yi[sr ww[yt
所以知	so[pj yi[sr vi[uk
所有制	so[pj yz[uo vi[nd
所緣以同異	so[pj yr[sv yi[sr ts[kh yi[kc
所知	so[pj vi[uk
泰阿泰德篇	td[su aa[ek td[su de[ru pm[vh
太沖	td[dd is[dv
太初	td[dd iu[yd
太和	td[dd he[hk
太極	td[dd ji[aj
泰勒斯	td[su le[gl si[qj
太始	td[dd ui[ns
太史儋	td[dd ui[ki dj[rd
太素	td[dd su[fy
胎息	td[os xi[zx
太虛	td[dd xu[hy
太虛本動	td[dd xu[hy bf[ah ds[el
太虛即氣	td[dd xu[hy ji[ge qi[rh
太虛一實	td[dd xu[hy yi[hh ui[gd
太一	td[dd yi[hh
太易	td[dd yi[ob
譚處端	tj[yx iu[wb dr[lu
譚戒甫	tj[yx jp[gc fu[uo
譚峭	tj[yx qn[ux
譚嗣同	tj[yx si[kv ts[kh
澹臺滅明	tj[dd td[sk mp[hh mk[oo
談天衍	tj[yh tm[hd yj[rd
談玄	tj[yh xr[wy
探頤索隱	tj[fg yi[ky so[uy yb[ed
湯斌	th[dv bb[ww
唐才常	th[gx cd[hu ih[xk
唐鶴徵	th[gx he[gn vg[rh
唐鑑	th[gx jm[uj
唐君毅	th[gx jy[xk yi[lj
唐僧	th[gx sg[rb
湯一介	th[dv yi[hh jp[rp
湯用彤	th[dv ys[ou ts[kp
唐甄	th[gx vf[xw
唐仲友	th[gx vs[rv yz[uy
陶弘景	tc[eb hs[gs jk[ow
陶潛	tc[eb qm[de
陶斯	tc[eb si[qj
陶望齡	tc[eb wh[ww lk[vr
陶希聖	tc[eb xi[iu ug[yt
陶行知	tc[eb xk[rh vi[uk
陶淵明	tc[eb yr[dp mk[oo
特殊功能	te[nt uu[hp gs[gl ng[sb
特殊現量	te[nt uu[hp xm[wj ll[oh
體常靜	ti[ra ih[xk jk[fd
體沖和以通元	ti[ra is[dv he[hk yi[sr ts[sz yr[ee
體見	ti[ra jm[ke
體認	ti[ra rf[yr
體同	ti[ra ts[kh
體性	ti[ra xk[xp
體用	ti[ra ys[ou
體用不二	ti[ra ys[ou bu[eu er[hh
體用殊絕	ti[ra ys[ou uu[hp jt[sd
體用胥有	ti[ra ys[ou xu[po yz[uo
田巴	tm[wu ba[ku
天必從之	tm[hd bi[xp cs[rr vi[dv
天不變道亦不變	tm[hd bu[eu bm[yy dc[bz yi[wy bu[eu bm[yy
天常	tm[hd ih[xk
天聰	tm[hd cs[eb
天當	tm[hd dh[xx
天道	tm[hd dc[bz
天道環周	tm[hd dc[bz hr[wb vz[kt
天道尚變	tm[hd dc[bz uh[xk bm[yy
天道為末	tm[hd dc[bz ww[dl mo[ha
天道無親	tm[hd dc[bz wu[ee qb[la
天道自然論	tm[hd dc[bz zi[pm rj[xd ly[yr
天道自然無為	tm[hd dc[bz zi[pm rj[xd wu[ee ww[dl
天德	tm[hd de[ru
天德良知	tm[hd de[ru ll[dg vi[uk
天地皆體	tm[hd di[ty jp[bb ti[ra
天地萬物自然一體	tm[hd di[ty wj[hv wu[nb zi[pm rj[xd yi[hh ti[ra
天地我立	tm[hd di[ty wo[pf li[lh
天地一體也	tm[hd di[ty yi[hh ti[ra ye[vu
天地一指	tm[hd di[ty yi[hh vi[fb
天地與我並生	tm[hd di[ty yu[hv wo[pf bk[bk ug[pf
天地之數	tm[hd di[ty vi[dv uu[mw
天地之性	tm[hd di[ty vi[dv xk[xp
天地之性人為貴	tm[hd di[ty vi[dv xk[xp rf[pd ww[dl gv[vb
天放	tm[hd fh[fw
天府	tm[hd fu[gr
天功	tm[hd gs[gl
天官	tm[hd gr[gu
天官意物	tm[hd gr[gu yi[lx wu[nb
田何	tm[wu he[rk
天極	tm[hd ji[aj
天稽環周	tm[hd ji[hy hr[wb vz[kt
天經地義	tm[hd jk[ss di[ty yi[di
田鳩	tm[wu jq[jn
天爵	tm[hd jt[ag
天鈞	tm[hd jy[jb
天君	tm[hd jy[xk
天均	tm[hd jy[tb
天籟自嗚	tm[hd ld[vh zi[pm wu[kw
天樂	tm[hd le[px
天理	tm[hd li[wo
天理自然	tm[hd li[wo zi[pm rj[xd
天門	tm[hd mf[du
天命	tm[hd mk[rh
天明	tm[hd mk[oo
天命靡常	tm[hd mk[rh mi[gf ih[xk
天命之性	tm[hd mk[rh vi[dv xk[xp
天能	tm[hd ng[sb
天倪	tm[hd ni[rj
田駢	tm[wu pm[mb
天情	tm[hd qk[xf
田俅子	tm[wu qq[rh zi[lh
天趣	tm[hd qu[ze
天泉證道	tm[hd qr[bu vg[yh dc[bz
天人	tm[hd rf[pd
天人不相勝	tm[hd rf[pd bu[eu xl[am ug[op
天人不相預	tm[hd rf[pd bu[eu xl[am yu[yy
天人感應	tm[hd rf[pd gj[wx yk[gx
天人合一	tm[hd rf[pd he[rh yi[hh
天人三策	tm[hd rf[pd sj[hh ce[vc
天人同類	tm[hd rf[pd ts[kh lw[md
天人相參	tm[hd rf[pd xl[am cj[sd
天人相與之際	tm[hd rf[pd xl[am yu[hv vi[dv ji[ee
天人一理	tm[hd rf[pd yi[hh li[wo
天人之辨	tm[hd rf[pd vi[dv bm[ld
天人之分	tm[hd rf[pd vi[dv ff[bd
天生人成	tm[hd ug[pf rf[pd ig[wv
天生之智	tm[hd ug[pf vi[dv vi[uo
天屬	tm[hd uu[up
天體非氣	tm[hd ti[ra fw[su qi[rh
天網	tm[hd wh[ki
天文	tm[hd wf[wi
天下為公	tm[hd xx[hb ww[dl gs[bs
天下惟器	tm[hd xx[hb ww[xv qi[kq
田襄子	tm[wu xl[wk zi[lh
天行	tm[hd xk[rh
天刑	tm[hd xk[kd
天行有常	tm[hd xk[rh yz[uo ih[xk
天性之知	tm[hd xk[xp vi[dv vi[uk
天演	tm[hd yj[dg
天養	tm[hd yh[yp
天意	tm[hd yi[lx
天有常道	tm[hd yz[uo ih[xk dc[bz
天與地卑	tm[hd yu[hv di[ty bw[bu
天與人交相勝還相用	tm[hd yu[hv rf[pd jn[li xl[am ug[op hd[bz xl[am ys[ou
天元	tm[hd yr[ee
天政	tm[hd vg[hw
天職	tm[hd vi[ek
天志	tm[hd vi[ux
天智	tm[hd vi[uo
田仲	tm[wu vs[rv
條理	tn[wa li[wo
聽其言而觀其行	tk[kj qi[cb yj[we er[ek gr[yj qi[cb xk[rh
通達	ts[sz da[dz
統待	ts[sw dd[rt
同而不和	ts[kh er[ek bu[eu he[hk
同歸殊途	ts[kh gv[ux uu[hp tu[rz
通過直覺	ts[sz go[cz vi[uj jt[xj
通幾	ts[sz ji[pv
通經致用	ts[sz jk[ss vi[hw ys[ou
同類相動	ts[kh lw[md xl[am ds[el
同氣相應	ts[kh qi[rh xl[am yk[gx
通天教主	ts[sz tm[hd jn[tw vu[dw
同天人	ts[kh tm[hd rf[pd
童心說	ts[lo xb[dv uo[yb
痛癢之知	ts[bs yh[by vi[dv vi[uk
同異	ts[kh yi[kc
同異交得	ts[kh yi[kc jn[li de[ro
同一性	ts[kh yi[hh xk[xp
同則不繼	ts[kh ze[bd bu[eu ji[sm
同則同之	ts[kh ze[bd ts[kh vi[dv
突駕	tu[xq jx[lm
吐納	tu[kt na[sk
圖難於易	tu[ww nj[yv yu[eu yi[ob
塗之人可以為禹	tu[dr vi[dv rf[pd ke[dk yi[sr ww[dl yu[pk
推故致新	tv[fv gu[gw vi[hw xb[lj
推論	tv[fv ly[yr
推知	tv[fv vi[uk
託古改制	to[fp gu[uk gd[kw vi[nd
瓦斯一大塊	wa[hv si[qj yi[hh da[hr kk[tv
外部環境	wd[xb bu[le hr[wb jk[tl
外丹	wd[xb dj[kw
外化而內不化	wd[xb hx[rq er[ek nw[kr bu[eu hx[rq
外界事物	wd[xb jp[tr ui[hk wu[nb
外界條理	wd[xb jp[tr tn[wa li[wo
外來詞	wd[xb ld[hm ci[yv
外生	wd[xb ug[pf
外籀	wd[xb vz[vf
萬法唯識	wj[hv fa[dt ww[kv ui[yk
萬化皆漸而無頓	wj[hv hx[rq jp[bb jm[di er[ek wu[ee dy[ty
萬化我出	wj[hv hx[rq wo[pf iu[ck
玩世不恭	wj[we ui[nv bu[eu gs[gx
萬物皆備於我	wj[hv wu[nb jp[bb bw[wt yu[eu wo[pf
萬物一馬	wj[hv wu[nb yi[hh ma[vv
萬物一齊	wj[hv wu[nb yi[hh qi[wp
萬物與我為一	wj[hv wu[nb yu[hv wo[pf ww[dl yi[hh
萬物之數括於三	wj[hv wu[nb vi[dv uu[mw ko[fq yu[eu sj[hh
萬章	wj[hv vh[lo
王安石	wh[su an[gn ui[ek
王霸並用	wh[su ba[yg bk[bk ys[ou
王柏	wh[su bd[ab
王弼	wh[su bi[ge
王充	wh[su is[we
王重陽	wh[su is[ph yh[eo
王處一	wh[su iu[wb yi[hh
王船山	wh[su ir[vj uj[uk
王道	wh[su dc[bz
王導	wh[su dc[kc
汪奠基	wh[dw dm[bd ji[qt
王棟	wh[su ds[aq
王浮	wh[su fu[da
王符	wh[su fu[vr
王輔嗣	wh[su fu[if si[kv
王夫之	wh[su fu[er vi[dv
王艮	wh[su gf[xv
王國維	wh[su go[ww ww[sv
王畿	wh[su ji[yt
王荊公	wh[su jk[cd gs[bs
王臨川	wh[su lb[uv ir[pu
王門四句教	wh[su mf[du si[we ju[bk jn[tw
王門四句訣	wh[su mf[du si[we ju[bk jt[yv
王明	wh[su mk[oo
王雱	wh[su ph[[
王清任	wh[su qk[df rf[rq
王戎	wh[su rs[gu
汪容甫	wh[dw rs[xr fu[uo
王若水	wh[su ro[cu uv[uu
王士元	wh[su ui[uh yr[ee
王守仁	wh[su uz[gc rf[re
王肅	wh[su su[xu
王韜	wh[su tc[wa
王廷相	wh[su tk[qj xl[am
王通	wh[su ts[sz
王文公	wh[su wf[wi gs[bs
王憲鈞	wh[su xm[gn jy[jb
王先謙	wh[su xm[ne qm[yb
王心齋	wh[su xb[dv vd[we
王星拱	wh[su xk[op gs[fg
王玄覽	wh[su xr[wy lj[uj
王衍	wh[su yj[rd
王陽明	wh[su yh[eo mk[oo
汪應辰	wh[dw yk[gx if[ie
王應麟	wh[su yk[gx lb[gm
王源	wh[su yr[di
罔直蒙酋冥	wh[kb vi[uj mg[ch qq[by mk[go
汪中	wh[dw vs[ku
汪子嵩	wh[dw zi[lh ss[uw
魏伯陽	ww[hg bo[rb yh[eo
為大於細	ww[dl da[hr yu[eu xi[st
為道日損	ww[dl dc[bz ri[wh sy[fk
未發	ww[ha fa[vy
衛國者	ww[eh go[ww ve[to
魏華存	ww[hg hx[ru cy[uz
未濟	ww[ha ji[dw
衛玠	ww[eh jp[wr
魏了翁	ww[hg le[vu wg[bx
唯理論	ww[kv li[wo ly[yr
惟理為實	ww[xv li[wo ww[dl ui[gd
魏良弼	ww[hg ll[dg bi[ge
尉繚子	ww[uc ln[sd zi[lh
微明	ww[ru mk[oo
唯名論	ww[kv mk[xk ly[yr
魏默深	ww[hg mo[hq uf[dg
魏牟	ww[hg mz[sn
為仁由己	ww[dl rf[re yz[ou ji[kv
為人者天	ww[dl rf[pd ve[to tm[hd
唯上智與下愚不移	ww[kv uh[bh vi[uo yu[hv xx[hb yu[ox bu[eu yi[hx
微生滅	ww[ru ug[pf mp[hh
唯實論	ww[kv ui[gd ly[yr
唯識無境	ww[kv ui[yk wu[ee jk[tl
唯識五位	ww[kv ui[yk wu[hu ww[rl
緯書	ww[sw uu[vv
魏特林	ww[hg te[nt lb[aa
危微精一	ww[de ww[ru jk[mf yi[hh
為我	ww[dl wo[pf
唯我獨尊	ww[kv wo[pf du[qi zy[bc
唯物辯證法	ww[kv wu[nb bm[ly vg[yh fa[dt
唯物辯證法論戰	ww[kv wu[nb bm[ly vg[yh fa[dt ly[yr vj[bg
唯物史觀	ww[kv wu[nb ui[ki gr[yj
唯物主義	ww[kv wu[nb vu[dw yi[di
唯物主義世界觀	ww[kv wu[nb vu[dw yi[di ui[nv jp[tr gr[yj
唯物主義哲學家	ww[kv wu[nb vu[dw yi[di ve[fk xt[xz jx[gu
微顯闡幽	ww[ru xm[oy ij[mb yz[yy
韋弦之喻	ww[hh xm[gw vi[dv yu[kr
維新	ww[sv xb[lj
唯心辯證法	ww[kv xb[dv bm[ly vg[yh fa[dt
唯心史觀	ww[kv xb[dv ui[ki gr[yj
唯心主義	ww[kv xb[dv vu[dw yi[di
唯心主義傾向	ww[kv xb[dv vu[dw yi[di qk[rb xl[pk
唯心主義者	ww[kv xb[dv vu[dw yi[di ve[to
唯心主義哲學	ww[kv xb[dv vu[dw yi[di ve[fk xt[xz
為學日益	ww[dl xt[xz ri[wh yi[bm
微言大義	ww[ru yj[we da[hr yi[di
衛鞅	ww[eh yh[gk
惟以五路知	ww[xv yi[sr wu[hu lu[zw vi[uk
唯一心是實	ww[kv yi[hh xb[dv ui[op ui[gd
唯一者	ww[kv yi[hh ve[to
魏源	ww[hg yr[di
文便是道	wf[wi bm[rh ui[op dc[bz
問答方法	wf[mk da[vr fh[dw fa[dt
溫公頤	wf[do gs[bs yi[ky
溫故知新	wf[do gu[gw vi[uk xb[lj
文化生活	wf[wi hx[rq ug[pf ho[dq
文化政治學	wf[wi hx[rq vg[hw vi[ds xt[xz
聞見之知	wf[me jm[ke vi[dv vi[uk
溫良恭儉讓	wf[do ll[dg gs[gx jm[rr rh[yu
文亂法	wf[wi lr[qv fa[dt
文明	wf[wi mk[oo
文氣說	wf[wi qi[rh uo[yb
溫柔敦厚	wf[do rz[ya dy[ww hz[io
問題與主義論戰	wf[mk ti[oy yu[hv vu[dw yi[di ly[yr vj[bg
文天祥	wf[wi tm[hd xl[uy
文武並行	wf[wi wu[hv bk[bk xk[rh
文武之道一也	wf[wi wu[hv vi[dv dc[bz yi[hh ye[vu
文偃	wf[wi yj[rk
文益	wf[wi yi[bm
文藝復興	wf[wi yi[cv fu[ro xk[xb
聞知	wf[me vi[uk
文質	wf[wi vi[pu
文質彬彬	wf[wi vi[pu bb[aa bb[aa
文質交替	wf[wi vi[pu jn[li ti[eo
握固	wo[fu gu[wg
我慢心	wo[pf mj[xo xb[dv
握一知多	wo[fu yi[hh vi[uk do[xx
我執	wo[pf vi[fj
我知天下之中央	wo[pf vi[uk tm[hd xx[hb vi[dv vs[ku yh[kd
無跋尚	wu[ee ba[zu uh[xk
五百年必有王者興	wu[hu bd[eo nm[rn bi[xp yz[uo wh[su ve[to xk[xb
物必有合	wu[nb bi[xp yz[uo he[rh
物不遷	wu[nb bu[eu qm[qz
五材	wu[hu cd[ac
無產階級專政	wu[ee ij[lp jp[er ji[sj vr[ev vg[hw
五常	wu[hu ih[xk
無常	wu[ee ih[xk
吳澄	wu[kt ig[dd
無待	wu[ee dd[rt
五德	wu[hu de[ru
五德終始	wu[hu de[ru vs[sw ui[ns
五德轉移	wu[hu de[ru vr[ie yi[hx
無獨必有對	wu[ee du[qi bi[xp yz[uo dv[yc
無對	wu[ee dv[yc
無對待在對待中	wu[ee dv[yc dd[rt zd[ut dv[yc dd[rt vs[ku
物各自生	wu[nb ge[wk zi[pm ug[pf
無故從有故	wu[ee gu[gw cs[rr yz[uo gu[gw
五鬼鬧中華	wu[hu gv[be nc[mw vs[ku hx[ru
無何有之鄉	wu[ee he[rk yz[uo vi[dv xl[sp
無厚不可積也	wu[ee hz[io bu[eu ke[dk ji[hk ye[vu
物化	wu[nb hx[rq
無會運世	wu[ee hv[re yy[ez ui[nv
無跡	wu[ee ji[yz
無己	wu[ee ji[kv
無極	wu[ee ji[aj
物極必反	wu[nb ji[aj bi[xp fj[py
無極而太極	wu[ee ji[aj er[ek td[dd ji[aj
五戒	wu[hu jp[gc
無盡緣起	wu[ee jb[ud yr[sv qi[zk
物競天擇	wu[nb jk[lk tm[hd ze[fy
伍舉論美	wu[rw ju[xf ly[yr mw[bw
吳筠	wu[kt jy[vt
物理可知	wu[nb li[wo ke[dk vi[uk
吳亮平	wu[kt ll[wj pk[hb
無量世	wu[ee ll[oh ui[nv
無漏	wu[ee lz[du
五路	wu[hu lu[zw
五倫	wu[hu ly[rr
無名	wu[ee mk[xk
無明	wu[ee mk[oo
物莫非指	wu[nb mo[co fw[su vi[fb
五逆	wu[hu ni[nz
無念	wu[ee nm[rx
無念為宗	wu[ee nm[rx ww[dl zs[ge
無平不陂	wu[ee pk[hb bu[eu bw[ep
吳起	wu[kt qi[zk
五其比	wu[hu qi[cb bi[bb
無其器則無其道	wu[ee qi[cb qi[kq ze[bd wu[ee qi[cb dc[bz
物氣之理	wu[nb qi[rh vi[dv li[wo
無情	wu[ee qk[xf
無情有性	wu[ee qk[xf yz[uo xk[xp
無窮	wu[ee qs[xl
無染	wu[ee rj[da
吾日三省吾身	wu[wk ri[wh sj[hh xk[xm wu[wk uf[pu
無神教	wu[ee uf[uo jn[tw
無生	wu[ee ug[pf
物生有兩	wu[nb ug[pf yz[uo ll[hk
五事	wu[hu ui[hk
五時七候	wu[hu ui[oc qi[hv hz[ru
勿施於人	wu[bp ui[fr yu[eu rf[pd
五殊二實	wu[hu uu[hp er[hh ui[gd
五四新文化運動	wu[hu si[we xb[lj wf[wi hx[rq yy[ez ds[el
無私則無心	wu[ee si[hs ze[bd wu[ee xb[dv
吳廷翰	wu[kt tk[qj hj[ur
烏托邦	wu[bv to[fp bh[fe
無往不復	wu[ee wh[rd bu[eu fu[ro
無為	wu[ee ww[dl
五位百法	wu[hu ww[rl bd[eo fa[dt
無為而無不為	wu[ee ww[dl er[ek wu[ee bu[eu ww[dl
無為而治	wu[ee ww[dl er[ek vi[ds
無為法	wu[ee ww[dl fa[dt
五位君臣	wu[hu ww[rl jy[xk if[ku
無我	wu[ee wo[pf
無我之境	wu[ee wo[pf vi[dv jk[tl
五無	wu[hu wu[ee
無無	wu[ee wu[ee
物無孤立之理	wu[nb wu[ee gu[zp li[lh vi[dv li[wo
物物者非物	wu[nb wu[nb ve[to fw[su wu[nb
無限性	wu[ee xm[eg xk[xp
無心	wu[ee xb[dv
吾心即是宇宙	wu[wk xb[dv ji[ge ui[op yu[ge vz[gy
無心與順有	wu[ee xb[dv yu[hv uy[iy yz[uo
五行	wu[hu xk[rh
五性	wu[hu xk[xp
五行無常勝	wu[hu xk[rh wu[ee ih[xk ug[op
五行毋常勝	wu[hu xk[rh wu[vv ih[xk ug[op
五行相勝	wu[hu xk[rh xl[am ug[op
五行相生	wu[hu xk[rh xl[am ug[pf
毋須擔心	wu[vv xu[py dj[fo xb[dv
無言無意之域	wu[ee yj[we wu[ee yi[lx vi[dv yu[tg
務義	wu[wl yi[di
毋意	wu[vv yi[lx
無以人滅天	wu[ee yi[sr rf[pd mp[hh tm[hd
無以小害大	wu[ee yi[sr xn[ub hd[gf da[hr
無因論	wu[ee yb[wd ly[yr
物因意果	wu[nb yb[wd yi[lx go[oa
無用之用	wu[ee ys[ou vi[dv ys[ou
無有	wu[ee yz[uo
吳虞	wu[kt yu[hk
無慾	wu[ee yu[bd
吳與弼	wu[kt yu[hv bi[ge
吳樾	wu[kt yt[az
五蘊	wu[hu yy[cs
物則不通	wu[nb ze[bd bu[eu ts[sz
五賊	wu[hu zw[bg
無政府主義論戰	wu[ee vg[hw fu[gr vu[dw yi[di ly[yr vj[bg
物質	wu[nb vi[pu
物指	wu[nb vi[fb
無質獨影	wu[ee vi[pu du[qi yk[op
吳稚暉	wu[kt vi[hv hv[og
物質進化時期	wu[nb vi[pu jb[ez hx[rq ui[oc qi[qo
物質論	wu[nb vi[pu ly[yr
物質性	wu[nb vi[pu xk[xp
物至則應	wu[nb vi[ht ze[bd yk[gx
五支作法	wu[hu vi[uy zo[rv fa[dt
物種進化之時期	wu[nb vs[hv jb[ez hx[rq vi[dv ui[oc qi[qo
物種競爭原則	wu[nb vs[hv jk[lk vg[dx yr[ib ze[bd
五重唯識觀	wu[hu vs[ph ww[kv ui[yk gr[yj
無住	wu[ee vu[rd
無足輕重	wu[ee zu[kv qk[is vs[ph
襲常	xi[yy ih[xk
習常	xi[vd ih[xk
郗超	xi[ie ic[zd
繫辭盡言	xi[py ci[ql jb[ud yj[we
習動	xi[vd ds[el
西方人	xi[hk fh[dw rf[pd
西方文化	xi[hk fh[dw wf[wi hx[rq
西方哲學	xi[hk fh[dw ve[fk xt[xz
西方政治思想	xi[hk fh[dw vg[hw vi[ds si[tx xl[ax
西方政治學	xi[hk fh[dw vg[hw vi[ds xt[xz
西方中世紀	xi[hk fh[dw vs[ku ui[nv ji[sk
羲和	xi[bh he[hk
希臘本土	xi[iu la[og bf[ah tu[uh
希臘城邦時代	xi[iu la[og ig[tw bh[fe ui[oc dd[rq
希臘城邦制度	xi[iu la[og ig[tw bh[fe vi[nd du[gn
希臘化時代	xi[iu la[og hx[rq ui[oc dd[rq
希臘文	xi[iu la[og wf[wi
希臘語	xi[iu la[og yu[yw
希臘哲學	xi[iu la[og ve[fk xt[xz
希臘哲學家	xi[iu la[og ve[fk xt[xz jx[gu
昔蘭尼學派	xi[go lj[bs ni[ub xt[xz pd[dp
西門豹	xi[hk mf[du bc[pb
襲明	xi[yy mk[oo
錫諾普	xi[jo no[yc pu[bo
翕闢	xi[rx pi[ul
翕闢成變	xi[rx pi[ul ig[wv bm[yy
希遷	xi[iu qm[qz
西塞羅	xi[hk sd[gt lo[sx
吸攝力	xi[kj ue[fe li[vp
西天	xi[hk tm[hd
習相遠	xi[vd xl[am yr[ez
習心	xi[vd xb[dv
洗心	xi[dn xb[dv
習行	xi[vd xk[rh
西學其末	xi[hk xt[xz qi[cb mo[ha
希運	xi[iu yy[ez
下德	xx[hb de[ru
夏侯建	xx[ew hz[rv jm[yj
夏侯勝	xx[ew hz[rv ug[op
夏侯玄	xx[ew hz[rv xr[wy
下學上達	xx[hb xt[xz uh[bh da[dz
現代科學	xm[wj dd[rq ke[hd xt[xz
現代哲學	xm[wj dd[rq ve[fk xt[xz
憲法國家	xm[gn fa[dt go[ww jx[gu
現量	xm[wj ll[oh
纖穠	xm[sq ns[hg
現實性	xm[wj ui[gd xk[xp
見素抱樸	xm[ke su[fy bc[fb pu[ab
先天學	xm[ne tm[hd xt[xz
先王之道	xm[ne wh[su vi[dv dc[bz
顯微闡幽	xm[oy ww[ru ij[mb yz[yy
現象世界	xm[wj xl[dk ui[nv jp[tr
現行	xm[wj xk[rh
先驗論	xm[ne yj[mr ly[yr
憲章文武	xm[gn vh[lo wf[wi wu[hv
先質後文	xm[ne vi[pu hz[pk wf[wi
先知先覺	xm[ne vi[uk xm[ne jt[xj
相待	xl[am dd[rt
相對	xl[am dv[yc
相對民主	xl[am dv[yc mb[kv vu[dw
相對真理	xl[am dv[yc vf[uj li[wo
相對主義	xl[am dv[yc vu[dw yi[di
相反而不可以相無	xl[am fj[py er[ek bu[eu ke[dk yi[sr xl[am wu[ee
相反相成	xl[am fj[py xl[am ig[wv
相反相濟	xl[am fj[py xl[am ji[dw
相反相因	xl[am fj[py xl[am yb[wd
相非	xl[am fw[su
相分	xl[am ff[bd
相夫氏	xl[am fu[er ui[pq
向郭逍遙義	xl[pk go[we xn[xz yc[az yi[di
相火	xl[am ho[dp
相即	xl[am ji[ge
相濟	xl[am ji[dw
相捄相勝而相成	xl[am jq[[ xl[am ug[op er[ek xl[am ig[wv
相里勤	xl[am li[ot qb[nl
相里氏	xl[am li[ot ui[pq
鄉陵氏	xl[sp lk[et ui[pq
相入	xl[am ru[pd
相生養之道	xl[am ug[pf yh[yp vi[dv dc[bz
象數	xl[dk uu[mw
相天	xl[am tm[hd
象外	xl[dk wd[xb
象外無道	xl[dk wd[xb wu[ee dc[bz
象外之象	xl[dk wd[xb vi[dv xl[dk
相為	xl[am ww[dl
向秀	xl[pk xq[hn
相續	xl[am xu[su
饗宴篇	xl[sr yj[go pm[vh
相因	xl[am yb[wd
相因之功	xl[am yb[wd vi[dv gs[gl
相與	xl[am yu[hv
鄉愿	xl[sp yr[ix
向子期	xl[pk zi[lh qi[qo
蕭抱珍	xn[cx bc[fb vf[wr
小辯	xn[ub bm[ly
小變而不失大常	xn[ub bm[yy er[ek bu[eu ui[pe da[hr ih[xk
蕭琛	xn[cx if[wg
蕭楚女	xn[cx iu[ap nv[vp
孝慈則忠	xn[tz ci[bx ze[bd vs[vx
孝弟	xn[tz di[bg
小故	xn[ub gu[gw
小國寡民	xn[ub go[ww gx[gf mb[kv
小康	xn[ub kh[gx
肖前	xn[xo qm[bo
小人喻於利	xn[ub rf[pd yu[kr yu[eu li[hd
小人之辯	xn[ub rf[pd vi[dv bm[ly
小三世	xn[ub sj[hh ui[nv
蕭萐父	xn[cx ua[[ fu[bi
小蘇格拉底學派	xn[ub su[cl ge[aw la[fl di[gu xt[xz pd[dp
孝悌	xn[tz ti[xb
小體	xn[ub ti[ra
孝悌忠信	xn[tz ti[xb vs[vx xb[ry
肖統	xn[xo ts[sw
小同異	xn[ub ts[kh yi[kc
消息	xn[dx xi[zx
小亞細亞	xn[ub ya[hy xi[st ya[hy
蕭衍	xn[cx yj[rd
效驗	xn[lw yj[mr
逍遙	xn[xz yc[az
逍遙學派	xn[xz yc[az xt[xz pd[dp
小一	xn[ub yi[hh
蕭子良	xn[cx zi[lh ll[dg
謝赫	xp[yu he[tt
絜矩之道	xp[[ ju[uk vi[dv dc[bz
謝鯤	xp[yu ky[yo
謝良佐	xp[yu ll[dg zo[ru
謝林	xp[yu lb[aa
邪魔外道	xp[ye mo[gg wd[xb dc[bz
謝上蔡	xp[yu uh[bh cd[cx
謝玄	xp[yu xr[wy
謝應芳	xp[yu yk[gx fh[cf
心辯	xb[dv bm[ly
新柏拉圖學派	xb[lj bo[ab la[fl tu[ww xt[xz pd[dp
新柏拉圖主義	xb[lj bo[ab la[fl tu[ww vu[dw yi[di
心成之說	xb[dv ig[wv vi[dv uo[yb
新村主義運動	xb[lj cy[ac vu[dw yi[di yy[ez ds[el
心法	xb[dv fa[dt
新故相除	xb[lj gu[gw xl[am iu[er
薪火之喻	xb[cl ho[dp vi[dv yu[kr
心跡	xb[dv ji[yz
心即理	xb[dv ji[ge li[wo
心即氣	xb[dv ji[ge qi[rh
心即生命力	xb[dv ji[ge ug[pf mk[rh li[vp
心境更互緣生	xb[dv jk[tl gg[ho hu[hv yr[sv ug[pf
心具眾理	xb[dv ju[jb vs[rr li[wo
心力	xb[dv li[vp
心靈智慧	xb[dv lk[xh vi[uo hv[fx
心聲二物	xb[dv ug[um er[hh wu[nb
心聲心畫	xb[dv ug[um xb[dv hx[ht
心術	xb[dv uu[ad
心所	xb[dv so[pj
心統性情	xb[dv ts[sw xk[xp qk[xf
心外無理	xb[dv wd[xb wu[ee li[wo
心外無物	xb[dv wd[xb wu[ee wu[nb
心外無學	xb[dv wd[xb wu[ee xt[xz
心王	xb[dv wh[su
新王必改制	xb[lj wh[su bi[xp gd[kw vi[nd
心為慮本	xb[dv ww[dl lv[hx bf[ah
心物	xb[dv wu[nb
心無本體	xb[dv wu[ee bf[ah ti[ra
心物合一	xb[dv wu[nb he[rh yi[hh
心無自體	xb[dv wu[ee zi[pm ti[ra
信行	xb[ry xk[rh
心性	xb[dv xk[xp
心意識	xb[dv yi[lx ui[yk
心齋	xb[dv vd[we
新政治學	xb[lj vg[hw vi[ds xt[xz
心之官則思	xb[dv vi[dv gr[gu ze[bd si[tx
興必有廢	xk[xb bi[xp yz[uo fw[gv
邢昺	xk[ke bk[[
省察克治	xk[xm ia[gx ke[ge vi[ds
性成命定	xk[xp ig[wv mk[rh dk[gp
性成於習	xk[xp ig[wv yu[eu xi[vd
形存則神存	xk[kp cy[uz ze[bd uf[uo cy[uz
刑德	xk[kd de[ru
刑德相養	xk[kd de[ru xl[am yh[yp
性惡	xk[xp ee[hx
形而上	xk[kp er[ek uh[bh
形而上學	xk[kp er[ek uh[bh xt[xz
形而上學唯物主義	xk[kp er[ek uh[bh xt[xz ww[kv wu[nb vu[dw yi[di
形而下	xk[kp er[ek xx[hb
性分	xk[xp ff[bd
性分之知	xk[xp ff[bd vi[dv vi[uk
性各自足	xk[xp ge[wk zi[pm zu[kv
興觀群怨	xk[xb gr[yj qy[xy yr[xx
性禾善米	xk[xp he[pa uj[yk mi[ba
形化	xk[kp hx[rq
形魂	xk[kp hy[eg
形跡	xk[kp ji[yz
性即理	xk[xp ji[ge li[wo
形靜神馳	xk[kp jk[fd uf[uo ii[my
性具	xk[xp ju[jb
形具而神生	xk[kp ju[jb er[ek uf[uo ug[pf
性覺	xk[xp jt[xj
行可兼知	xk[rh ke[dk jm[bh vi[uk
性空	xk[xp ks[xg
形潰反原	xk[kp kv[dv fj[py yr[ib
性理	xk[xp li[wo
性靈說	xk[xp lk[xh uo[yb
興滅繼絕	xk[xb mp[hh ji[sm jt[sd
刑名	xk[kd mk[xk
形名	xk[kp mk[xk
性命	xk[xp mk[rh
幸偶遭遇	xk[tb ou[ro zc[hz yu[oz
行氣	xk[rh qi[rh
性起	xk[xp qi[zk
性其情	xk[xp qi[cb qk[xf
行其所不知以致其知	xk[rh qi[cb so[pj bu[eu vi[uk yi[sr vi[hw qi[cb vi[uk
性情	xk[xp qk[xf
性情三品	xk[xp qk[xf sj[hh pb[kk
興趣	xk[xb qu[ze
性日生日成	xk[xp ri[wh ug[pf ri[wh ig[wv
性三品	xk[xp sj[hh pb[kk
性善	xk[xp uj[yk
性善惡混	xk[xp uj[yk ee[hx hy[do
性善情惡	xk[xp uj[yk qk[xf ee[hx
邢邵	xk[ke uc[de
形神	xk[kp uf[uo
形神不二	xk[kp uf[uo bu[eu er[hh
形神非一	xk[kp uf[uo fw[su yi[hh
形神相合	xk[kp uf[uo xl[am he[rh
形神相即	xk[kp uf[uo xl[am ji[ge
形神相異	xk[kp uf[uo xl[am yi[kc
形恃神以立	xk[kp ui[xt uf[uo yi[sr li[lh
形式質料說	xk[kp ui[qg vi[pu ln[md uo[yb
行是知之成	xk[rh ui[op vi[uk vi[dv ig[wv
形似	xk[kp si[rs
行為方式	xk[rh ww[dl fh[dw ui[qg
性偽之分	xk[xp ww[rd vi[dv ff[bd
性無善惡論	xk[xp wu[ee uj[yk ee[hx ly[yr
性習	xk[xp xi[vd
行先知後	xk[rh xm[ne vi[uk hz[pk
興象	xk[xb xl[dk
性相	xk[xp xl[am
性相近	xk[xp xl[am jb[jz
形謝則神滅	xk[kp xp[yu ze[bd uf[uo mp[hh
形性不二	xk[kp xk[xp bu[eu er[hh
行秀	xk[rh xq[hn
性修不二	xk[xp xq[ru bu[eu er[hh
形須氣而成	xk[kp xu[py qi[rh er[ek ig[wv
形須神而立焉	xk[kp xu[py uf[uo er[ek li[lh yj[hh
行易知難	xk[rh yi[ob vi[uk nj[yv
性有善有惡	xk[xp yz[uo uj[yk yz[uo ee[hx
行遠必自邇	xk[rh yr[ez bi[xp zi[pm er[dz
星雲	xk[op yy[es
形者生之具	xk[kp ve[to ug[pf vi[dv ju[jb
性智	xk[xp vi[uo
性知	xk[xp vi[uk
形質神用	xk[kp vi[pu uf[uo ys[ou
行重知輕	xk[rh vs[ph vi[uk qk[is
熊伯龍	xs[sd bo[rb ls[yp
熊賜履	xs[sd ci[bo lv[ur
雄渾	xs[uv hy[dg
雄節	xs[uv jp[ce
熊十力	xs[sd ui[hu li[vp
熊鍾陵	xs[sd vs[jv lk[et
修齊治平	xq[ru qi[wp vi[ds pk[hb
修飾學	xq[ru ui[ur xt[xz
羞惡之心	xq[yi wu[hx vi[dv xb[dv
修正的民主政治	xq[ru vg[hv de[bb mb[kv vu[dw vg[hw vi[ds
徐愛	xu[rr ai[au
徐復觀	xu[rr fu[ro gr[yj
徐幹	xu[rr gj[hu
徐光啟	xu[rr gl[xe qi[hk
許衡	xu[yw hg[rd
虛極	xu[hy ji[aj
虛霩	xu[hy ko[[
許謙	xu[yw qm[yb
許慎	xu[yw uf[xu
虛實	xu[hy ui[gd
虛室生白	xu[hy ui[gh ug[pf bd[po
徐壽	xu[rr uz[fc
虛位	xu[hy ww[rl
徐謂	xu[rr ww[yt
虛無形	xu[hy wu[ee xk[kp
虛無有	xu[hy wu[ee yz[uo
虛象	xu[hy xl[dk
許行	xu[yw xk[rh
虛一而靜	xu[hy yi[hh er[ek jk[fd
玄德	xr[wy de[ru
懸解	xr[qx jp[dd
玄覽	xr[wy lj[uj
玄妙	xr[wy mn[nx
玄冥	xr[wy mk[go
玄牝	xr[wy pb[nb
玄談	xr[wy tj[yh
玄通	xr[wy ts[sz
玄同	xr[wy ts[kh
玄學鬼	xr[wy xt[xz gv[be
宣夜說	xr[gh ye[wr uo[yb
玄一	xr[wy yi[hh
玄一之道	xr[wy yi[hh vi[dv dc[bz
玄遠	xr[wy yr[ez
玄奘	xr[wy zh[pd
學而不思則罔	xt[xz er[ek bu[eu si[tx ze[bd wh[kb
學而不厭	xt[xz er[ek bu[eu yj[iq
學而時習之	xt[xz er[ek ui[oc xi[vd vi[dv
學而優則仕	xt[xz er[ek yz[ry ze[bd ui[ru
學而知之	xt[xz er[ek vi[uk vi[dv
薛福成	xt[cp fu[uh ig[wv
薛季宣	xt[cp ji[hz xr[gh
血氣心知	xt[pm qi[rh xb[dv vi[uk
學說庫	xt[xz uo[yb ku[gi
學思	xt[xz si[tx
學問思辨	xt[xz wf[mk si[tx bm[ld
學習	xt[xz xi[vd
薛瑄	xt[cp xr[wg
學園派	xt[xz yr[we pd[dp
學知	xt[xz vi[uk
荀粲	xy[cb cj[bm
循道而不貳	xy[rp dc[bz er[ek bu[eu er[qb
荀況	xy[cb kl[dk
循理	xy[rp li[wo
循名究理	xy[rp mk[xk jq[xj li[wo
循名責實	xy[rp mk[xk ze[fb ui[gd
荀卿	xy[cb qk[pg
尋求超越	xy[xc qq[hu ic[zd yt[zh
荀融	xy[cb rs[hi
荀爽	xy[cb ul[di
熏習	xy[pd xi[vd
荀彧	xy[cb yu[[
荀悅	xy[cb yt[xb
荀子	xy[cb zi[lh
雅典法庭	ya[yv dm[kb fa[dt tk[gq
牙含章	ya[hv hj[rk vh[lo
亞里士多德	ya[hy li[ot ui[uh do[xx de[ru
亞里斯提布	ya[hy li[ot si[qj ti[fo bu[uj
亞里土多德學說	ya[hy li[ot tu[uh do[xx de[ru xt[xz uo[yb
揠苗助長	ya[fk mn[ct vu[ql vh[ph
雅遠	ya[yv yr[ez
嚴北溟	yj[hy bw[ub mk[dg
言不盡意	yj[we bu[eu jb[ud yi[lx
彥琮	yj[lp cs[wg
言多方	yj[we do[xx fh[dw
嚴復	yj[hy fu[ro
顏回	yj[ly hv[wk
嚴幾道	yj[hy ji[pv dc[bz
言盡意	yj[we jb[ud yi[lx
研究對象	yj[ek jq[xj dv[yc xl[dk
研究自然	yj[ek jq[xj zi[pm rj[xd
顏鈞	yj[ly jy[jb
嚴君平	yj[hy jy[xk pk[hb
嚴靈峰	yj[hy lk[xh fg[uw
閻羅妖	yj[md lo[sx yc[np
晏平仲	yj[og pk[hb vs[rv
閻若璩	yj[md ro[cu qu[wh
顏師古	yj[ly ui[uh gu[uk
延壽	yj[pj uz[fc
延天佑人	yj[pj tm[hd yz[ru rf[pd
言為心聲	yj[we ww[dl xb[dv ug[um
顏習齋	yj[ly xi[vd vd[we
言行	yj[we xk[rh
言偃	yj[we yj[rk
顏延之	yj[ly yj[pj vi[dv
言意	yj[we yi[lx
言以諭心	yj[we yi[sr yu[yr xb[dv
言意之辨	yj[we yi[lx vi[dv bm[ld
言因理而變	yj[we yb[wd li[wo er[ek bm[yy
晏嬰	yj[og yk[bn
嚴羽	yj[hy yu[xx
顏元	yj[ly yr[ee
顏淵	yj[ly yr[dp
燕之北越之南是也	yj[nk vi[dv bw[ub yt[zh vi[dv nj[uk ui[op ye[vu
顏之推	yj[ly vi[dv tv[fv
晏子	yj[og zi[lh
嚴遵	yj[hy zy[bz
楊布利柯	yh[av bu[uj li[hd ke[ak
楊誠齋	yh[av ig[yw vd[we
楊慈湖	yh[av ci[bx hu[dg
楊東明	yh[av ds[qx mk[oo
陽剛之美	yh[eo gh[kd vi[dv mw[bw
仰觀俯察	yh[rp gr[yj fu[rg ia[gx
楊龜山	yh[av gv[do uj[uk
楊何	yh[av he[rk
楊簡	yh[av jm[vm
楊柳橋	yh[av lq[ap qn[ap
養氣	yh[yp qi[rh
揚棄	yh[fv qi[wc
楊泉	yh[av qr[bu
楊榮國	yh[av rs[ca go[ww
楊慎	yh[av uf[xu
楊升庵	yh[av ug[pc an[gd
楊時	yh[av ui[oc
楊萬里	yh[av wj[hv li[ot
楊王孫	yh[av wh[su sy[zx
楊文會	yh[av wf[wi hv[re
楊獻珍	yh[av xm[uq vf[wr
養心	yh[yp xb[dv
揚雄	yh[fv xs[uv
楊雄	yh[av xs[uv
楊朱	yh[av vu[ph
楊子	yh[av zi[lh
陽子居	yh[eo zi[lh ju[ug
陽尊陰卑	yh[eo zy[bc yb[eo bw[bu
要擺脫	yc[xn bd[fs to[ob
爻辭	yc[ii ci[ql
姚際恆	yc[nv ji[ee hg[xh
業報	ye[ub bc[fe
葉德輝	ye[ku de[ru hv[xg
野馬	ye[oy ma[vv
夜氣	ye[wr qi[rh
葉青	ye[ku qk[fo
葉適	ye[ku ui[qz
葉水心	ye[ku uv[uu xb[dv
葉燮	ye[ku xp[hy
葉子奇	ye[ku zi[lh qi[dk
伊奧尼亞	yi[rx ao[pd ni[ub ya[hy
易白沙	yi[ob bd[po ua[dx
一本	yi[hh bf[ah
一本萬殊	yi[hh bf[ah wj[hv uu[hp
伊壁鳩魯	yi[rx bi[ut jq[jn lu[yo
伊壁鳩魯派	yi[rx bi[ut jq[jn lu[yo pd[dp
伊壁鳩魯篇	yi[rx bi[ut jq[jn lu[yo pm[vh
伊壁鳩魯學派	yi[rx bi[ut jq[jn lu[yo xt[xz pd[dp
伊壁鳩魯主義	yi[rx bi[ut jq[jn lu[yo vu[dw yi[di
義兵	yi[di bk[qb
以不知為宗	yi[sr bu[eu vi[uk ww[dl zs[ge
一闡提	yi[hh ij[mb ti[fo
一闡提迦	yi[hh ij[mb ti[fo jx[lz
以禪喻詩	yi[sr ij[ub yu[kr ui[yt
以辭抒意	yi[sr ci[ql uu[fy yi[lx
義存	yi[di cy[uz
意大利南部	yi[lx da[hr li[hd nj[uk bu[le
一旦擁有	yi[hh dj[oh ys[fo yz[uo
以道制欲	yi[sr dc[bz vi[nd yu[bd
以德報怨	yi[sr de[ru bc[fe yr[xx
以德配天	yi[sr de[ru pw[yk tm[hd
一多	yi[hh do[xx
一多相即	yi[hh do[xx xl[am ji[ge
一多相容	yi[hh do[xx xl[am rs[xr
一而二	yi[hh er[ek er[hh
已發	yi[kv fa[vy
以法為教	yi[sr fa[dt ww[dl jn[tw
一分為二	yi[hh ff[bd ww[dl er[hh
易服色	yi[ob fu[oe se[db
異故	yi[kc gu[gw
一故神	yi[hh gu[gw uf[uo
一貫	yi[hh gr[mb
一行	yi[hh hh[rh
醫和	yi[ku he[hk
一畫	yi[hh hx[ht
一即三	yi[hh ji[ge sj[hh
一即一切	yi[hh ji[ge yi[hh qp[qd
意見	yi[lx jm[ke
易簡工夫	yi[ob jm[vm gs[hu fu[er
以見知隱	yi[sr jm[ke vi[uk yb[ed
意匠	yi[lx jl[kj
以今推古	yi[sr jb[rd tv[fv gu[uk
義淨	yi[di jk[dd
意境	yi[lx jk[tl
以靜制動	yi[sr jk[fd vi[nd ds[el
異類不比	yi[kc lw[md bu[eu bi[bb
以類度類	yi[sr lw[md du[gn lw[md
以類取	yi[sr lw[md qu[ey
以類行雜	yi[sr lw[md xk[rh za[ja
以類予	yi[sr lw[md yu[sv
義利	yi[di li[hd
義理	yi[di li[wo
以理殺人	yi[sr li[wo ua[ia rf[pd
義利雙行	yi[di li[hd ul[yy xk[rh
以吏為師	yi[sr li[hk ww[dl ui[uh
義利之辨	yi[di li[hd vi[dv bm[ld
義理之性	yi[di li[wo vi[dv xk[xp
義理之學	yi[di li[wo vi[dv xt[xz
一兩	yi[hh ll[hk
以名舉實	yi[sr mk[xk ju[xf ui[gd
一念發動即是行	yi[hh nm[rx fa[vy ds[el ji[ge ui[op xk[rh
一念三千	yi[hh nm[rx sj[hh qm[pu
以其取也	yi[sr qi[cb qu[ey ye[vu
以奇相御	yi[sr qi[dk xl[am yu[rw
一切即一	yi[hh qp[qd ji[ge yi[hh
一切知識	yi[hh qp[qd vi[uk ui[yk
以情緯文	yi[sr qk[xf ww[sw wf[wi
一曲	yi[hh qu[ou
依人建極	yi[ry rf[pd jm[yj ji[aj
以仁為本	yi[sr rf[re ww[dl bf[ah
義榮	yi[di rs[ca
義辱	yi[di ru[ic
以儒學為本	yi[sr ru[ry xt[xz ww[dl bf[ah
意識	yi[lx ui[yk
一是而一非	yi[hh ui[op er[ek yi[hh fw[su
以適聽適	yi[sr ui[qz tk[kj ui[qz
意識形態	yi[lx ui[yk xk[kp td[dx
衣食足以知榮辱	yi[wy ui[rl zu[kv yi[sr vi[uk rs[ca ru[ic
異熟	yi[kc uu[wd
以說出故	yi[sr uo[yb iu[ck gu[gw
依他起性	yi[ry ta[ry qi[zk xk[xp
以太	yi[sr td[dd
以天合天	yi[sr tm[hd he[rh tm[hd
異同攻取	yi[kc ts[kh gs[gw qu[ey
以往知來	yi[sr wh[rd vi[uk ld[hm
以物觀物	yi[sr wu[nb gr[yj wu[nb
一物兩體	yi[hh wu[nb ll[hk ti[ra
以無為本	yi[sr wu[ee ww[dl bf[ah
夷夏之辨	yi[hg xx[ew vi[dv bm[ld
意象	yi[lx xl[dk
以小推大	yi[sr xn[ub tv[fv da[hr
以心傳心	yi[sr xb[dv ir[re xb[dv
一心三觀	yi[hh xb[dv sj[hh gr[yj
一心三智	yi[hh xb[dv sj[hh vi[uo
以心挽劫	yi[sr xb[dv wj[fd jp[tl
易心瑩	yi[ob xb[dv yk[cw
以心原物	yi[sr xb[dv yr[ib wu[nb
以行而求知	yi[sr xk[rh er[ek qq[hu vi[uk
以刑去刑	yi[sr xk[kd qu[ts xk[kd
以性統情	yi[sr xk[xp ts[sw qk[xf
以形務名	yi[sr xk[kp wu[wl mk[xk
以形寫神	yi[sr xk[kp xp[gh uf[uo
以形寫形	yi[sr xk[kp xp[gh xk[kp
義玄	yi[di xr[wy
意驗相符	yi[lx yj[mr xl[am fu[vr
一以貫之	yi[hh yi[sr gr[mb vi[dv
以義為利	yi[sr yi[di ww[dl li[hd
一陰一陽之謂道	yi[hh yb[eo yi[hh yh[eo vi[dv ww[yt dc[bz
意欲	yi[lx yu[bd
以元為本	yi[sr yr[ee ww[dl bf[ah
意在筆前	yi[lx zd[ut bi[vm qm[bo
異則異之	yi[kc ze[bd yi[kc vi[dv
一真法界	yi[hh vf[uj fa[dt jp[tr
一真絕待	yi[hh vf[uj jt[sd dd[rt
以真為師	yi[sr vf[uj ww[dl ui[uh
一致百慮	yi[hh vi[hw bd[eo lv[hx
意之所在便是物	yi[lx vi[dv so[pj zd[ut bm[rh ui[op wu[nb
以知為力	yi[sr vi[uk ww[dl li[vp
以智相識	yi[sr vi[uo xl[am ui[yk
一中多	yi[hh vs[ku do[xx
一種萬實	yi[hh vs[hv wj[hv ui[gd
一週而一不周	yi[hh vz[kt er[ek yi[hh bu[eu vz[kt
依自不依他	yi[ry zi[pm bu[eu yi[ry ta[ry
引蔽習染	yb[gu bi[cb xi[vd rj[da
因革	yb[wd ge[nk
隱栝之道	yb[ed gx[aq vi[dv dc[bz
因果	yb[wd go[oa
因果報應	yb[wd go[oa bc[fe yk[gx
因過而知	yb[wd go[cz er[ek vi[uk
因果非物	yb[wd go[oa fw[su wu[nb
殷海光	yb[pj hd[dr gl[xe
殷浩	yb[pj hc[dn
因門六義	yb[wd mf[du lq[wb yi[di
因明	yb[wd mk[oo
陰柔之美	yb[eo rz[ya vi[dv mw[bw
因三相	yb[wd sj[hh xl[am
因勢慎小	yb[wd ui[fl uf[xu xn[ub
因十四過	yb[wd ui[hu si[we go[cz
尹焞	yb[xp tv[[
尹文	yb[xp wf[wi
尹文子	yb[xp wf[wi zi[lh
因悟而知	yb[wd wu[xw er[ek vi[uk
因習而知	yb[wd xi[vd er[ek vi[uk
隱秀	yb[ed xq[hn
因循革化	yb[wd xy[rp ge[nk hx[rq
陰陽	yb[eo yh[eo
陰陽五行說	yb[eo yh[eo wu[hu xk[rh uo[yb
陰陽相薄	yb[eo yh[eo xl[am bo[cd
陰陽之大義	yb[eo yh[eo vi[dv da[hr yi[di
因疑而知	yb[wd yi[bs er[ek vi[uk
因緣	yb[wd yr[sv
氤氳	yb[qw yy[qo
絪縕	yb[[ yy[so
因知以進行	yb[wd vi[uk yi[sr jb[ez xk[rh
陰騭之說	yb[eo vi[em vi[dv uo[yb
贏絀變化	yk[wo iu[si bm[yy hx[rq
應化之道	yk[gx hx[rq vi[dv dc[bz
盈堅白	yk[nm jm[ut bd[po
攖寧	yk[fb nk[gd
營魄	yk[ck po[bg
贏縮轉化	yk[wo so[sg vr[ie hx[rq
盈天地者無非物	yk[nm tm[hd di[ty ve[to wu[ee fw[su wu[nb
盈天地之間唯萬物	yk[nm tm[hd di[ty vi[dv jm[mo ww[kv wj[hv wu[nb
英雄與時勢互為因果	yk[ck xs[uv yu[hv ui[oc ui[fl hu[hv ww[dl yb[wd go[oa
盈虛	yk[nm xu[hy
郢有天下	yk[ke yz[uo tm[hd xx[hb
用常動	ys[ou ih[xk ds[el
永恆不變	ys[dv hg[xh bu[eu bm[yy
永恆存在	ys[dv hg[xh cy[uz zd[ut
永恆真理	ys[dv hg[xh vf[uj li[wo
用名以亂名	ys[ou mk[xk yi[sr lr[qv mk[xk
用名以亂實	ys[ou mk[xk yi[sr lr[qv ui[gd
用實以亂名	ys[ou ui[gd yi[sr lr[qv mk[xk
有待	yz[uo dd[rt
有對	yz[uo dv[yc
有對爭而後能進	yz[uo dv[yc vg[dx er[ek hz[pk ng[sb jb[ez
猶火之燃燭	yz[qy ho[dp vi[dv rj[hx vu[hi
有跡	yz[uo ji[yz
有教無類	yz[uo jn[tw wu[ee lw[md
有漏	yz[uo lz[du
又名	yz[vd mk[xk
有名	yz[uo mk[xk
有情	yz[uo qk[xf
有窮	yz[uo qs[xl
有若	yz[uo ro[cu
有生於無	yz[uo ug[pf yu[eu wu[ee
有統一而後能成	yz[uo ts[sw yi[hh er[ek hz[pk ng[sb ig[wv
遊外弘內	yz[df wd[xb hs[gs nw[kr
有為	yz[uo ww[dl
有為法	yz[uo ww[dl fa[dt
有我之境	yz[uo wo[pf vi[dv jk[tl
有無	yz[uo wu[ee
有無混一之常	yz[uo wu[ee hy[do yi[hh vi[dv ih[xk
有無相生	yz[uo wu[ee xl[am ug[pf
有物有則	yz[uo wu[nb yz[uo ze[bd
有物之域	yz[uo wu[nb vi[dv yu[tg
有限性	yz[uo xm[eg xk[xp
有相	yz[uo xl[am
遊心	yz[df xb[dv
有因而無生焉	yz[uo yb[wd er[ek wu[ee ug[pf yj[hh
遊於藝	yz[df yu[eu yi[cv
有子	yz[uo zi[lh
遊酢	yz[df zo[yv
玉柄麈尾	yu[wd bk[ah vu[gd ww[um
虞翻	yu[hk fj[px
于光遠	yu[eu gl[xe yr[ez
于吉	yu[eu ji[uk
餘家菊	yu[re jx[gu ju[cb
餘靖	yu[re jk[lf
與民同樂	yu[hv mb[kv ts[kh le[px
俞曲園	yu[rh qu[ou yr[we
喻十過	yu[kr ui[hu go[cz
喻體	yu[kr ti[ra
與天為徙	yu[hv tm[hd ww[dl xi[rv
與天為一	yu[hv tm[hd ww[dl yi[hh
宇徙久	yu[ge xi[rv jq[xd
喻依	yu[kr yi[ry
余英時	yu[re yk[ck ui[oc
虞愚	yu[hk yu[ox
俞樾	yu[rh yt[az
豫則立	yu[yd ze[bd li[lh
宇宙	yu[ge vz[gy
宇宙便是吾心	yu[ge vz[gy bm[rh ui[op wu[wk xb[dv
宇宙觀	yu[ge vz[gy gr[yj
宇宙之磚	yu[ge vz[gy vi[dv vr[ee
袁粲	yr[tk cj[bm
圓成實性	yr[wk ig[wv ui[gd xk[xp
緣道理	yr[sv dc[bz li[wo
緣督為經	yr[sv du[um ww[dl jk[ss
轅固生	yr[it gu[wg ug[pf
圓寂	yr[wk ji[gu
元結	yr[ee jp[su
元精	yr[ee jk[mf
袁枚	yr[tk mw[aw
元氣	yr[ee qi[rh
緣起	yr[sv qi[zk
元氣本體論	yr[ee qi[rh bf[ah ti[ra ly[yr
元氣之外無太極	yr[ee qi[rh vi[dv wd[xb wu[ee td[dd ji[aj
元氣自動論	yr[ee qi[rh zi[pm ds[el ly[yr
元氣自然論	yr[ee qi[rh zi[pm rj[xd ly[yr
緣情論	yr[sv qk[xf ly[yr
圓融三諦	yr[wk rs[hi sj[hh di[yl
緣生	yr[sv ug[pf
原始反終	yr[ib ui[ns fj[py vs[sw
元始天尊	yr[ee ui[ns tm[hd zy[bc
原始要終	yr[ib ui[ns yc[xn vs[sw
緣天官	yr[sv tm[hd gr[gu
元享利貞	yr[ee xl[wz li[hd vf[bb
袁燮	yr[tk xp[hy
原型觀念	yr[ib xk[kt gr[yj nm[rx
元照	yr[ee vc[od
元知	yr[ee vi[uk
原質	yr[ib vi[pu
原子論者	yr[ib zi[lh ly[yr ve[to
月旦評	yt[ke dj[oh pk[yp
約定俗成	yt[sb dk[gp su[rb ig[wv
約公元前	yt[sb gs[bs yr[ee qm[bo
越名教而任自然	yt[zh mk[xk jn[tw er[ek rf[rq zi[pm rj[xd
月映萬川	yt[ke yk[ok wj[hv ir[pu
惲代英	yy[xg dd[rq yk[ck
雲門三句	yy[es mf[du sj[hh ju[bk
韻味說	yy[lb ww[kh uo[yb
允執其中	yy[se vi[fj qi[cb vs[ku
宰理	zd[gl li[wo
宰我	zd[gl wo[pf
災異	zd[gh yi[kc
宰予	zd[gl yu[sv
在運動中	zd[ut yy[ez ds[el vs[ku
暫時變動	zj[io ui[oc bm[yy ds[el
藏傳因明	zh[cw ir[re yb[wd mk[oo
臧三耳	zh[wk sj[hh er[hu
臧文仲	zh[wk wf[wi vs[rv
鑿不圍枘	zc[yb bu[eu ww[ww rv[ak
造命	zc[nz mk[rh
早期希臘哲學	zc[ou qi[qo xi[iu la[og ve[fk xt[xz
造物者	zc[nz wu[nb ve[to
增多人性	zg[tb do[xx rf[pd xk[xp
曾國藩	zg[bo go[ww fj[cd
曾參	zg[bo uf[sd
增益執	zg[tb yi[bm vi[fj
曾子	zg[bo zi[lh
湛甘泉	vj[dq gj[nh qr[bu
詹何	vj[dy he[rk
戰略學	vj[bg lt[tw xt[xz
湛然	vj[dq rj[xd
湛若水	vj[dq ro[cu uv[uu
章炳麟	vh[lo bk[hh lb[gm
張伯端	vh[gi bo[rb dr[lu
張伯行	vh[gi bo[rb xk[rh
張岱年	vh[gi dd[ru nm[rn
張道陵	vh[gi dc[bz lk[et
張東蓀	vh[gi ds[qx sy[cz
張韓	vh[gi hj[uw
張衡	vh[gi hg[rd
張橫渠	vh[gi hg[ag qu[da
張華	vh[gi hx[ru
張惠言	vh[gi hv[hx yj[we
張譏	vh[gi ji[yj
張角	vh[gi jn[do
張九成	vh[gi jq[pv ig[wv
張居正	vh[gi ju[ug vg[hv
張君房	vh[gi jy[xk fh[hf
張君勱	vh[gi jy[xk md[wl
張陵	vh[gi lk[et
張魯	vh[gi lu[yo
張履祥	vh[gi lv[ur xl[uy
張南軒	vh[gi nj[uk xr[ig
張融	vh[gi rs[hi
張如心	vh[gi ru[nk xb[dv
張三丰	vh[gi sj[hh fg[su
張申府	vh[gi uf[ou fu[gr
張盛	vh[gi ug[wm
張栻	vh[gi ui[[
張世英	vh[gi ui[nv yk[ck
章實齋	vh[lo ui[gd vd[we
章士釗	vh[lo ui[uh vc[jd
張崧年	vh[gi ss[ua nm[rn
章太炎	vh[lo td[dd yj[hh
彰往察來	vh[lp wh[rd ia[gx ld[hm
張遐	vh[gi xx[kz
張修	vh[gi xq[ru
章學誠	vh[lo xt[xz ig[yw
張楊園	vh[gi yh[av yr[we
張儀	vh[gi yi[rd
張元忭	vh[gi yr[ee bm[xd
張載	vh[gi zd[ti
張湛	vh[gi vj[dq
張之洞	vh[gi vi[dv ds[dk
張仲景	vh[gi vs[rv jk[ow
照單全收	vc[od dj[bo qr[rw uz[vw
趙復	vc[zi fu[ro
趙歸真	vc[zi gv[ux vf[uj
趙紀彬	vc[zi ji[sk bb[aa
趙歧	vc[zi qi[vu
趙蕤	vc[zi rv[cu
朝三暮四	vc[uo sj[hh mu[co si[we
遮詮與表詮	ve[gz qr[yr yu[hv bn[fy qr[yr
這些思想	ve[wz xp[ve si[tx xl[ax
哲學	ve[fk xt[xz
哲學基礎	ve[fk xt[xz ji[qt iu[ei
哲學論戰	ve[fk xt[xz ly[yr vj[bg
哲學史	ve[fk xt[xz ui[ki
哲學思維	ve[fk xt[xz si[tx ww[sv
哲學體系	ve[fk xt[xz ti[ra xi[py
哲學學派	ve[fk xt[xz xt[xz pd[dp
哲學學說	ve[fk xt[xz xt[xz uo[yb
哲學研究	ve[fk xt[xz yj[ek jq[xj
哲學之父	ve[fk xt[xz vi[dv fu[bi
哲學追求	ve[fk xt[xz vv[pz qq[hu
這一主義	ve[wz yi[hh vu[dw yi[di
折衷主義	ve[fj vs[wv vu[dw yi[di
真德秀	vf[uj de[ru xq[hn
真諦	vf[uj di[yl
貞而不諒	vf[bb er[ek bu[eu ll[yw
真跡	vf[uj ji[yz
真幾	vf[uj ji[pv
真己	vf[uj ji[kv
真可	vf[uj ke[dk
真理	vf[uj li[wo
真理性	vf[uj li[wo xk[xp
甄鸞	vf[xw lr[yn
真趣	vf[uj qu[ze
真人	vf[uj rf[pd
真如	vf[uj ru[nk
真善美	vf[uj uj[yk mw[bw
珍生	vf[wr ug[pf
真實本質	vf[uj ui[gd bf[ah vi[pu
真實的存在	vf[uj ui[gd de[bb cy[uz zd[ut
真實知識	vf[uj ui[gd vi[uk ui[yk
真唯識量	vf[uj ww[kv ui[yk ll[oh
真性	vf[uj xk[xp
真一	vf[uj yi[hh
真一統萬一	vf[uj yi[hh ts[sw wj[hv yi[hh
真一之道	vf[uj yi[hh vi[dv dc[bz
真宰	vf[uj zd[gl
真正的社會主義	vf[uj vg[hv de[bb ue[ut hv[re vu[dw yi[di
真知	vf[uj vi[uk
正德	vg[hv de[ru
正法眼藏	vg[hv fa[dt yj[mg ch[cw
正反	vg[hv fj[py
正反合	vg[hv fj[py he[rh
鄭觀應	vg[be gr[yj yk[gx
證會	vg[yh hv[re
整理材料	vg[hh li[wo cd[ac ln[md
證量	vg[yh ll[oh
正名	vg[hv mk[xk
正命	vg[hv mk[rh
正奇	vg[hv qi[dk
正奇有位	vg[hv qi[dk yz[uo ww[rl
爭起於不足	vg[dx qi[zk yu[eu bu[eu zu[kv
鄭樵	vg[be qn[av
正確認識	vg[hv qt[ed rf[yr ui[yk
整體需要	vg[hh ti[ra xu[ye yc[xn
鄭鮮之	vg[be xm[yy vi[dv
鄭昕	vg[be xb[oj
正心	vg[hv xb[dv
鄭興	vg[be xk[xb
鄭玄	vg[be xr[wy
正言若反	vg[hv yj[we ro[cu fj[py
正誼不謀利	vg[hv yi[yg bu[eu mz[yg li[hd
鄭隱	vg[be yb[ed
徵知	vg[rh vi[uk
政治傳統	vg[hw vi[ds ir[re ts[sw
政治鬥爭	vg[hw vi[ds dz[du vg[dx
政治活動	vg[hw vi[ds ho[dq ds[el
政治家篇	vg[hw vi[ds jx[gu pm[vh
政治上層建築	vg[hw vi[ds uh[bh cg[ue jm[yj vu[vg
政治學家	vg[hw vi[ds xt[xz jx[gu
政治哲學	vg[hw vi[ds ve[fk xt[xz
鄭眾	vg[be vs[rr
證自證分	vg[yh zi[pm vg[yh ff[bd
知彼知己	vi[uk bi[rp vi[uk ji[kv
知材	vi[uk cd[ac
質測	vi[pu ce[db
知常	vi[uk ih[xk
支讖	vi[uy if[yr
至誠能化	vi[ht ig[yw ng[sb hx[rq
至誠如神	vi[ht ig[yw ru[nk uf[uo
執道	vi[fj dc[bz
支道林	vi[uy dc[bz lb[aa
執道守度	vi[fj dc[bz uz[gc du[gn
指導原理	vi[fb dc[kc yr[ib li[wo
值得擁有	vi[ru de[ro ys[fo yz[uo
至德之世	vi[ht de[ru vi[dv ui[nv
支遁	vi[uy dy[pz
志功	vi[ux gs[gl
止觀	vi[uh gr[yj
智慧	vi[uo hv[fx
知接	vi[uk jp[fl
直覺	vi[uj jt[xj
知覺	vi[uk jt[xj
知覺運動	vi[uk jt[xj yy[ez ds[el
至樂	vi[ht le[px
至理	vi[ht li[wo
質力	vi[pu li[vp
知力	vi[uk li[vp
知禮	vi[uk li[uv
支離事業	vi[uy li[wk ui[hk ye[ub
質力相推	vi[pu li[vp xl[am tv[fv
執兩用中	vi[fj ll[hk ys[ou vs[ku
致良知	vi[hw ll[dg vi[uk
質料	vi[pu ln[md
支婁迦讖	vi[uy lz[mn jx[lz if[yr
制民之產	vi[nd mb[kv vi[dv ij[lp
制名指實	vi[nd mk[xk vi[fb ui[gd
制名之樞要	vi[nd mk[xk vi[dv uu[ak yc[xn
知難行易	vi[uk nj[yv xk[rh yi[ob
知能	vi[uk ng[sb
止念	vi[uh nm[rx
芝諾	vi[cv no[yc
知氣	vi[uk qi[rh
支謙	vi[uy qm[yb
至人	vi[ht rf[pd
智仁勇	vi[uo rf[re ys[sl
質日代而行如一	vi[pu ri[wh dd[rq er[ek xk[rh ru[nk yi[hh
知實	vi[uk ui[gd
智士篇	vi[uo ui[uh pm[vh
知識社會學	vi[uk ui[yk ue[ut hv[re xt[xz
知是行之始	vi[uk ui[op xk[rh vi[dv ui[ns
制天命而用之	vi[nd tm[hd mk[rh er[ek ys[ou vi[dv
質文代變	vi[pu wf[wi dd[rq bm[yy
至無	vi[ht wu[ee
指物	vi[fb wu[nb
知物由學	vi[uk wu[nb yz[ou xt[xz
知先規而後為之	vi[uk xm[ne gv[ej er[ek hz[pk ww[dl vi[dv
知先行後	vi[uk xm[ne xk[rh hz[pk
治心	vi[ds xb[dv
志行	vi[ux xk[rh
知行	vi[uk xk[rh
知行分工	vi[uk xk[rh ff[bd gs[hu
知行分任	vi[uk xk[rh ff[bd rf[rq
知行合一	vi[uk xk[rh he[rh yi[hh
知行兼舉	vi[uk xk[rh jm[bh ju[xf
知行相須互發	vi[uk xk[rh xl[am xu[py hu[hv fa[vy
知行相資以為用	vi[uk xk[rh xl[am zi[db yi[sr ww[dl ys[ou
智旭	vi[uo xu[jo
直尋	vi[uj xy[xc
智儼	vi[uo yj[rh
知言	vi[uk yj[we
執要	vi[fj yc[xn
執一不二	vi[fj yi[hh bu[eu er[hh
志壹動氣	vi[ux yi[ud ds[el qi[rh
執一統眾	vi[fj yi[hh ts[sw vs[rr
知易行難	vi[uk yi[ob xk[rh nj[yv
知音	vi[uk yb[lo
質用	vi[pu ys[ou
知有所合謂之智	vi[uk yz[uo so[pj he[rh ww[yt vi[dv vi[uo
止於至善	vi[uh yu[eu vi[ht uj[yk
指月	vi[fb yt[ke
智者篇	vi[uo ve[to pm[vh
致知	vi[hw vi[uk
知之不若行之	vi[uk vi[dv bu[eu ro[cu xk[rh vi[dv
執中	vi[fj vs[ku
知足不辱	vi[uk zu[kv bu[eu ru[ic
知足常足	vi[uk zu[kv ih[xk zu[kv
仲長敖	vs[rv ih[ph ao[fw
仲長統	vs[rv ih[ph ts[sw
忠誠可靠	vs[vx ig[yw ke[dk kc[nf
中道	vs[ku dc[bz
中道觀	vs[ku dc[bz gr[yj
重點論	vs[ph dm[bd ly[yr
种放	vs[hv fh[fw
眾甫	vs[rr fu[uo
仲弓	vs[rv gs[kv
中國哲學名詞	vs[ku go[ww ve[fk xt[xz mk[xk ci[yv
中行	vs[ku hh[rh
中和	vs[ku he[hk
中和之美	vs[ku he[hk vi[dv mw[bw
鍾會	vs[jv hv[re
種類相產	vs[hv lw[md xl[am ij[lp
仲良	vs[rv ll[dg
仲尼	vs[rv ni[ub
鍾嶸	vs[jv rs[uc
眾生	vs[rr ug[pf
中世紀	vs[ku ui[nv ji[sk
忠恕之道	vs[vx uu[nx vi[dv dc[bz
中體西用	vs[ku ti[ra xi[hk ys[ou
重同	vs[ph ts[kh
中五說	vs[ku wu[hu uo[yb
踵息	vs[zp xi[zx
忠孝仁愛信義和平	vs[vx xn[tz rf[re ai[au xb[ry yi[di he[hk pk[hb
中學其本	vs[ku xt[xz qi[cb bf[ah
眾議參同	vs[rr yi[yd cj[sd ts[kh
中庸	vs[ku ys[gx
仲由	vs[rv yz[ou
種子	vs[hv zi[lh
周惇頤	vz[kt dy[xw yi[ky
周敦頤	vz[kt dy[ww yi[ky
周公	vz[kt gs[bs
周濂溪	vz[kt lm[dg xi[da
周汝登	vz[kt ru[dn dg[dd
周樹人	vz[kt uu[ay rf[pd
周顒	vz[kt ys[[
周予同	vz[kt yu[sv ts[kh
著變	vu[ct bm[yy
朱伯崑	vu[ph bo[rb ky[[
朱次琦	vu[ph ci[dd qi[wd
竺道生	vu[ve dc[bz ug[pf
鑄鼎象物	vu[jf dk[mv xl[dk wu[nb
竺法護	vu[ve fa[dt hu[fh
朱光潛	vu[ph gl[xe qm[de
袾宏	vu[[ hs[gu
朱晦庵	vu[ph hv[or an[gd
燭火之喻	vu[hi ho[dp vi[dv yu[kr
主靜	vu[dw jk[fd
主敬	vu[dw jk[cw
朱陸異同	vu[ph lu[ef yi[kc ts[kh
著名學派	vu[ct mk[xk xt[xz pd[dp
朱謙之	vu[ph qm[yb vi[dv
朱世卿	vu[ph ui[nv qk[pg
朱士行	vu[ph ui[uh xk[rh
朱舜水	vu[ph uy[ax uv[uu
麈談	vu[gd tj[yh
朱熹	vu[ph xi[ud
主要教條	vu[dw yc[xn jn[tw tn[wa
主要矛盾	vu[dw yc[xn mc[yp dy[pu
主要矛盾方面	vu[dw yc[xn mc[yp dy[pu fh[dw mm[ew
主一	vu[dw yi[hh
主意	vu[dw yi[lx
朱一新	vu[ph yi[hh xb[lj
住在	vu[rd zd[ut
朱澤雲	vu[ph ze[dy yy[es
朱震	vu[ph vf[yi
朱執信	vu[ph vi[fj xb[ry
朱之瑜	vu[ph vi[dv yu[wr
諸子合觀	vu[yt zi[lh he[rh gr[yj
轉識成智	vr[ie ui[yk ig[wv vi[uo
顓孫師	vr[uy sy[zx ui[uh
轉依	vr[ie yi[ry
莊存與	vl[gt cy[uz yu[hv
莊周	vl[gt vz[kt
莊周夢蝶	vl[gt vz[kt mg[ax dp[in
莊子	vl[gt zi[lh
自比量	zi[pm bi[bb ll[oh
子產	zi[lh ij[lp
自得	zi[pm de[ro
自爾	zi[pm er[dx
自反	zi[pm fj[py
子貢	zi[lh gs[gb
子罕	zi[lh hj[gg
自化	zi[pm hx[rq
子華子	zi[lh hx[ru zi[lh
子路	zi[lh lu[zw
子莫	zi[lh mo[co
自然	zi[pm rj[xd
自然本身	zi[pm rj[xd bf[ah uf[pu
自然發生論	zi[pm rj[xd fa[vy ug[pf ly[yr
自然觀	zi[pm rj[xd gr[yj
自然過程	zi[pm rj[xd go[cz ig[hk
自然科學	zi[pm rj[xd ke[hd xt[xz
自然命定論	zi[pm rj[xd mk[rh dk[gp ly[yr
自然現象	zi[pm rj[xd xm[wj xl[dk
自然與必然非二事	zi[pm rj[xd yu[hv bi[xp rj[xd fw[su er[hh ui[hk
自然哲學	zi[pm rj[xd ve[fk xt[xz
自然哲學家	zi[pm rj[xd ve[fk xt[xz jx[gu
自然哲學時期	zi[pm rj[xd ve[fk xt[xz ui[oc qi[qo
自然之命	zi[pm rj[xd vi[dv mk[rh
自然之說	zi[pm rj[xd vi[dv uo[yb
自然主義的人生觀	zi[pm rj[xd vu[dw yi[di de[bb rf[pd ug[pf gr[yj
梓慎	zi[al uf[xu
自生	zi[pm ug[pf
自生而必體有	zi[pm ug[pf er[ek bi[xp ti[ra yz[uo
自適	zi[pm ui[qz
子思	zi[lh si[tx
自為	zi[pm ww[dl
滋味說	zi[db ww[kh uo[yb
自我滿足	zi[pm wo[pf mj[dc zu[kv
自我意識	zi[pm wo[pf yi[lx ui[yk
子夏	zi[lh xx[ew
自相	zi[pm xl[am
自相矛盾	zi[pm xl[am mc[yp dy[pu
自性	zi[pm xk[xp
自有	zi[pm yz[uo
子游	zi[lh yz[df
自由思想者	zi[pm yz[ou si[tx xl[ax ve[to
自由王國	zi[pm yz[ou wh[su go[ww
自由意志	zi[pm yz[ou yi[lx vi[ux
子羽	zi[lh yu[xx
子張	zi[lh vh[gi
自正	zi[pm vg[hv
自證分	zi[pm vg[yh ff[bd
恣之兩行	zi[dx vi[dv ll[hk hh[rh
自足	zi[pm zu[kv
自尊其心	zi[pm zy[bc qi[cb xb[dv
宗白華	zs[ge bd[po hx[ru
宗柄	zs[ge bk[ah
宗杲	zs[ge gc[oa
宗教教條	zs[ge jn[tw jn[tw tn[wa
宗教倫理	zs[ge jn[tw ly[rr li[wo
宗教哲學	zs[ge jn[tw ve[fk xt[xz
宗九過	zs[ge jq[pv go[cz
宗密	zs[ge mi[gu
宗眼	zs[ge yj[mg
縱慾	zs[sr yu[bd
鄒容	zz[de rs[xr
騶奭	zz[md ui[de
鄒守益	zz[de uz[gc yi[bm
鄒衍	zz[de yj[rd
騶衍	zz[md yj[rd
鏃矢之疾而有不行不止之時	zu[jf ui[rd vi[dv ji[bu er[ek yz[uo bu[eu xk[rh bu[eu vi[uh vi[dv ui[oc
祖述堯舜	zu[uq uu[az yc[qh uy[ax
祖統	zu[uq ts[sw
卒於	zu[wr yu[eu
尊道貴德	zy[bc dc[bz gv[vb de[ru
尊德性而道問學	zy[bc de[ru xk[xp er[ek dc[bz wf[mk xt[xz
尊靈魂輕體魄	zy[bc lk[xh hy[eg qk[is ti[ra po[bg
尊情	zy[bc qk[xf
尊天事鬼	zy[bc tm[hd ui[hk gv[be
尊王賤霸	zy[bc wh[su jm[bj ba[yg
尊心	zy[bc xb[dv
尊疑之學	zy[bc yi[bs vi[dv xt[xz
左慈	zo[ug ci[bx
左丘明	zo[ug qq[jh mk[oo
左舜生	zo[ug uy[ax ug[pf
坐忘	zo[rr wh[wx
作文害道	zo[rv wf[wi hd[gf dc[bz
左雄	zo[ug xs[uv
