哀江頭	ai[wk jl[dg tz[dd
唉乃一聲山水綠	ai[ks nd[vp yi[hh ug[um uj[uk uv[uu lv[sx
哀弱羽之飄零	ai[wk ro[gg yu[xx vi[dv pn[xf lk[yr
哀王孫	ai[wk wh[su sy[zx
哀哉王孫慎勿疏	ai[wk zd[tk wh[su sy[zx uf[xu wu[bp uu[pw
黯黯見臨洮	an[hl an[hl jm[ke lb[uv tc[dv
安禪製毒龍	an[gn ij[ub vi[nd du[fm ls[yp
安得至老不更歸	an[gn de[ro vi[ht lc[tb bu[eu gg[ho gv[ux
安能摧眉折腰事權貴	an[gn ng[sb cv[fu mw[mm ve[fj yc[ox ui[hk qr[ay gv[vb
安能以此上論列	an[gn ng[sb yi[sr ci[vb uh[bh ly[yr lp[hd
安知峰壑今來變	an[gn vi[uk fg[uw he[bt jb[rd ld[hm bm[yy
安置妥帖平不頗	an[gn vi[su to[an tp[jb pk[hb bu[eu po[py
罷官昨日今如何	ba[st gr[gu zo[ov ri[wh jb[rd ru[nk he[rk
罷歸無舊業	ba[st gv[ux wu[ee jq[uo ye[ub
把劍覓徐君	ba[fb jm[rd mi[aj xu[rr jy[xk
拔劍四顧心茫然	ba[fu jm[rd si[we gu[iy xb[dv mh[cd rj[xd
芭蕉葉大梔子肥	ba[cb jn[cv ye[ku da[hr vi[ap zi[lh fw[ob
把酒話桑麻	ba[fb jq[dy hx[yq sh[ya ma[ga
巴人訟芋田	ba[ku rf[pd ss[yb yu[ce tm[wu
罷如江海凝清光	ba[st ru[nk jl[dg hd[dr nk[db qk[df gl[xe
巴山道中除夜有懷	ba[ku uj[uk dc[bz vs[ku iu[er ye[wr yz[uo hk[xb
灞上秋居	ba[dy uh[bh qq[hh ju[ug
灞原風雨定	ba[dy yr[ib fg[ji yu[hk dk[gp
八月蝴蝶來	ba[pd yt[ke hu[ig dp[in ld[hm
八月湖水平	ba[pd yt[ke hu[dg uv[uu pk[hb
八月十五夜贈張功曹	ba[pd yt[ke ui[hu wu[hu ye[wr zg[bb vh[gi gs[gl cc[ho
八月蕭關道	ba[pd yt[ke xn[cx gr[bt dc[bz
八陣圖	ba[pd vf[ei tu[ww
白波九道流雪山	bd[po bo[dp jq[pv dc[bz lq[dw xt[yx uj[uk
百步九折縈巖巒	bd[eo bu[vu jq[pv ve[fj yk[cy yj[ue lr[yu
白帝城邊古木疏	bd[po di[lj ig[tw bm[lz gu[uk mu[ub uu[pw
白髮悲花落	bd[po fa[vy bw[fx hx[cr lo[cd
白髮催年老	bd[po fa[vy cv[ru nm[rn lc[tb
白骨亂蓬蒿	bd[po gu[ko lr[qv pg[cw hc[cw
白居易	bd[po ju[ug yi[ob
白狼河北音書斷	bd[po lh[ql he[dk bw[ub yb[lo uu[vv dr[mj
白馬嚼齧黃金勒	bd[po ma[vv jn[ka np[kv hl[gy jb[rw le[gl
白門寥落意多違	bd[po mf[du ln[gx lo[cd yi[lx do[xx ww[wz
百年都是幾多時	bd[eo nm[rn dz[te ui[op ji[pv do[xx ui[oc
百年多病獨登臺	bd[eo nm[rn do[xx bk[bh du[qi dg[dd td[sk
白日登山望烽火	bd[po ri[wh dg[dd uj[uk wh[ww fg[hw ho[dp
白日放歌須縱酒	bd[po ri[wh fh[fw ge[kd xu[py zs[sr jq[dy
白日落梁州	bd[po ri[wh lo[cd ll[da vz[dp
白日依山盡	bd[po ri[wh yi[ry uj[uk jb[ud
白首臥松雲	bd[po uz[be wo[kb ss[ab yy[es
白水繞東城	bd[po uv[uu rc[sq ds[qx ig[tw
白頭宮女在	bd[po tz[dd gs[gk nv[vp zd[ut
白頭搔更短	bd[po tz[dd sc[fy gg[ho dr[ud
白雪歌送武判官歸京	bd[po xt[yx ge[kd ss[bz wu[hv pj[bd gr[gu gv[ux jk[wk
白雲回望合	bd[po yy[es hv[wk wh[ww he[rh
白雲千載空悠悠	bd[po yy[es qm[pu zd[ti ks[xg yz[rx yz[rx
白雲無盡時	bd[po yy[es wu[ee jb[ud ui[oc
白雲依靜渚	bd[po yy[es yi[ry jk[fd vu[dt
半壁見海日	bj[bf bi[ut jm[ke hd[dr ri[wh
半夜軍行戈相撥	bj[bf ye[wr jy[gi xk[rh ge[qp xl[am bo[fv
斑騅只系垂楊岸	bj[ww vv[mv vi[kb xi[py iv[ph yh[av an[ui
傍鄰聞者多嘆息	bh[rl lb[re wf[me ve[to do[xx tj[ky xi[zx
報答平生未展眉	bc[fe da[vr pk[hb ug[pf ww[ha vj[ug mw[mm
報到山中去	bc[fe dc[hd uj[uk vs[ku qu[ts
報得三春輝	bc[fe de[ro sj[hh iy[so hv[xg
褒公鄂公毛髮動	bc[wr gs[bs ee[ke gs[bs mc[sv fa[vy ds[el
寶扇迎歸九華帳	bc[gw uj[hx yk[pz gv[ux jq[pv hx[ru vh[ji
北斗兼春遠	bw[ub dz[du jm[bh iy[so yr[ez
北斗闌干南鬥斜	bw[ub dz[du lj[mh gj[hu nj[uk dz[du xp[rd
北斗七星高	bw[ub dz[du qi[hv xk[op gc[wk
北風江上寒	bw[ub fg[ji jl[dg uh[bh hj[gd
北風捲地白草折	bw[ub fg[ji jr[be di[ty bd[po cc[co ve[fj
碑高三丈字如鬥	bw[eb gc[wk sj[hh vh[hi zi[gz ru[nk dz[du
背後何所見	bw[bo hz[pk he[rk so[pj jm[ke
北極朝庭終不改	bw[ub ji[aj ic[uo tk[gq vs[sw bu[eu gd[kw
北青蘿	bw[ub qk[fo lo[cs
被驅不異犬與雞	bw[yp qu[mk bu[eu yi[kc qr[dd yu[hv ji[yn
北闕休上書	bw[ub qt[mn xq[ra uh[bh uu[vv
北山白雲裡	bw[ub uj[uk bd[po yy[es li[ot
北土非吾願	bw[ub tu[uh fw[su wu[wk yr[ix
本長安倡女	bf[ah ih[ph an[gn ih[ro nv[vp
奔湊如朝東	bf[du cz[ds ru[nk ic[uo ds[qx
奔流到海不復回	bf[du lq[dw dc[hd hd[dr bu[eu fu[ro hv[wk
本以高難飽	bf[ah yi[sr gc[wk nj[yv bc[ub
崩年亦在永安宮	bg[uo nm[rn yi[wy zd[ut ys[dv an[gn gs[gk
迸泉颯颯飛木末	bg[bz qr[bu sa[lf sa[lf fw[vp mu[ub mo[ha
彼何人哉軒與羲	bi[rp he[rk rf[pd zd[tk xr[ig yu[hv xi[bh
碧文圓頂夜深縫	bi[we wf[wi yr[wk dk[dy ye[wr uf[dg fg[sw
遍插茱萸少一人	bm[hz ia[fq vu[cp yu[cj uc[xp yi[hh rf[pd
變調如聞楊柳春	bm[yy dn[yk ru[nk wf[me yh[av lq[ap iy[so
邊亭流血成海水	bm[lz tk[wd lq[dw xt[pm ig[wv hd[dr uv[uu
邊庭飄搖那可度	bm[lz tk[gq pn[xf yc[fa na[ve ke[dk du[gn
便下襄陽向洛陽	bm[rh xx[hb xl[wk yh[eo xl[pk lo[dw yh[eo
遍飲坐者	bm[hz yb[ud zo[rr ve[to
便至四十西營田	bm[rh vi[ht si[we ui[hu xi[hk yk[ck tm[wu
表曰臣愈昧死上	bn[fy yt[wh if[ku yu[rx mw[oh si[hx uh[bh
別房太尉墓	bp[kd fh[hf td[dd ww[uc mu[ct
別來滄海事	bp[kd ld[hm ch[dr hd[dr ui[hk
別離在今晨	bp[kd li[wk zd[ut jb[rd if[oi
別時茫茫江浸月	bp[kd ui[oc mh[cd mh[cd jl[dg jb[dx yt[ke
別意與之誰短長	bp[kd yi[lx yu[hv vi[dv uv[yv dr[ud ih[ph
別有幽愁暗恨生	bp[kd yz[uo yz[yy iz[hx an[ol hf[xg ug[pf
賓從雜沓實要津	bb[gq cs[rr za[ja ta[uo ui[gd yc[xn jb[dy
鬢髮各已蒼	bb[ig fa[vy ge[wk yi[kv ch[cr
鬢絲生幾縷	bb[ig si[sh ug[pf ji[pv lv[sm
兵車行	bk[qb ie[qu xk[rh
稟君子	bk[we jy[xk zi[lh
柄任儒術崇丘軻	bk[ah rf[rq ru[ry uu[ad is[ug qq[jh ke[ik
兵衛森畫戟	bk[qb ww[eh sf[aa hx[ht ji[ug
冰崖轉石萬壑雷	bk[du ya[ui vr[ie ui[ek wj[hv he[bt lw[yt
波撼岳陽城	bo[dp hj[fw yt[qu yh[eo ig[tw
薄宦梗猶泛	bo[cd hr[gk gg[ah yz[qy fj[dp
波瀾動遠空	bo[dp lj[dm ds[el yr[ez ks[xg
波瀾誓不起	bo[dp lj[dm ui[fy bu[eu qi[zk
薄暮空潭曲	bo[cd mu[co ks[xg tj[dx qu[ou
薄暮漁樵乘水入	bo[cd mu[co yu[dy qn[av ig[qb uv[uu ru[pd
泊秦淮	bo[db qb[sh hk[dv
波上馬嘶看棹去	bo[dp uh[bh ma[vv si[kq kj[fm vc[ab qu[ts
伯仲之間見伊呂	bo[rb vs[rv vi[dv jm[mo jm[ke yi[rx lv[kk
不哀傷而自怨	bu[eu ai[wk uh[rr er[ek zi[pm yr[xx
不把雙眉鬥畫長	bu[eu ba[fb ul[yy mw[mm dz[du hx[ht ih[ph
不辨仙源何處尋	bu[eu bm[ld xm[ru yr[di he[rk iu[wb xy[xc
不才明主棄	bu[eu cd[hu mk[oo vu[dw qi[wc
不重生男重生女	bu[eu is[ph ug[pf nj[tl is[ph ug[pf nv[vp
步出東齋讀	bu[vu iu[ck ds[qx vd[we du[yu
不得到遼西	bu[eu de[ro dc[hd ln[lz xi[hk
不得顧采薇	bu[eu de[ro gu[iy cd[aa ww[cr
不得收骨肉	bu[eu de[ro uz[vw gu[ko rz[kr
不犯此	bu[eu fj[qe ci[vb
不敢長語臨交衢	bu[eu gj[vw ih[ph yu[yw lb[uv jn[li qu[rm
不敢過臨洮	bu[eu gj[vw go[cz lb[uv tc[dv
不敢問來人	bu[eu gj[vw wf[mk ld[hm rf[pd
不敢倚先賢	bu[eu gj[vw yi[rd xm[ne xm[ub
不見長安見塵霧	bu[eu jm[ke ih[ph an[gn jm[ke if[xt wu[yw
不見玉顏空死處	bu[eu jm[ke yu[wd yj[ly ks[xg si[hx iu[wb
不盡長江滾滾來	bu[eu jb[ud ih[ph jl[dg gy[dl gy[dl ld[hm
不據山河據平地	bu[eu ju[fu uj[uk he[dk ju[fu pk[hb di[ty
不覺碧山暮	bu[eu jt[xj bi[we uj[uk mu[co
不覺已鳴鴉	bu[eu jt[xj yi[kv mk[kn ya[yn
不堪人事日蕭條	bu[eu kj[tq rf[pd ui[hk ri[wh xn[cx tn[wa
不堪盈手贈	bu[eu kj[tq yk[nm uz[su zg[bb
不肯低頭在草莽	bu[eu kf[vo di[ru tz[dd zd[ut cc[co mh[cq
不露文章世已驚	bu[eu lu[yz wf[wi vh[lo ui[nv yi[kv jk[xw
不能廢人運酒舫	bu[eu ng[sb fw[gv rf[pd yy[ez jq[dy fh[vf
不能聽終淚如雨	bu[eu ng[sb tk[kj vs[sw lw[dm ru[nk yu[hk
不寢聽金鑰	bu[eu qb[gd tk[kj jb[rw yc[jo
不是宸遊玩物華	bu[eu ui[op if[gi yz[df wj[we wu[nb hx[ru
不似潁川空使酒	bu[eu si[rs yk[by ir[pu ks[xg ui[rh jq[dy
不惜珊瑚持與人	bu[eu xi[xg uj[wk hu[wg ii[ft yu[hv rf[pd
不信妾腸斷	bu[eu xb[ry qp[ln ih[ov dr[mj
步行奪得胡馬騎	bu[vu xk[rh do[dc de[ro hu[go ma[vv qi[md
不以道昏而昧其視	bu[eu yi[sr dc[bz hy[uo er[ek mw[oh qi[cb ui[uj
不疑靈境難聞見	bu[eu yi[bs lk[xh jk[tl nj[yv wf[me jm[ke
不以俗厚而易其真	bu[eu yi[sr su[rb hz[io er[ek yi[ob qi[cb vf[uj
不知何處吹蘆管	bu[eu vi[uk he[rk iu[wb iv[kd lu[ch gr[vg
不知香積寺	bu[eu vi[uk xl[ho ji[hk si[tc
不知心恨誰	bu[eu vi[uk xb[dv hf[xg uv[yv
不自著羅衣	bu[eu zi[pm vu[ct lo[sx yi[wy
採柏動盈掬	cd[aa bd[ab ds[el yk[nm ju[fb
才薄將奈石鼓何	cd[hu bo[cd jl[dx nd[de ui[ek gu[uu he[rk
裁縫寄遠道	cd[ty fg[sw ji[gd yr[ez dc[bz
才可容顏十五餘	cd[hu ke[dk rs[xr yj[ly ui[hu wu[hu yu[ur
蔡女昔造胡笳聲	cd[cx nv[vp xi[go zc[nz hu[go jx[vl ug[um
採桑綠水邊	cd[aa sh[ya lv[sx uv[uu bm[lz
採山因買斧	cd[aa uj[uk yb[wd md[vd fu[bj
蠶叢及魚鳧	cj[ti cs[rh ji[pv yu[dt fu[nj
蠶飢妾欲去	cj[ti ji[uj qp[ln yu[bd qu[ts
蠶眠桑葉稀	cj[ti mm[mm sh[ya ye[ku xi[hi
殘宵猶得夢依稀	cj[hj xn[gx yz[qy de[ro mg[ax yi[ry xi[hi
殘陽西入崦	cj[hj yh[eo xi[hk ru[pd yj[ud
殘螢棲玉露	cj[hj yk[ci qi[ax yu[wd lu[yz
殘月下章臺	cj[hj yt[ke xx[hb vh[lo td[sk
殘雲歸太華	cj[hj yy[es gv[ux td[dd hx[ru
殘鍾廣陵樹	cj[hj vs[jv gl[di lk[et uu[ay
蒼蒼橫翠微	ch[cr ch[cr hg[ag cv[xw ww[ru
蒼蒼竹林寺	ch[cr ch[cr vu[rr lb[aa si[tc
滄海月明珠有淚	ch[dr hd[dr yt[ke mk[oo vu[wp yz[uo lw[dm
滄江好煙月	ch[dr jl[dg hc[nz yj[hw yt[ke
滄江急夜流	ch[dr jl[dg ji[dx ye[wr lq[dw
蒼茫古木連窮巷	ch[cr mh[cd gu[uk mu[ub lm[iz qs[xl xl[gk
蒼茫雲海間	ch[cr mh[cd yy[es hd[dr jm[mo
蒼然滿關中	ch[cr rj[xd mj[dc gr[bt vs[ku
蒼山夾亂流	ch[cr uj[uk jx[hb lr[qv lq[dw
嘈嘈切切錯雜彈	cc[kh cc[kh qp[qd qp[qd co[jg za[ja dj[gb
草木有本心	cc[co mu[ub yz[uo bf[ah xb[dv
草色新雨中	cc[co se[db xb[lj yu[hk vs[ku
側見雙翠鳥	ce[rb jm[ke ul[yy cv[xw nn[nh
側身西望常諮嗟	ce[rb uf[pu xi[hk wh[ww ih[xk zi[dk jp[ky
參差連曲陌	cf[sd ci[yg lm[iz qu[ou mo[ee
岑夫子	cf[ur fu[er zi[lh
岑參	cf[ur uf[sd
曾貌先帝照夜白	cg[bo mc[pb xm[ne di[lj vc[od ye[wr bd[po
曾驅十萬師	cg[bo qu[mk ui[hu wj[hv ui[uh
曾是寂寥金燼暗	cg[bo ui[op ji[gu ln[gx jb[rw jb[hu an[ol
差池不相見	ia[yg ii[dy bu[eu xl[am jm[ke
釵擘黃金合分鈿	id[jy bo[uf hl[gy jb[rw he[rh ff[bd dm[jt
豺狼在邑龍在野	id[pc lh[ql zd[ut yi[kb ls[yp zd[ut ye[oy
釵留一股合一扇	id[jy lq[pt yi[hh gu[oj he[rh yi[hh uj[hx
禪房花木深	ij[ub fh[hf hx[cr mu[ub uf[dg
蟬鳴空桑林	ij[ib mk[kn ks[xg sh[ya lb[aa
蟬休露滿枝	ij[ib xq[ra lu[yz mj[dc vi[au
單于獵火照狼山	ij[bo yu[eu lp[qg ho[dp vc[od lh[ql uj[uk
單于夜遁逃	ij[bo yu[eu ye[wr dy[pz tc[vz
單于已在金山西	ij[bo yu[eu yi[kv zd[ut jb[rw uj[uk xi[hk
讒之天子言其私	ij[yd vi[dv tm[hd zi[lh yj[we qi[cb si[hs
長安城連東掖垣	ih[ph an[gn ig[tw lm[iz ds[qx ye[fw yr[th
長安城頭頭白烏	ih[ph an[gn ig[tw tz[dd tz[dd bd[po wu[bv
長安水邊多麗人	ih[ph an[gn uv[uu bm[lz do[xx li[hk rf[pd
長安一片月	ih[ph an[gn yi[hh pm[pu yt[ke
長安遇馮著	ih[ph an[gn yu[oz fg[dm vu[ct
長飆風中自來往	ih[ph bn[qf fg[ji vs[ku zi[pm ld[hm wh[rd
常存抱柱信	ih[xk cy[uz bc[fb vu[ad xb[ry
長簟迎風早	ih[ph dm[vx yk[pz fg[ji zc[ou
腸斷未忍掃	ih[ov dr[mj ww[ha rf[dx sc[fx
長風吹林雨墮瓦	ih[ph fg[ji iv[kd lb[aa yu[hk do[et wa[hv
長風幾萬裡	ih[ph fg[ji ji[pv wj[hv li[ot
長風連日作大浪	ih[ph fg[ji lm[iz ri[wh zo[rv da[hr lh[dl
長風破浪會有時	ih[ph fg[ji po[ep lh[dl hv[re yz[uo ui[oc
長風萬里送秋雁	ih[ph fg[ji wj[hv li[ot ss[bz qq[hh yj[ir
長幹行	ih[ph gj[hu xk[rh
長幹行二首之二	ih[ph gj[hu xk[rh er[hh uz[be vi[dv er[hh
長幹行二首之一	ih[ph gj[hu xk[rh er[hh uz[be vi[dv yi[hh
長歌楚天碧	ih[ph ge[kd iu[ap tm[hd bi[we
長戈利矛日可麾	ih[ph ge[qp li[hd mc[yp ri[wh ke[dk hv[gm
長歌吟松風	ih[ph ge[kd yb[kr ss[ab fg[ji
長河浪頭連天黑	ih[ph he[dk lh[dl tz[dd lm[iz tm[hd hw[sd
長恨歌	ih[ph hf[xg ge[kd
常建	ih[xk jm[yj
長江獨至今	ih[ph jl[dg du[qi vi[ht jb[rd
長江一帆遠	ih[ph jl[dg yi[hh fj[jj yr[ez
長樂鐘聲花外盡	ih[ph le[px vs[jv ug[um hx[cr wd[xb jb[ud
悵然吟式微	ih[xi rj[xd yb[kr ui[qg ww[ru
長沙過賈誼宅	ih[ph ua[dx go[cz jx[xb yi[yg vd[gp
長沙謫去古今憐	ih[ph ua[dx ve[yl qu[ts gu[uk jb[rd lm[xr
長繩百尺拽碑倒	ih[ph ug[sk bd[eo ii[ud vk[fo bw[eb dc[rh
長使英雄淚滿襟	ih[ph ui[rh yk[ck xs[uv lw[dm mj[dc jb[ya
長亭酒一瓢	ih[ph tk[wd jq[dy yi[hh pn[xp
悵望千秋一灑淚	ih[xi wh[ww qm[pu qq[hh yi[hh sa[dx lw[dm
悵臥新春白袷衣	ih[xi wo[kb xb[lj iy[so bd[po qx[yr yi[wy
長相思	ih[ph xl[am si[tx
長相思二首之二	ih[ph xl[am si[tx er[hh uz[be vi[dv er[hh
長相思二首之一	ih[ph xl[am si[tx er[hh uz[be vi[dv yi[hh
嘗學琵琶於穆曹二善才	ih[xe xt[xz pi[wb pa[wb yu[fr mu[hb cc[ho er[hh uj[yk cd[hu
長願向南流	ih[ph yr[ix xl[pk nj[uk lq[dw
朝罷須裁五色詔	ic[uo ba[st xu[py cd[ty wu[hu se[db vc[yd
朝避猛虎	ic[uo bi[uz mg[qz hu[hj
朝別黃鶴樓	ic[uo bp[kd hl[gy he[gn lz[am
潮落夜江斜月裡	ic[du lo[cd ye[wr jl[dg xp[rd yt[ke li[ot
潮平兩岸闊	ic[du pk[hb ll[hk an[ui ko[md
朝聞遊子唱驪歌	ic[uo wf[me yz[df zi[lh ih[ko li[mh ge[kd
巢在三珠樹	ic[vo zd[ut sj[hh vu[wp uu[ay
車轔轔	ie[qu lb[im lb[im
車馬去閒閒	ie[qu ma[vv qu[ts xm[ma xm[ma
車師西門佇獻捷	ie[qu ui[uh xi[hk mf[du vu[rg xm[uq jp[fh
車走雷聲語未通	ie[qu zz[tv lw[yt ug[um yu[yw ww[ha ts[sz
塵埃不見咸陽橋	if[xt ai[ts bu[eu jm[ke xm[wh yh[eo qn[ap
陳侯立身何坦蕩	if[eq hz[rv li[lh uf[pu he[rk tj[to dh[cd
陳王昔時宴平樂	if[eq wh[su xi[go ui[oc yj[go pk[hb le[px
塵心未盡思鄉縣	if[xt xb[dv ww[ha jb[ud si[tx xl[sp xm[qs
晨搖玉佩趨金殿	if[oi yc[fa yu[wd pw[rj qu[zd jb[rw dm[uj
晨詣超師院讀禪經	if[oi yi[yb ic[zd ui[uh yr[eg du[yu ij[ub jk[ss
陳子昂	if[eq zi[lh ah[op
澄澄變今古	ig[dd ig[dd bm[yy jb[rd gu[uk
澄澄映葭葦	ig[dd ig[dd yk[ok jx[ck ww[cw
城春草木深	ig[tw iy[so cc[co mu[ub uf[dg
承恩不在貌	ig[lu en[wx bu[eu zd[ut mc[pb
承恩數上南薰殿	ig[lu en[wx uu[mw uh[bh nj[uk xy[pd dm[uj
承歡侍宴無閒暇	ig[lu hr[yd ui[rt yj[go wu[ee xm[ma xx[ok
稱名憶舊容	ig[hd mk[xk yi[xv jq[uo rs[xr
城闕輔三秦	ig[tw qt[mn fu[if sj[hh qb[sh
城闕夜千重	ig[tw qt[mn ye[wr qm[pu vs[ph
城上高樓接大荒	ig[tw uh[bh gc[wk lz[am jp[fl da[hr hl[cw
城下沒全師	ig[tw xx[hb mw[dj qr[rw ui[uh
丞相祠堂何處尋	ig[lh xl[am ci[uv th[xt he[rk iu[wb xy[xc
城小賊不屠	ig[tw xn[ub zw[bg bu[eu tu[ut
誠知此恨人人有	ig[yw vi[uk ci[vb hf[xg rf[pd rf[pd yz[uo
城中相識盡繁華	ig[tw vs[ku xl[am ui[yk jb[ud fj[ry hx[ru
城中增暮寒	ig[tw vs[ku zg[tb mu[co hj[gd
赤壁	ii[ty bi[ut
遲遲鐘鼓初長夜	ii[uz ii[uz vs[jv gu[uu iu[yd ih[ph ye[wr
持此謝高鳥	ii[ft ci[vb xp[yu gc[wk nn[nh
池潢不敢顧	ii[dy hl[dg bu[eu gj[vw gu[iy
赤雞白狗賭梨慄	ii[ty ji[yn bd[po gz[qb du[bt li[ha li[xa
恥令越甲鳴吾君	ii[ev lk[rd yt[zh jx[ou mk[kn wu[wk jy[xk
魑魅喜人過	ii[gw mw[gh xi[uk rf[pd go[cz
持謝鄰家子	ii[ft xp[yu lb[re jx[gu zi[lh
池月漸東上	ii[dy yt[ke jm[di ds[qx uh[bh
重上君子堂	is[ph uh[bh jy[xk zi[lh th[xt
蟲聲新透綠窗紗	is[ks ug[um xb[lj tz[hz lv[sx il[xp ua[sx
籌筆驛	iz[vf bi[vm yi[my
惆悵南朝事	iz[xk ih[xi nj[uk ic[uo ui[hk
酬程延秋夜即事見贈	iz[yd ig[hk yj[pj qq[hh ye[wr ji[ge ui[hk jm[ke zg[bb
抽刀斷水水更流	iz[fy dc[vp dr[mj uv[uu uv[uu gg[ho lq[dw
酬郭給事	iz[yd go[we gw[sr ui[hk
愁因薄暮起	iz[hx yb[wd bo[cd mu[co qi[zk
愁雲黲淡萬里凝	iz[hx yy[es cj[hs dj[dh wj[hv li[ot nk[db
酬張少府	iz[yd vh[gi uc[xp fu[gr
觸波濤	iu[di bo[dp tc[df
處處伴愁顏	iu[wb iu[wb bj[rb iz[hx yj[ly
處處黃蘆草	iu[wb iu[wb hl[gy lu[ch cc[co
處處聞啼鳥	iu[wb iu[wb wf[me ti[kl nn[nh
初彈淥水後楚妃	iu[yd dj[gb lu[dx uv[uu hz[pk iu[ap fw[nk
出洞無論隔山水	iu[ck ds[dk wu[ee ly[yr ge[eh uj[uk uv[uu
初發揚子寄元大校書	iu[yd fa[vy yh[fv zi[lh ji[gd yr[ee da[hr xn[al uu[vv
楚江懷古	iu[ap jl[dg hk[xb gu[uk
楚江微雨裡	iu[ap jl[dg ww[ru yu[hk li[ot
出郊曠清曙	iu[ck jn[le kl[og qk[df uu[os
楚客相思益渺然	iu[ap ke[gw xl[am si[tx yi[bm mn[dm rj[xd
出門搔白首	iu[ck mf[du sc[fy bd[po uz[be
初日郢門山	iu[yd ri[wh yk[ke mf[du uj[uk
初日照高林	iu[yd ri[wh vc[od gc[wk lb[aa
出入高下窮煙霏	iu[ck ru[pd gc[wk xx[hb qs[xl yj[hw fw[yf
出塞復入塞	iu[ck sd[gt fu[ro ru[pd sd[gt
楚塞三湘接	iu[ap sd[gt sj[hh xl[da jp[fl
出山泉水濁	iu[ck uj[uk qr[bu uv[uu vo[di
出師未捷身先死	iu[ck ui[uh ww[ha jp[fh uf[pu xm[ne si[hx
初為霓裳後六麼	iu[yd ww[dl ni[yj ih[xy hz[pk lq[wb me[ps
初聞涕淚滿衣裳	iu[yd wf[me ti[db lw[dm mj[dc yi[wy uh[xy
出行復悠悠	iu[ck xk[rh fu[ro yz[rx yz[rx
初因避地去人間	iu[yd yb[wd bi[uz di[ty qu[ts rf[pd jm[mo
滁州西澗	iu[de vz[dp xi[hk jm[dm
川為靜其波	ir[pu ww[dl jk[fd qi[cb bo[dp
傳聞至此回	ir[re wf[me vi[ht ci[vb hv[wk
傳之七十有二代	ir[re vi[dv qi[hv ui[hu yz[uo er[hh dd[rq
摐金伐鼓下榆關	il[[ jb[rw fa[rg gu[uu xx[hb yu[ar gr[bt
床前明月光	il[ga qm[bo mk[oo yt[ke gl[xe
垂釣將已矣	iv[ph dn[jb jl[dx yi[kv yi[su
吹度玉門關	iv[kd du[gn yu[wd mf[du gr[bt
春蠶到死絲方盡	iy[so cj[ti dc[hd si[hx si[sh fh[dw jb[ud
春草閉閒門	iy[so cc[co bi[mc xm[ma mf[du
春草明年綠	iy[so cc[co mk[oo nm[rn lv[sx
春潮帶雨晚來急	iy[so ic[du dd[cj yu[hk wj[od ld[hm ji[dx
春城無處不飛花	iy[so ig[tw wu[ee iu[wb bu[eu fw[vp hx[cr
春城紫禁曉陰陰	iy[so ig[tw zi[vy jb[ae xn[oq yb[eo yb[eo
春愁黯黯獨成眠	iy[so iz[hx an[hl an[hl du[qi ig[wv mm[mm
春窗曙滅九微火	iy[so il[xp uu[os mp[hh jq[pv ww[ru ho[dp
春詞	iy[so ci[yv
春從春遊夜專夜	iy[so cs[rr iy[so yz[df ye[wr vr[ev ye[wr
春泛若耶溪	iy[so fj[dp ro[cu ye[ee xi[da
春風不相識	iy[so fg[ji bu[eu xl[am ui[yk
春風吹又生	iy[so fg[ji iv[kd yz[vd ug[pf
春風對青冢	iy[so fg[ji dv[yc qk[fo vs[gu
春風桃李花開日	iy[so fg[ji tc[av li[az hx[cr kd[hc ri[wh
春歌	iy[so ge[kd
春宮曲	iy[so gs[gk qu[ou
春宮怨	iy[so gs[gk yr[xx
春歸在客先	iy[so gv[ux zd[ut ke[gw xm[ne
春寒賜浴華清池	iy[so hj[gd ci[bo yu[db hx[ru qk[df ii[dy
春江花朝秋月夜	iy[so jl[dg hx[cr vc[uo qq[hh yt[ke ye[wr
春鳩鳴何處	iy[so jq[jn mk[kn he[rk iu[wb
春來遍是桃花水	iy[so ld[hm bm[hz ui[op tc[av hx[cr uv[uu
春來發幾枝	iy[so ld[hm fa[vy ji[pv vi[au
春眠不覺曉	iy[so mm[mm bu[eu jt[xj xn[oq
春日凝妝上翠樓	iy[so ri[wh nk[db vl[dn uh[bh cv[xw lz[am
春日潛行曲江曲	iy[so ri[wh qm[de xk[rh qu[ou jl[dg qu[ou
春思	iy[so si[tx
春宿左省	iy[so su[gr zo[ug ug[xm
春望	iy[so wh[ww
春曉	iy[so xn[oq
春宵苦短日高起	iy[so xn[gx ku[cg dr[ud ri[wh gc[wk qi[zk
春心莫共花爭發	iy[so xb[dv mo[co gs[gb hx[cr vg[dx fa[vy
春雨	iy[so yu[hk
春與青溪長	iy[so yu[hv qk[fo xi[da ih[ph
春怨	iy[so yr[xx
次北固山下	ci[dd bw[ub gu[wg uj[uk xx[hb
此道昔歸順	ci[vb dc[bz xi[go gv[ux uy[iy
此地空餘黃鶴樓	ci[vb di[ty ks[xg yu[re hl[gy he[gn lz[am
此地一為別	ci[vb di[ty yi[hh ww[dl bp[kd
辭根散作九秋蓬	ci[ql gf[ag sj[gw zo[rv jq[pv qq[hh pg[cw
此恨綿綿無絕期	ci[vb hf[xg mm[sb mm[sb wu[ee jt[sd qi[qo
辭家終擬長遊衍	ci[ql jx[gu vs[sw ni[fs ih[ph yz[df yj[rd
此皆騎戰一敵萬	ci[vb jp[bb qi[md vj[bg yi[hh di[qw wj[hv
此樂本自龜茲出	ci[vb le[px bf[ah zi[pm qq[do ci[by iu[ck
賜名大國虢與秦	ci[bo mk[xk da[hr go[ww go[ah yu[hv qb[sh
此木豈無陰	ci[vb mu[ub qi[uk wu[ee yb[eo
慈母手中線	ci[bx mu[vv uz[su vs[ku xm[sj
此情可待成追憶	ci[vb qk[xf ke[dk dd[rt ig[wv vv[pz yi[xv
此去隨所偶	ci[vb qu[ts sv[eu so[pj ou[ro
此曲有意無人傳	ci[vb qu[ou yz[uo yi[lx wu[ee rf[pd ir[re
此日登臨曙色開	ci[vb ri[wh dg[dd lb[uv uu[os se[db kd[hc
此事不繫於職司	ci[vb ui[hk bu[eu ji[py yu[eu vi[ek si[vh
此時無聲勝有聲	ci[vb ui[oc wu[ee ug[um ug[op yz[uo ug[um
此物最相思	ci[vb wu[nb zv[oe xl[am si[tx
辭嚴義密讀難曉	ci[ql yj[hy yi[di mi[gu du[yu nj[yv xn[oq
詞中有誓兩心知	ci[yv vs[ku yz[uo ui[fy ll[hk xb[dv vi[uk
此州獨見全	ci[vb vz[dp du[qi jm[ke qr[rw
從臣才藝鹹第一	cs[rr if[ku cd[hu yi[cv xm[wh di[vg yi[hh
從此君王不早朝	cs[rr ci[vb jy[xk wh[su bu[eu zc[ou ic[uo
從今四海為家日	cs[rr jb[rd si[we hd[dr ww[dl jx[gu ri[wh
從今又幾年	cs[rr jb[rd yz[vd ji[pv nm[rn
從來幽並客	cs[rr ld[hm yz[yy bk[bk ke[gw
蹙金孔雀銀麒麟	cu[wz jb[rw ks[zv qt[xv yb[jg qi[gq lb[gm
粗沙大石相磨治	cu[mq ua[dx da[hr ui[ek xl[am mo[ge vi[ds
竄逐蠻荒幸不死	cr[xk vu[uz mj[yi hl[cw xk[tb bu[eu si[hx
崔顥	cv[uv hc[oy
翠花拂天來向東	cv[xw hx[cr fu[ff tm[hd ld[hm xl[pk ds[qx
翠華想像空山裡	cv[xw hx[ru xl[ax xl[rd ks[xg uj[uk li[ot
翠華搖搖行復止	cv[xw hx[ru yc[fa yc[fa xk[rh fu[ro vi[uh
崔九堂前幾度聞	cv[uv jq[pv th[xt qm[bo ji[pv du[gn wf[me
翠翹金雀玉搔頭	cv[xw qn[qx jb[rw qt[xv yu[wd sc[fy tz[dd
崔曙	cv[uv uu[os
崔塗	cv[uv tu[dr
翠微盍葉垂鬢脣	cv[xw ww[ru he[tm ye[ku iv[ph bb[ig iy[ik
崔嵬枝幹郊原古	cv[uv ww[ug vi[au gj[hu jn[le yr[ib gu[uk
摧心肝	cv[fu xb[dv gj[og
翠影紅霞映朝日	cv[xw yk[op hs[sg xx[yk yk[ok vc[uo ri[wh
大道如青天	da[hr dc[bz ru[nk qk[fo tm[hd
大荒沈沈飛雪白	da[hr hl[cw uf[dg uf[dg fw[vp xt[yx bd[po
大江茫茫去不黃	da[hr jl[dg mh[cd mh[cd qu[ts bu[eu hl[gy
大江溯輕舟	da[hr jl[dg su[dn qk[is vz[pk
大開明堂受朝賀	da[hr kd[hc mk[oo th[xt uz[ay ic[uo he[lb
大曆二年十月十九日夔府別駕元持宅見臨潁李十二孃舞劍器	da[hr li[il er[hh nm[rn ui[hu yt[ke ui[hu jq[pv ri[wh kv[bb fu[gr bp[kd jx[lm yr[ee ii[ft vd[gp jm[ke lb[uv yk[by li[az ui[hu er[hh nl[nl wu[rx jm[rd qi[kq
大漠窮秋塞草衰	da[hr mo[dc qs[xl qq[hh sd[gt cc[co uk[wk
大漠無兵阻	da[hr mo[dc wu[ee bk[qb zu[eq
打起黃鶯兒	da[fd qi[zk hl[gy yk[cn er[pv
達人之高行	da[dz rf[pd vi[dv gc[wk xk[rh
大廈如傾要樑棟	da[hr ua[ie ru[nk qk[rb yc[xn ll[da ds[aq
大廈深簷與蓋覆	da[hr ua[ie uf[dg yj[ad yu[hv gd[bm fu[xr
大弦嘈嘈如急雨	da[hr xm[gw cc[kh cc[kh ru[nk ji[dx yu[hk
大雪滿弓刀	da[hr xt[yx mj[dc gs[kv dc[vp
大珠小珠落玉盤	da[hr vu[wp xn[ub vu[wp lo[cd yu[wd pj[vm
待到重陽日	dd[rt dc[hd is[ph yh[eo ri[wh
黛色參天二千尺	dd[rh se[db cj[sd tm[hd er[hh qm[pu ii[ud
戴叔倫	dd[tt uu[uy ly[rr
待曉堂前拜舅姑	dd[rt xn[oq th[xt qm[bo bd[fh jq[jt gu[ng
玳筵急管曲復終	dd[wr yj[vp ji[dx gr[vg qu[ou fu[ro vs[sw
岱宗夫如何	dd[ru zs[ge fu[er ru[nk he[rk
但道困苦乞為奴	dj[ro dc[bz ky[wa ku[cg qi[rv ww[dl nu[ny
丹鳳城南秋夜長	dj[kw fg[jy ig[tw nj[uk qq[hh ye[wr ih[ph
但恨無過王右軍	dj[ro hf[xg wu[ee go[cz wh[su yz[uk jy[gi
但見悲鳥號古木	dj[ro jm[ke bw[fx nn[nh hc[kk gu[uk mu[ub
但見淚痕溼	dj[ro jm[ke lw[dm hf[bg ui[do
但見群鷗日日來	dj[ro jm[ke qy[xy ou[kn ri[wh ri[wh ld[hm
但見新人笑	dj[ro jm[ke xb[lj rf[pd xn[vp
但教心似金鈿堅	dj[ro jn[tw xb[dv si[rs jb[rw dm[jt jm[ut
但看古來盛名下	dj[ro kj[fm gu[uk ld[hm ug[wm mk[xk xx[hb
丹青不知老將至	dj[kw qk[fo bu[eu vi[uk lc[tb jl[dx vi[ht
丹青引贈曹霸將軍	dj[kw qk[fo yb[gu zg[bb cc[ho ba[yg jl[dx jy[gi
丹丘生	dj[kw qq[jh ug[pf
但去莫復聞	dj[ro qu[ts mo[co fu[ro wf[me
澹然空水對斜暉	dj[dd rj[xd ks[xg uv[uu dv[yc xp[rd hv[og
澹然離言說	dj[dd rj[xd li[wk yj[we uo[yb
淡掃蛾眉朝至尊	dj[dh sc[fx ee[ip mw[mm ic[uo vi[ht zy[bc
但聞人語響	dj[ro wf[me rf[pd yu[yw xl[kp
但願長醉不願醒	dj[ro yr[ix ih[ph zv[yw bu[eu yr[ix xk[yo
丹灶初開火	dj[kw zc[ht iu[yd kd[hc ho[dp
當君懷歸日	dh[xx jy[xk hk[xb gv[ux ri[wh
當流赤足蹋澗石	dh[xx lq[dw ii[ty zu[kv ta[zo jm[dm ui[ek
當路誰相假	dh[xx lu[zw uv[yv xl[am jx[rk
當仁自古有不讓	dh[xx rf[re zi[pm gu[uk yz[uo bu[eu rh[yu
當時浣紗伴	dh[xx ui[oc hr[dg ua[sx bj[rb
當時只記入山深	dh[xx ui[oc vi[kb ji[yk ru[pd uj[uk uf[dg
蕩胸生層雲	dh[cd xs[ob ug[pf cg[ue yy[es
當軒下馬入錦茵	dh[xx xr[ig xx[hb ma[vv ru[pd jb[jb yb[cw
當與夢時同	dh[xx yu[hv mg[ax ui[oc ts[kh
到此躊躇不能去	dc[hd ci[vb iz[zf iu[zc bu[eu ng[sb qu[ts
道寄人知	dc[bz ji[gd rf[pd vi[uk
道旁過者問行人	dc[bz ph[lf go[cz ve[to wf[mk xk[rh rf[pd
道人庭宇靜	dc[bz rf[pd tk[gq yu[ge jk[fd
道由白雲盡	dc[bz yz[ou bd[po yy[es jb[ud
得無金丸懼	de[ro wu[ee jb[rw wj[jd ju[xj
得相能開國	de[ro xl[am ng[sb kd[hc go[ww
德以象賢	de[ru yi[sr xl[dk xm[ub
磴道盤虛空	dg[ed dc[bz pj[vm xu[hy ks[xg
登高	dg[dd gc[wk
登高壯觀天地間	dg[dd gc[wk vl[du gr[yj tm[hd di[ty jm[mo
登鸛雀樓	dg[dd gr[cn qt[xv lz[am
登樂遊原	dg[dd le[px yz[df yr[ib
登臨出世界	dg[dd lb[uv iu[ck ui[nv jp[tr
登柳州城樓寄漳汀封連四州刺史	dg[dd lq[ap vz[dp ig[tw lz[am ji[gd vh[dl tk[dd fg[tc lm[iz si[we vz[dp ci[cd ui[ki
登樓	dg[dd lz[am
燈下白頭人	dg[hd xx[hb bd[po tz[dd rf[pd
鄧攸無子尋知命	dg[ye yz[ru wu[ee zi[lh xy[xc vi[uk mk[rh
登幽州臺歌	dg[dd yz[yy vz[dp td[sk ge[kd
登岳陽樓	dg[dd yt[qu yh[eo lz[am
登舟望秋月	dg[dd vz[pk wh[ww qq[hh yt[ke
地崩山摧壯士死	di[ty bg[uo uj[uk cv[fu vl[du ui[uh si[hx
帝得聖相相曰度	di[lj de[ro ug[yt xl[am xl[am yt[wh du[gn
低空有斷雲	di[ru ks[xg yz[uo dr[mj yy[es
低眉信手續續彈	di[ru mw[mm xb[ry uz[su xu[su xu[su dj[gb
低頭思故鄉	di[ru tz[dd si[tx gu[gw xl[sp
低頭向暗壁	di[ru tz[dd xl[pk an[ol bi[ut
滌瑕盪垢清朝班	di[dw xx[wk dh[cd gz[tp qk[df ic[uo bj[wd
地下若逢陳後主	di[ty xx[hb ro[cu fg[wz if[eq hz[pk vu[dw
帝鄉明日到	di[lj xl[sp mk[oo ri[wh dc[hd
弟兄羈旅各西東	di[bg xs[ke ji[sg lv[fr ge[wk xi[hk ds[qx
地猶鄹氏邑	di[ty yz[qy zz[ee ui[pq yi[kb
帝曰汝度功第一	di[lj yt[wh ru[dn du[gn gs[gl di[vg yi[hh
弟子韓幹早入室	di[bg zi[lh hj[uw gj[hu zc[ou ru[pd ui[gh
弟走從軍阿姨死	di[bg zz[tv cs[rr jy[gi aa[ek yi[nh si[hx
點竄堯典舜典字	dm[bd cr[xk yc[qh dm[kb uy[ax dm[kb zi[gz
鈿合金釵寄將去	dm[jt he[rh jb[rw id[jy ji[gd jl[dx qu[ts
鈿頭銀篦擊節碎	dm[jt tz[dd yb[jg bi[vp ji[fk jp[ce sv[ew
調角斷清秋	dn[yk jn[do dr[mj qk[df qq[hh
弔影分為千里雁	dn[kj yk[op ff[bd ww[dl qm[pu li[ot yj[ir
東船西舫悄無言	ds[qx ir[vj xi[hk fh[vf qn[xx wu[ee yj[we
洞房昨夜停紅燭	ds[dk fh[hf zo[ov ye[wr tk[rw hs[sg vu[hi
東風不與周郎便	ds[qx fg[ji bu[eu yu[hv vz[kt lh[le bm[rh
東風無力百花殘	ds[qx fg[ji wu[ee li[vp bd[eo hx[cr cj[hj
董夫子	ds[cp fu[er zi[lh
冬歌	ds[wd ge[kd
洞壑當門前	ds[dk he[bt dh[xx mf[du qm[bo
東郊	ds[qx jn[le
東來橐駝滿舊都	ds[qx ld[hm to[he to[mg mj[dc jq[uo du[te
東林懷我師	ds[qx lb[aa hk[xb wo[pf ui[uh
洞門高閣靄餘輝	ds[dk mf[du gc[wk ge[mw ai[yy yu[ur hv[xg
東門酤酒飲我曹	ds[qx mf[du gu[yg jq[dy yb[ud wo[pf cc[ho
動如參與商	ds[el ru[nk cj[sd yu[hv uh[lk
洞天石扇	ds[dk tm[hd ui[ek uj[hx
洞庭連天九嶷高	ds[dk tk[gq lm[iz tm[hd jq[pv yi[ub gc[wk
洞庭秋水遠連天	ds[dk tk[gq qq[hh uv[uu yr[ez lm[iz tm[hd
東望都門信馬歸	ds[qx wh[ww du[te mf[du xb[ry ma[vv gv[ux
洞在清溪何處邊	ds[dk zd[ut qk[df xi[da he[rk iu[wb bm[lz
斗酒十千恣歡謔	dz[du jq[dy ui[hu qm[pu zi[dx hr[yd xt[yh
讀罷淚沾襟	du[yu ba[st lw[dm vj[db jb[ya
獨出冠時	du[qi iu[ck gr[ge ui[oc
獨愴然而涕下	du[qi il[xr rj[xd er[ek ti[db xx[hb
獨釣寒江雪	du[qi dn[jb hj[gd jl[dg xt[yx
杜甫	du[at fu[uo
渡漢江	du[dg hj[dy jl[dg
都護鐵衣冷猶著	du[te hu[fh tp[jp yi[wy lg[dr yz[qy vu[ct
渡荊門送別	du[dg jk[cd mf[du ss[bz bp[kd
杜鵑啼血猿哀鳴	du[at jr[kn ti[kl xt[pm yr[qt ai[wk mk[kn
獨立三邊靜	du[qi li[lh sj[hh bm[lz jk[fd
獨立揚新令	du[qi li[lh yh[fv xb[lj lk[rd
獨憐幽草澗邊生	du[qi lm[xr yz[yy cc[co jm[dm bm[lz ug[pf
獨留青冢向黃昏	du[qi lq[pt qk[fo vs[gu xl[pk hl[gy hy[uo
杜牧	du[at mu[nw
獨敲初夜磬	du[qi qn[wb iu[yd ye[wr qk[ue
杜審言	du[at uf[go yj[we
賭勝馬蹄下	du[bt ug[op ma[vv ti[zl xx[hb
獨戍臨江夜泊船	du[qi uu[wd lb[uv jl[dg ye[wr bo[db ir[vj
獨宿江城蠟炬殘	du[qi su[gr jl[dg ig[tw la[ig ju[hk cj[hj
渡頭餘落日	du[dg tz[dd yu[ur lo[cd ri[wh
杜荀鶴	du[at xy[cb he[gn
獨夜憶秦關	du[qi ye[wr yi[xv qb[sh gr[bt
獨有鳳凰池上客	du[qi yz[uo fg[jy hl[jb ii[dy uh[bh ke[gw
獨有宦遊人	du[qi yz[uo hr[gk yz[df rf[pd
渡遠荊門外	du[dg yr[ez jk[cd mf[du wd[xb
獨在異鄉為異客	du[qi zd[ut yi[kc xl[sp ww[dl yi[kc ke[gw
獨酌無相親	du[qi vo[yb wu[ee xl[am qb[la
獨坐幽篁裡	du[qi zo[rr yz[yy hl[vb li[ot
端居恥聖明	dr[lu ju[ug ii[ev ug[yt mk[oo
斷絕胡兒戀母聲	dr[mj jt[sd hu[go er[pv lm[yx mu[vv ug[um
斷無消息石榴紅	dr[mj wu[ee xn[dx xi[zx ui[ek lq[ap hs[sg
斷雁警愁眠	dr[mj yj[ir jk[cy iz[hx mm[mm
對此結中腸	dv[yc ci[vb jp[su vs[ku ih[ov
對此可以酣高樓	dv[yc ci[vb ke[dk yi[sr hj[yg gc[wk lz[am
對此如何不淚垂	dv[yc ci[vb ru[nk he[rk bu[eu lw[dm iv[ph
對此涕淚雙滂沱	dv[yc ci[vb ti[db lw[dm ul[yy ph[dl to[dg
對此欲倒東南傾	dv[yc ci[vb yu[bd dc[rh ds[qx nj[uk qk[rb
對棋陪謝傅	dv[yc qi[aq pw[el xp[yu fu[rf
對影成三人	dv[yc yk[op ig[wv sj[hh rf[pd
多病故人疏	do[xx bk[bh gu[gw rf[pd uu[pw
多難識君遲	do[xx nj[yv ui[yk jy[xk ii[uz
多歧路	do[xx qi[vu lu[zw
峨嵋山下少人行	ee[up mw[um uj[uk xx[hb uc[xp rf[pd xk[rh
爾輩苦無恃	er[dx bw[fi ku[cg wu[ee ui[xt
爾來四萬八千歲	er[dx ld[hm si[we wj[hv ba[pd qm[pu sv[ux
二陵風雨自東來	er[hh lk[et fg[ji yu[hk zi[pm ds[qx ld[hm
兒女共沾巾	er[pv nv[vp gs[gb vj[db jb[ku
兒女忽成行	er[pv nv[vp hu[bx ig[wv xk[rh
而聽	er[ek tk[kj
兒童相見不相識	er[pv ts[lo xl[am jm[ke bu[eu xl[am ui[yk
而往來者	er[ek wh[rd ld[hm ve[to
二雅褊迫無委蛇	er[hh ya[yv bm[yh po[bz wu[ee ww[hn yi[ig
二月黃鸝飛上林	er[hh yt[ke hl[gy li[hn fw[vp uh[bh lb[aa
發聲幽息	fa[vy ug[um yz[yy xi[zx
泛泛入煙霧	fj[dp fj[dp ru[pd yj[hw wu[yw
蕃漢斷消息	fj[cp hj[dy dr[mj xn[dx xi[zx
返景入深林	fj[pz jk[ow ru[pd uf[dg lb[aa
煩君最相警	fj[hy jy[xk zv[oe xl[am jk[cy
煩痾近消散	fj[hy ke[bk jb[jz xn[dx sj[gw
凡六百一十六言	fj[jd lq[wb bd[eo yi[hh ui[hu lq[wb yj[we
蕃情似此水	fj[cp qk[xf si[rs ci[vb uv[uu
翻身向天仰射雲	fj[px uf[pu xl[pk tm[hd yh[rp ue[uc yy[es
反是生女好	fj[py ui[op ug[pf nv[vp hc[nz
繁星宿故關	fj[ry xk[op su[gr gu[gw gr[bt
翻疑夢裡逢	fj[px yi[bs mg[ax li[ot fg[wz
芳草萋萋鸚鵡洲	fh[cf cc[co qi[ch qi[ch yk[bn wu[wn vz[dd
芳草已雲暮	fh[cf cc[co yi[kv yy[es mu[co
方今太平日無事	fh[dw jb[rd td[dd pk[hb ri[wh wu[ee ui[hk
訪舊半為鬼	fh[yf jq[uo bj[bf ww[dl gv[be
芳心向春盡	fh[cf xb[dv xl[pk iy[so jb[ud
方知大蕃地	fh[dw vi[uk da[hr fj[cp di[ty
翡翠衾寒誰與共	fw[fx cv[xw qb[ry hj[gd uv[yv yu[hv gs[gb
飛鳥沒何處	fw[vp nn[nh mw[dj he[rk iu[wb
飛入尋常百姓家	fw[vp ru[pd xy[xc ih[xk bd[eo xk[np jx[gu
飛沈理自隔	fw[vp uf[dg li[wo zi[pm ge[eh
飛湍瀑流爭喧豗	fw[vp tr[du pu[do lq[dw vg[dx xr[kg hv[[
非謂文墨	fw[su ww[yt wf[wi mo[ht
分曹射覆蠟燈紅	ff[bd cc[ho ue[uc fu[xr la[ig dg[hd hs[sg
分曹限紫微	ff[bd cc[ho xm[eg zi[vy ww[ru
紛紛暮雪下轅門	ff[sf ff[sf mu[co xt[yx xx[hb yr[it mf[du
分明怨恨曲中論	ff[bd mk[oo yr[xx hf[xg qu[ou vs[ku ly[yr
紛牆丹柱動光彩	ff[sf ql[tt dj[kw vu[ad ds[el gl[xe cd[ap
焚燒殺掠	ff[ah uc[hq ua[ia lt[fw
分野中峰變	ff[bd ye[oy vs[ku fg[uw bm[yy
風波不信菱枝弱	fg[ji bo[dp bu[eu xb[ry lk[ct vi[au ro[gg
風掣紅旗凍不翻	fg[ji ie[nf hs[sg qi[fr ds[dq bu[eu fj[px
風塵何處期	fg[ji if[xt he[rk iu[wb qi[qo
風塵澒洞昏王室	fg[ji if[xt hs[[ ds[dk hy[uo wh[su ui[gh
風塵荏苒音書絕	fg[ji if[xt rf[cr rj[ck yb[lo uu[vv jt[sd
風吹柳花滿店香	fg[ji iv[kd lq[ap hx[cr mj[dc dm[gb xl[ho
風吹仙袂飄飄舉	fg[ji iv[kd xm[ru mw[yv pn[xf pn[xf ju[xf
風多響易沉	fg[ji do[xx xl[kp yi[ob if[dg
鳳歌笑孔丘	fg[jy ge[kd xn[vp ks[zv qq[jh
奉和聖制從蓬萊向興慶閣道中留春雨中春望之作應制	fg[sf he[hk ug[yt vi[nd cs[rr pg[cw ld[cl xl[pk xk[xb qk[gd ge[mw dc[bz vs[ku lq[pt iy[so yu[hk vs[ku iy[so wh[ww vi[dv zo[rv yk[gx vi[nd
奉和中書舍人賈至早朝大明宮	fg[sf he[hk vs[ku uu[vv ue[rg rf[pd jx[xb vi[ht zc[ou ic[uo da[hr mk[oo gs[gk
鳳凰池對青瑣門	fg[jy hl[jb ii[dy dv[yc qk[fo so[wx mf[du
烽火連三月	fg[hw ho[dp lm[iz sj[hh yt[ke
風急天高猿嘯哀	fg[ji ji[dx tm[hd gc[wk yr[qt xn[kx ai[wk
奉濟驛重送嚴公四韻	fg[sf ji[dw yi[my vs[ph ss[bz yj[hy gs[bs si[we yy[lb
封狼生貙貙生羆	fg[tc lh[ql ug[pf iu[[ iu[[ ug[pf pi[sd
風流儒雅亦吾師	fg[ji lq[dw ru[ry ya[yv yi[wy wu[wk ui[uh
風流天下聞	fg[ji lq[dw tm[hd xx[hb wf[me
風鳴兩岸葉	fg[ji mk[kn ll[hk an[ui ye[ku
風暖鳥聲碎	fg[ji nr[oa nn[nh ug[um sv[ew
楓橋夜泊	fg[af qn[ap ye[wr bo[db
風泉滿清聽	fg[ji qr[bu mj[dc qk[df tk[kj
逢入京使	fg[wz ru[pd jk[wk ui[rh
風送宮嬪笑語和	fg[ji ss[bz gs[gk pb[ng xn[vp yu[yw he[hk
風頭如刀面如割	fg[ji tz[dd ru[nk dc[vp mm[ew ru[nk ge[gd
鳳尾香羅薄幾重	fg[jy ww[um xl[ho lo[sx bo[cd ji[pv is[ph
風物悽悽宿雨收	fg[ji wu[nb qi[dh qi[dh su[gr yu[hk uz[vw
風煙望五津	fg[ji yj[hw wh[ww wu[hu jb[dy
楓葉荻花秋瑟瑟	fg[af ye[ku di[cq hx[cr qq[hh se[wx se[wx
楓葉落紛紛	fg[af ye[ku lo[cd ff[sf ff[sf
風雨	fg[ji yu[hk
風雲常為護儲胥	fg[ji yy[es ih[xk ww[dl hu[fh iu[ry xu[po
風正一帆懸	fg[ji vg[hv yi[hh fj[jj xr[qx
風枝驚暗鵲	fg[ji vi[au jk[xw an[ol qt[gn
扶持自是神明力	fu[fe ii[ft zi[pm ui[op uf[uo mk[oo li[vp
賦得古原草送別	fu[bw de[ro gu[uk yr[ib cc[co ss[bz bp[kd
賦得暮雨送李胄	fu[bw de[ro mu[co yu[hk ss[bz li[az vz[yo
富貴於我如浮雲	fu[gh gv[vb yu[eu wo[pf ru[nk fu[da yy[es
復令識者久嘆嗟	fu[ro lk[rd ui[yk ve[to jq[xd tj[ky jp[ky
撫念益慈柔	fu[fe nm[rx yi[bm ci[bx rz[ya
芙蓉旌旗煙霧落	fu[ce rs[cx jk[fr qi[fr yj[hw wu[yw lo[cd
芙蓉樓送辛漸	fu[ce rs[cx lz[am ss[bz xb[lu jm[di
芙蓉如面柳如眉	fu[ce rs[cx ru[nk mm[ew lq[ap ru[nk mw[mm
芙蓉塘外有輕雷	fu[ce rs[cx th[tg wd[xb yz[uo qk[is lw[yt
芙蓉帳暖度春宵	fu[ce rs[cx vh[ji nr[oa du[gn iy[so xn[gx
撫事慷慨	fu[fe ui[hk kh[xg kd[xg
浮天滄海遠	fu[da tm[hd ch[dr hd[dr yr[ez
俯聽聞驚風	fu[rg tk[kj wf[me jk[xw fg[ji
夫婿輕薄兒	fu[er xu[np qk[is bo[cd er[pv
負以靈鰲蟠以螭	fu[db yi[sr lk[xh ao[fy pj[ip yi[sr ii[iw
俯飲一杯酒	fu[rg yb[ud yi[hh bw[ab jq[dy
浮雲一別後	fu[da yy[es yi[hh bp[kd hz[pk
浮雲遊子意	fu[da yy[es yz[df zi[lh yi[lx
浮雲終日行	fu[da yy[es vs[sw ri[wh xk[rh
復照青苔上	fu[ro vc[od qk[fo td[cs uh[bh
復值接輿醉	fu[ro vi[ru jp[fl yu[pb zv[yw
腹中貯書一萬卷	fu[or vs[ku vu[bg uu[vv yi[hh wj[hv jr[be
夫子何為者	fu[er zi[lh he[rk ww[dl ve[to
蓋蒙其傷憐而已	gd[bm mg[ch qi[cb uh[rr lm[xr er[ek yi[kv
感此懷故人	gj[wx ci[vb hk[xb gu[gw rf[pd
感此傷妾心	gj[wx ci[vb uh[rr qp[ln xb[dv
感而綴詩	gj[wx er[ek vv[sy ui[yt
敢告雲山從此始	gj[vw gc[nk yy[es uj[uk cs[rr ci[vb ui[ns
敢將十指誇針巧	gj[vw jl[dx ui[hu vi[fb kx[dh vf[ju qn[gk
感時撫事增惋傷	gj[wx ui[oc fu[fe ui[hk zg[tb wj[xg uh[rr
感時花濺淚	gj[wx ui[oc hx[cr jm[db lw[dm
感斯人言	gj[wx si[qj rf[pd yj[we
幹惟畫肉不畫骨	gj[hu ww[xv hx[ht rz[kr bu[eu hx[ht gu[ko
感我此言良久立	gj[wx wo[pf ci[vb yj[we ll[dg jq[xd li[lh
感遇四首之二	gj[wx yu[oz si[we uz[be vi[dv er[hh
感遇四首之三	gj[wx yu[oz si[we uz[be vi[dv sj[hh
感遇四首之四	gj[wx yu[oz si[we uz[be vi[dv si[we
感遇四首之一	gj[wx yu[oz si[we uz[be vi[dv yi[hh
感征戍之事	gj[wx vg[rh uu[wd vi[dv ui[hk
感子故意長	gj[wx zi[lh gu[gw yi[lx ih[ph
高才脫略名與利	gc[wk cd[hu to[ob lt[tw mk[xk yu[hv li[hd
高帝子孫盡隆準	gc[wk di[lj zi[lh sy[zx jb[ud ls[ew vy[dv
高風漢陽渡	gc[wk fg[ji hj[dy yh[eo du[dg
杲杲寒日生於東	gc[oa gc[oa hj[gd ri[wh ug[pf yu[eu ds[qx
高閣客竟去	gc[wk ge[mw ke[gw jk[lo qu[ts
告歸常侷促	gc[nk gv[ux ih[xk ju[uv cu[rz
高樓當此夜	gc[wk lz[am dh[xx ci[vb ye[wr
高明逼神惡	gc[wk mk[oo bi[hz uf[uo ee[hx
高山安可仰	gc[wk uj[uk an[gn ke[dk yh[rp
高適	gc[wk ui[qz
高樹曉還密	gc[wk uu[ay xn[oq hd[bz mi[gu
縞素漠漠開風沙	gc[sw su[fy mo[dc mo[dc kd[hc fg[ji ua[dx
高堂明鏡悲白髮	gc[wk th[xt mk[oo jk[jl bw[fx bd[po fa[vy
高臥南齋時	gc[wk wo[kb nj[uk vd[we ui[oc
閣道回看上苑花	ge[mw dc[bz hv[wk kj[fm uh[bh yr[cx hx[cr
隔江猶唱後庭花	ge[eh jl[dg yz[qy ih[ko hz[pk tk[gq hx[cr
隔籬呼取盡餘杯	ge[eh li[vw hu[kp qu[ey jb[ud yu[ur bw[ab
隔山望南鬥	ge[eh uj[uk wh[ww nj[uk dz[du
哥舒歌	ge[kk uu[ry ge[kd
哥舒夜帶刀	ge[kk uu[ry ye[wr dd[cj dc[vp
隔水問樵夫	ge[eh uv[uu wf[mk qn[av fu[er
閣夜	ge[mw ye[wr
隔葉黃鸝空好音	ge[eh ye[ku hl[gy li[hn ks[xg hc[nz yb[lo
歌以贈之	ge[kd yi[sr zg[bb vi[dv
各在一處	ge[wk zd[ut yi[hh iu[wb
隔座送鉤春酒暖	ge[eh zo[gr ss[bz gz[jb iy[so jq[dy nr[oa
更隔蓬山一萬重	gg[ho ge[eh pg[cw uj[uk yi[hh wj[hv is[ph
耿耿星河欲曙天	gg[eh gg[eh xk[op he[dk yu[bd uu[os tm[hd
更教明月照流黃	gg[ho jn[tw mk[oo yt[ke vc[od lq[dw hl[gy
更堪江上鼓鼙聲	gg[ho kj[tq jl[dg uh[bh gu[uu pi[ub ug[um
更上一層樓	gg[ho uh[bh yi[hh cg[ue lz[am
更深月色半人家	gg[ho uf[dg yt[ke se[db bj[bf rf[pd jx[gu
更有明朝恨	gg[ho yz[uo mk[oo ic[uo hf[xg
功成不退皆殞身	gs[gl ig[wv bu[eu tv[gz jp[bb yy[hk uf[pu
宮詞	gs[gk ci[yv
共此燈燭光	gs[gb ci[vb dg[hd vu[hi gl[xe
公從何處得紙本	gs[bs cs[rr he[rk iu[wb de[ro vi[su bf[ah
功蓋三分國	gs[gl gd[bm sj[hh ff[bd go[ww
宮館何玲瓏	gs[gk gr[ug he[rk lk[wr ls[wy
宮花寂寞紅	gs[gk hx[cr ji[gu mo[gc hs[sg
共看明月應垂淚	gs[gb kj[fm mk[oo yt[ke yk[gx iv[ph lw[dm
共來百越文身地	gs[gb ld[hm bd[eo yt[zh wf[wi uf[pu di[ty
共憐時世儉梳妝	gs[gb lm[xr ui[oc ui[nv jm[rr uu[aw vl[dn
公孫劍器初第一	gs[bs sy[zx jm[rd qi[kq iu[yd di[vg yi[hh
公孫一人而已	gs[bs sy[zx yi[hh rf[pd er[ek yi[kv
公退齋戒坐小閣	gs[bs tv[gz vd[we jp[gc zo[rr xn[ub ge[mw
功無與讓恩不訾	gs[gl wu[ee yu[hv rh[yu en[wx bu[eu zi[vy
公之斯文不示後	gs[bs vi[dv si[qj wf[wi bu[eu ui[ex hz[pk
公之斯文若元氣	gs[bs vi[dv si[qj wf[wi ro[cu yr[ee qi[rh
公主琵琶幽怨多	gs[bs vu[dw pi[wb pa[wb yz[yy yr[xx do[xx
共醉重陽節	gs[gb zv[yw is[ph yh[eo jp[ce
古柏行	gu[uk bd[ab xk[rh
孤壁野僧鄰	gu[zp bi[ut ye[oy sg[rb lb[re
故別	gu[gw bp[kd
孤城背嶺寒吹角	gu[zp ig[tw bw[bo lk[ur hj[gd iv[kd jn[do
孤城當落暉	gu[zp ig[tw dh[xx lo[cd hv[og
孤城落日鬥兵稀	gu[zp ig[tw lo[cd ri[wh dz[du bk[qb xi[hi
古祠高樹兩茫然	gu[uk ci[uv gc[wk uu[ay ll[hk mh[cd rj[xd
古從軍行	gu[uk cs[rr jy[gi xk[rh
孤燈不明思欲絕	gu[zp dg[hd bu[eu mk[oo si[tx yu[bd jt[sd
孤燈寒照雨	gu[zp dg[hd hj[gd vc[od yu[hk
孤燈挑盡未成眠	gu[zp dg[hd tn[fv jb[ud ww[ha ig[wv mm[mm
孤燈聞楚角	gu[zp dg[hd wf[me iu[ap jn[do
古調雖自愛	gu[uk dn[yk sv[ki zi[pm ai[au
古鼎躍水龍騰梭	gu[uk dk[mv yt[zp uv[uu ls[yp tg[ob so[as
孤獨異鄉春	gu[zp du[qi yi[kc xl[sp iy[so
孤帆天際看	gu[zp fj[jj tm[hd ji[ee kj[fm
孤帆遠影碧空盡	gu[zp fj[jj yr[ez yk[op bi[we ks[xg jb[ud
孤飛自可疑	gu[zp fw[vp zi[pm ke[dk yi[bs
孤高聳天宮	gu[zp gc[wk ss[re tm[hd gs[gk
故關衰草遍	gu[gw gr[bt uk[wk cc[co bm[hz
故國三千里	gu[gw go[ww sj[hh qm[pu li[ot
孤鴻海上來	gu[zp hs[dn hd[dr uh[bh ld[hm
故潔其身也	gu[gw jp[du qi[cb uf[pu ye[vu
估客晝眠知浪靜	gu[rg ke[gw vz[uo mm[mm vi[uk lh[dl jk[fd
谷口書齋寄楊補闕	gu[bk kz[uv uu[vv vd[we ji[gd yh[av bu[yb qt[mn
顧況	gu[iy kl[dk
古來白骨無人收	gu[uk ld[hm bd[po gu[ko wu[ee rf[pd uz[vw
古來材大難為用	gu[uk ld[hm cd[ac da[hr nj[yv ww[dl ys[ou
古來青史誰不見	gu[uk ld[hm qk[fo ui[ki uv[yv bu[eu jm[ke
古來聖賢皆寂寞	gu[uk ld[hm ug[yt xm[ub jp[bb ji[gu mo[gc
古來萬事東流水	gu[uk ld[hm wj[hv ui[hk ds[qx lq[dw uv[uu
古來征戰幾人回	gu[uk ld[hm vg[rh vj[bg ji[pv rf[pd hv[wk
故壘蕭蕭蘆荻秋	gu[gw lw[st xn[cx xn[cx lu[ch di[cq qq[hh
古廟杉松巢水鶴	gu[uk mn[gy uj[ap ss[ab ic[vo uv[uu he[gn
古木無人徑	gu[uk mu[ub wu[ee rf[pd jk[rs
孤蓬萬里徵	gu[zp pg[cw wj[hv li[ot vg[rh
孤琴候蘿徑	gu[zp qb[wr hz[ru lo[cs jk[rs
故人從軍在右輔	gu[gw rf[pd cs[rr jy[gi zd[ut yz[uk fu[if
故人江海別	gu[gw rf[pd jl[dg hd[dr bp[kd
故人具雞黍	gu[gw rf[pd ju[jb ji[yn uu[hr
故人入我夢	gu[gw rf[pd ru[pd wo[pf mg[ax
故人殊未來	gu[gw rf[pd uu[hp ww[ha ld[hm
故人西辭黃鶴樓	gu[gw rf[pd xi[hk ci[ql hl[gy he[gn lz[am
骨肉不待同馳驅	gu[ko rz[kr bu[eu dd[rt ts[kh ii[my qu[mk
骨肉流離道路中	gu[ko rz[kr lq[dw li[wk dc[bz lu[zw vs[ku
顧視清高氣深穩	gu[iy ui[uj qk[df gc[wk qi[rh uf[dg wf[hd
古戍蒼蒼烽火寒	gu[uk uu[wd ch[cr ch[cr fg[hw ho[dp hj[gd
姑蘇城外寒山寺	gu[ng su[cl ig[tw wd[xb hj[gd uj[uk si[tc
古臺搖落後	gu[uk td[sk yc[fa lo[cd hz[pk
顧我無衣搜藎篋	gu[iy wo[pf wu[ee yi[wy sz[fj jb[cu qp[vk
孤雁	gu[zp yj[ir
古意	gu[uk yi[lx
古意呈補闕喬知之	gu[uk yi[lx ig[kw bu[yb qt[mn qn[pp vi[uk vi[dv
顧影無如白髮何	gu[iy yk[op wu[ee ru[nk bd[po fa[vy he[rk
故園東望路漫漫	gu[gw yr[we ds[qx wh[ww lu[zw mj[do mj[do
故園蕪已平	gu[gw yr[we wu[ce yi[kv pk[hb
孤雲將野鶴	gu[zp yy[es jl[dx ye[oy he[gn
古者世稱大手筆	gu[uk ve[to ui[nv ig[hd da[hr uz[su bi[vm
孤舟蓑笠翁	gu[zp vz[pk so[cw li[vl wg[bx
故作詩一篇以	gu[gw zo[rv ui[yt yi[hh pm[vh yi[sr
關城樹色催寒近	gr[bt ig[tw uu[ay se[db cv[ru hj[gd jb[jz
冠蓋滿京華	gr[ge gd[bm mj[dc jk[wk hx[ru
官高何足論	gr[gu gc[wk he[rk zu[kv ly[yr
觀公孫大娘弟子舞劍器行並序	gr[yj gs[bs sy[zx da[hr nl[nl di[bg zi[lh wu[rx jm[rd qi[kq xk[rh bk[bk xu[gy
觀經鴻都尚填咽	gr[yj jk[ss hs[dn dz[te uh[xk tm[tu yj[kw
關門令尹誰能識	gr[bt mf[du lk[rd yb[xp uv[yv ng[sb ui[yk
關內阻飢	gr[bt nw[kr zu[eq ji[uj
關塞蕭條行陸難	gr[bt sd[gt xn[cx tn[wa xk[rh lu[ef nj[yv
關山月	gr[bt uj[uk yt[ke
慣彈琵琶解歌舞	gr[xm tj[gb pi[wb pa[wb jp[dd ge[kd wu[rx
官應老病休	gr[gu yk[gx lc[tb bk[bh xq[ra
關月冷相隨	gr[bt yt[ke lg[dr xl[am sv[eu
管樂有才原不忝	gr[vg yt[px yz[uo cd[hu yr[ib bu[eu tm[tx
關張無命欲何如	gr[bt vh[gi wu[ee mk[rh yu[bd he[rk ru[nk
觀者如山色沮喪	gr[yj ve[to ru[nk uj[uk se[db ju[dq sh[ty
關中昔喪亂	gr[bt vs[ku xi[go sh[ty lr[qv
光價豈止百倍過	gl[xe jx[rr qi[uk vi[uh bd[eo bw[rl go[cz
廣澤生明月	gl[di ze[dy ug[pf mk[oo yt[ke
桂華秋皎潔	gv[at hx[ru qq[hh jn[bl jp[du
歸來池苑皆依舊	gv[ux ld[hm ii[dy yr[cx jp[bb yi[ry jq[uo
貴來方悟稀	gv[vb ld[hm fh[dw wu[xw xi[hi
歸來看取明鏡前	gv[ux ld[hm kj[fm qu[ey mk[oo jk[jl qm[bo
歸來每日斜	gv[ux ld[hm mw[rm ri[wh xp[rd
歸來且閉關	gv[ux ld[hm qp[ke bi[mc gr[bt
歸來視幼女	gv[ux ld[hm ui[uj yz[yl nv[vp
歸來頭白還戍邊	gv[ux ld[hm tz[dd bd[po hd[bz uu[wd bm[lz
歸來煮白石	gv[ux ld[hm vu[td bd[po ui[ek
歸老江湖邊	gv[ux lc[tb jl[dg hu[dg bm[lz
歸馬識殘旗	gv[ux ma[vv ui[yk cj[hj qi[fr
癸卯歲	gv[dt mc[pe sv[ux
貴戚權門得筆跡	gv[vb qi[wu qr[ay mf[du de[ro bi[vm ji[yz
歸去來	gv[ux qu[ts ld[hm
歸去越王家	gv[ux qu[ts yt[zh wh[su jx[gu
歸山深淺去	gv[ux uj[uk uf[dg qm[dj qu[ts
歸思欲沾巾	gv[ux si[tx yu[bd vj[db jb[ku
歸嵩山作	gv[ux ss[uw uj[uk zo[rv
歸臥南山陲	gv[ux wo[kb nj[uk uj[uk iv[ei
鬼物守護煩撝呵	gv[be wu[nb uz[gc hu[fh fj[hy hv[[ he[kk
鬼物圖畫填青紅	gv[be wu[nb tu[ww hx[ht tm[tu qk[fo hs[sg
歸雁洛陽邊	gv[ux yj[ir lo[dw yh[eo bm[lz
閨怨	gv[mt yr[xx
歸棹洛陽人	gv[ux vc[ab lo[dw yh[eo rf[pd
閨中少婦不知愁	gv[mt vs[ku uc[xp fu[nx bu[eu vi[uk iz[hx
閨中只獨看	gv[mt vs[ku vi[kb du[qi kj[fm
國初以來畫鞍馬	go[ww iu[yd yi[sr ld[hm hx[ht an[gg ma[vv
過故人莊	go[cz gu[gw rf[pd vl[gt
虢國夫人承主恩	go[ah go[ww fu[er rf[pd ig[lu vu[dw en[wx
國家成敗吾豈敢	go[ww jx[gu ig[wv bd[bw wu[wk qi[uk gj[vw
國破山河在	go[ww po[ep uj[uk he[dk zd[ut
過香積寺	go[cz xl[ho ji[hk si[tc
過雨看松色	go[cz yu[hk kj[fm ss[ab se[db
還從物外起田園	hd[bz cs[rr wu[nb wd[xb qi[zk tm[wu yr[we
還將兩行淚	hd[bz jl[dx ll[hk hh[rh lw[dm
海客談瀛洲	hd[dr ke[gw tj[yh yk[dw vz[dd
還來就菊花	hd[bz ld[hm jq[wy ju[cb hx[cr
海門深不見	hd[dr mf[du uf[dg bu[eu jm[ke
海內存知己	hd[dr nw[kr cy[uz vi[uk ji[kv
海內風塵諸弟隔	hd[dr nw[kr fg[ji if[xt vu[yt di[bg ge[eh
海鷗何事更相疑	hd[dr ou[kn he[rk ui[hk gg[ho xl[am yi[bs
海畔雲山擁薊城	hd[dr pj[tb yy[es uj[uk ys[fo ji[cy ig[tw
海氣溼蟄薰腥臊	hd[dr qi[rh ui[do ve[fi xy[pd xk[oo sc[ok
還寢夢佳期	hd[bz qb[gd mg[ax jx[rt qi[qo
海日生殘夜	hd[dr ri[wh ug[pf cj[hj ye[wr
海上風雨至	hd[dr uh[bh fg[ji yu[hk vi[ht
海上生明月	hd[dr uh[bh ug[pf mk[oo yt[ke
海天愁思正茫茫	hd[dr tm[hd iz[hx si[tx vg[hv mh[cd mh[cd
還掩故園扉	hd[bz yj[fd gu[gw yr[we fw[hf
海燕雙棲玳瑁梁	hd[dr yj[nk ul[yy qi[ax dd[wr mc[wo ll[da
還作江南會	hd[bz zo[rv jl[dg nj[uk hv[re
韓碑	hj[uw bw[eb
漢兵奮迅如霹靂	hj[dy bk[qb ff[dt xy[vz ru[nk pi[yu li[yi
漢兵屯在輪臺北	hj[dy bk[qb ty[hk zd[ut ly[ir td[sk bw[ub
漢朝公卿忌賈生	hj[dy ic[uo gs[bs qk[pg ji[kx jx[xb ug[pf
菡萏發荷花	hj[cl dj[cd fa[vy he[cr hx[cr
寒燈獨夜人	hj[gd dg[hd du[qi ye[wr rf[pd
寒燈思舊事	hj[gd dg[hd si[tx jq[uo ui[hk
含光混世貴無名	hj[rk gl[xe hy[do ui[nv gv[vb wu[ee mk[xk
瀚海闌干百丈冰	hj[du hd[dr lj[mh gj[hu bd[eo vh[hi bk[du
韓翃	hj[uw hs[[
漢皇重色思傾國	hj[dy hl[bw vs[ph se[db si[tx qk[rb go[ww
漢家大將西出師	hj[dy jx[gu da[hr jl[dx xi[hk iu[ck ui[uh
漢家山東二百州	hj[dy jx[gu uj[uk ds[qx er[hh bd[eo vz[dp
漢家煙塵在東北	hj[dy jx[gu yj[hw if[xt zd[ut ds[qx bw[ub
漢將辭家破殘賊	hj[dy jl[dx ci[ql jx[gu po[ep cj[hj zw[bg
漢江臨眺	hj[dy jl[dg lb[uv tn[mv
漢口夕陽斜渡鳥	hj[dy kz[uv xi[xd yh[eo xp[rd du[dg nn[nh
寒林空見日斜時	hj[gd lb[aa ks[xg jm[ke ri[wh xp[rd ui[oc
寒梅著花未	hj[gd mw[ar vu[ct hx[cr ww[ha
漢女輸幢布	hj[dy nv[vp uu[ir vl[jl bu[uj
寒禽與衰草	hj[gd qb[rw yu[hv uk[wk cc[co
寒磬滿空林	hj[gd qk[ue mj[dc ks[xg lb[aa
含情凝睇謝君王	hj[rk qk[xf nk[db di[mb xp[yu jy[xk wh[su
含情慾說宮中事	hj[rk qk[xf yu[bd uo[yb gs[gk vs[ku ui[hk
寒山轉蒼翠	hj[gd uj[uk vr[ie ch[cr cv[xw
寒聲一夜傳刁斗	hj[gd ug[um yi[hh ye[wr ir[re dn[vh dz[du
寒食	hj[gd ui[rl
寒食東風御柳斜	hj[gd ui[rl ds[qx fg[ji yu[rw lq[ap xp[rd
漢使斷腸對歸客	hj[dy ui[rh dr[mj ih[ov dv[yc gv[ux ke[gw
寒塘欲下遲	hj[gd th[tg yu[bd xx[hb ii[uz
漢文皇帝有高臺	hj[dy wf[wi hl[bw di[lj yz[uo gc[wk td[sk
漢文有道恩猶薄	hj[dy wf[wi yz[uo dc[bz en[wx yz[qy bo[cd
漢下白登道	hj[dy xx[hb bd[po dg[dd dc[bz
涵虛混太清	hj[dl xu[hy hy[do td[dd qk[df
韓愈	hj[uw yu[rx
寒雨連江夜入吳	hj[gd yu[hk lm[iz jl[dg ye[wr ru[pd wu[kt
寒雲路幾層	hj[gd yy[es lu[zw ji[pv cg[ue
行當浮桂棹	hh[rh dh[xx fu[da gv[at vc[ab
豪蕩感激	hc[wu dh[cd gj[wx ji[db
毫髮盡備無差訛	hc[wm fa[vy jb[ud bw[wt wu[ee ia[yg ee[yr
浩浩風起波	hc[dn hc[dn fg[ji qi[zk bo[dp
浩然離故關	hc[dn rj[xd li[wk gu[gw gr[bt
好為廬山謠	hc[nz ww[dl lu[gh uj[uk yc[ya
何必待之子	he[rk bi[xp dd[rt vi[dv zi[lh
何處還相遇	he[rk iu[wb hd[bz xl[am yu[oz
何處西南任好風	he[rk iu[wb xi[hk nj[uk rf[rq hc[nz fg[ji
何處尋行跡	he[rk iu[wb xy[xc xk[rh ji[yz
何當重相見	he[rk dh[xx is[ph xl[am jm[ke
何當載酒來	he[rk dh[xx zd[ti jq[dy ld[hm
荷風送香氣	he[cr fg[ji ss[bz xl[ho qi[rh
合昏尚知時	he[rh hy[uo uh[xk vi[uk ui[oc
和賈舍人早朝大明宮之作	he[hk jx[xb ue[rg rf[pd zc[ou ic[uo da[hr mk[oo gs[gk vi[dv zo[rv
和晉陵路丞早春遊望	he[hk jb[ho lk[et lu[zw ig[lh zc[ou iy[so yz[df wh[ww
賀蘭山下陣如雲	he[lb lj[bs uj[uk xx[hb vf[ei ru[nk yy[es
荷笠帶斜陽	he[cr li[vl dd[cj xp[rd yh[eo
何滿子	he[rk mj[dc zi[lh
何年致此身	he[rk nm[rn vi[hw ci[vb uf[pu
何求美人折	he[rk qq[hu mw[bw rf[pd ve[fj
何日復歸來	he[rk ri[wh fu[ro gv[ux ld[hm
何日平胡虜	he[rk ri[wh pk[hb hu[go lu[hl
河山北枕秦關險	he[dk uj[uk bw[ub vf[ag qb[sh gr[bt xm[er
河上仙翁去不回	he[dk uh[bh xm[ru wg[bx qu[ts bu[eu hv[wk
禾生隴畝無東西	he[pa ug[pf ls[ey mu[wt wu[ee ds[qx xi[hk
河聲入海遙	he[dk ug[um ru[pd hd[dr yc[az
何時返旆勒燕然	he[rk ui[oc fj[pz pw[fr le[gl yj[nk rj[xd
何事入羅幃	he[rk ui[hk ru[pd lo[sx ww[jw
何時倚虛幌	he[rk ui[oc yi[rd xu[hy hl[jo
何所慰吾誠	he[rk so[pj ww[ux wu[wk ig[yw
何惜醉流霞	he[rk xi[xg zv[yw lq[dw xx[yk
何須身後千載名	he[rk xu[py uf[pu hz[pk qm[pu zd[ti mk[xk
何以有羽翼	he[rk yi[sr yz[uo yu[xx yi[xt
何因北歸去	he[rk yb[wd bw[ub gv[ux qu[ts
何用別尋方外去	he[rk ys[ou bp[kd xy[xc fh[dw wd[xb qu[ts
何用孤高比雲月	he[rk ys[ou gu[zp gc[wk bi[bb yy[es yt[ke
曷與三五相攀追	he[ob yu[hv sj[hh wu[hu xl[am pj[ad vv[pz
賀知章	he[lb vi[uk vh[lo
恨別鳥驚心	hf[xg bp[kd nn[nh jk[xw xb[dv
恨無知音賞	hf[xg wu[ee vi[uk yb[lo uh[xk
衡陽歸雁幾封書	hg[rd yh[eo gv[ux yj[ir ji[pv fg[tc uu[vv
紅豆生南國	hs[sg dz[hk ug[pf nj[uk go[ww
鴻飛冥冥日月白	hs[dn fw[vp mk[go mk[go ri[wh yt[ke bd[po
紅樓隔雨相望冷	hs[sg lz[am ge[eh yu[hk xl[am wh[ww lg[dr
紅泥小火爐	hs[sg ni[du xn[ub ho[dp lu[hh
訇然中開	hs[by rj[xd vs[ku kd[hc
紅樹花迎曉露開	hs[sg uu[ay hx[cr yk[pz xn[oq lu[yz kd[hc
紅桃綠柳垂簷向	hs[sg tc[av lv[sx lq[ap iv[ph yj[ad xl[pk
鴻雁不堪愁裡聽	hs[dn yj[ir bu[eu kj[tq iz[hx li[ot tk[kj
鴻雁幾時到	hs[dn yj[ir ji[pv ui[oc dc[hd
紅顏棄軒冕	hs[sg yj[ly qi[wc xr[ig mm[od
紅顏未老恩先斷	hs[sg yj[ly ww[ha lc[tb en[wx xm[ne dr[mj
紅葉晚蕭蕭	hs[sg ye[ku wj[od xn[cx xn[cx
紅妝白日鮮	hs[sg vl[dn bd[po ri[wh xm[yy
後不見來者	hz[pk bu[eu jm[ke ld[hm ve[to
後宮詞	hz[pk gs[gk ci[yv
後宮佳麗三千人	hz[pk gs[gk jx[rt li[hk sj[hh qm[pu rf[pd
後來鞍馬何逡巡	hz[pk ld[hm an[gg ma[vv he[rk qy[sz xy[vz
候時而來	hz[ru ui[oc er[ek ld[hm
侯王將相望久絕	hz[rv wh[su jl[dx xl[am wh[ww jq[xd jt[sd
後有韋諷前支盾	hz[pk yz[uo ww[hh fg[yf qm[bo vi[uy dy[pu
忽到龐公棲隱處	hu[bx dc[hd ph[gy gs[bs qi[ax yb[ed iu[wb
呼兒將出換美酒	hu[kp er[pv jl[dx iu[ck hr[fd mw[bw jq[dy
胡兒眼淚雙雙落	hu[go er[pv yj[mg lw[dm ul[yy ul[yy lo[cd
忽逢青鳥使	hu[bx fg[wz qk[fo nn[nh ui[rh
忽復乘舟夢日邊	hu[bx fu[ro ig[qb vz[pk mg[ax ri[wh bm[lz
虎鼓瑟兮鸞回車	hu[hj gu[uu se[wx xi[bk lr[yn hv[wk ie[qu
忽魂悸以魄動	hu[bx hy[eg ji[xh yi[sr po[bg ds[el
忽見陌頭楊柳色	hu[bx jm[ke mo[ee tz[dd yh[av lq[ap se[db
胡窺青海灣	hu[go kv[xe qk[fo hd[dr wj[dy
忽念山中客	hu[bx nm[rx uj[uk vs[ku ke[gw
胡騎憑陵雜風雨	hu[go qi[md pk[rj lk[et za[ja fg[ji yu[hk
胡琴琵琶與羌笛	hu[go qb[wr pi[wb pa[wb yu[hv ql[yv di[vy
狐裘不暖錦衾薄	hu[qp qq[hy bu[eu nr[oa jb[jb qb[ry bo[cd
忽然更作漁陽摻	hu[bx rj[xd gg[ho zo[rv yu[dy yh[eo ij[fs
忽然遭時變	hu[bx rj[xd zc[hz ui[oc bm[yy
胡人落淚沾邊草	hu[go rf[pd lo[cd lw[dm vj[db bm[lz cc[co
忽如一夜春風來	hu[bx ru[nk yi[hh ye[wr iy[so fg[ji ld[hm
胡天八月即飛雪	hu[go tm[hd ba[pd yt[ke ji[ge fw[vp xt[yx
胡為乎來哉	hu[go ww[dl hu[pb ld[hm zd[tk
忽聞歌古調	hu[bx wf[me ge[kd gu[uk dn[yk
忽聞海上有仙山	hu[bx wf[me hd[dr uh[bh yz[uo xm[ru uj[uk
忽聞水上琵琶聲	hu[bx wf[me uv[uu uh[bh pi[wb pa[wb ug[um
胡雁哀鳴夜夜飛	hu[go yj[ir ai[wk mk[kn ye[wr ye[wr fw[vp
湖月照我影	hu[dg yt[ke vc[od wo[pf yk[op
花鈿委地無人收	hx[cr dm[jt ww[hn di[ty wu[ee rf[pd uz[vw
畫閣朱樓盡相望	hx[ht ge[mw vu[ph lz[am jb[ud xl[am wh[ww
畫工如山貌不同	hx[ht gs[hu ru[nk uj[uk mc[pb bu[eu ts[kh
花冠不整下堂來	hx[cr gr[ge bu[eu vg[hh xx[hb th[xt ld[hm
花間一壺酒	hx[cr jm[mo yi[hh hu[uy jq[dy
花近高樓傷客心	hx[cr jb[jz gc[wk lz[am uh[rr ke[gw xb[dv
花徑不曾緣客掃	hx[cr jk[rs bu[eu cg[bo yr[sv ke[gw sc[fx
畫樓西畔桂堂東	hx[ht lz[am xi[hk pj[tb gv[at th[xt ds[qx
花路入溪口	hx[cr lu[zw ru[pd xi[da kz[uv
花落知多少	hx[cr lo[cd vi[uk do[xx uc[xp
畫眉深淺入時無	hx[ht mw[mm uf[dg qm[dj ru[pd ui[oc wu[ee
花門剺面請雪恥	hx[cr mf[du li[[ mm[ew qk[yf xt[yx ii[ev
華亭鶴唳詎可聞	hx[ru tk[wd he[gn li[kh ju[yk ke[dk wf[me
畫圖省識春風面	hx[ht tu[ww ug[xm ui[yk iy[so fg[ji mm[ew
化為狼與豺	hx[rq ww[dl lh[ql yu[hv id[pc
花隱掖垣暮	hx[cr yb[ed ye[fw yr[th mu[co
花迎劍佩星初落	hx[cr yk[pz jm[rd pw[rj xk[op iu[yd lo[cd
懷君屬秋夜	hk[xb jy[xk uu[up qq[hh ye[wr
淮南木落楚山多	hk[dv nj[uk mu[ub lo[cd iu[ap uj[uk do[xx
淮南一葉下	hk[dv nj[uk yi[hh ye[ku xx[hb
淮上對秋山	hk[dv uh[bh dv[yc qq[hh uj[uk
淮上喜會梁川故人	hk[dv uh[bh xi[uk hv[re ll[da ir[pu gu[gw rf[pd
淮西有賊五十載	hk[dv xi[hk yz[uo zw[bg wu[hu ui[hu zd[ti
淮陰市井笑韓信	hk[dv yb[eo ui[wj jk[ep xn[vp hj[uw xb[ry
緩歌慢舞凝絲竹	hr[sa ge[kd mj[xo wu[rx nk[db si[sh vu[rr
環佩空歸月下魂	hr[wb pw[rj ks[xg gv[ux yt[ke xx[hb hy[eg
歡笑情如舊	hr[yd xn[vp qk[xf ru[nk jq[uo
歡言得所憩	hr[yd yj[we de[ro so[pj qi[qx
歡醉中	hr[yd zv[yw vs[ku
黃埃散漫風蕭索	hl[gy ai[ts sj[gw mj[do fg[ji xn[cx so[uy
黃塵足今古	hl[gy if[xt zu[kv jb[rd gu[uk
荒城臨古渡	hl[cw ig[tw lb[uv gu[uk du[dg
皇甫冉	hl[bw fu[uo rj[kt
黃鶴樓	hl[gy he[gn lz[am
黃河入海流	hl[gy he[dk ru[pd hd[dr lq[dw
黃鶴一去不復返	hl[gy he[gn yi[hh qu[ts bu[eu fu[ro fj[pz
黃鶴之飛尚不得	hl[gy he[gn vi[dv fw[vp uh[xk bu[eu de[ro
黃河之水天上來	hl[gy he[dk vi[dv uv[uu tm[hd uh[bh ld[hm
黃昏到寺蝙蝠飛	hl[gy hy[uo dc[hd si[tc bm[ih fu[ih fw[vp
黃昏胡騎塵滿城	hl[gy hy[uo hu[go qi[md if[xt mj[dc ig[tw
黃昏飲馬傍交河	hl[gy hy[uo yb[ud ma[vv bh[rl jn[li he[dk
黃金燃桂盡	hl[gy jb[rw rj[hx gv[at jb[ud
恍驚起而長嗟	hl[xx jk[xw qi[zk er[ek ih[ph jp[ky
荒居舊業貧	hl[cw ju[ug jq[uo ye[ub pb[fb
黃蘆苦竹繞宅生	hl[gy lu[ch ku[cg vu[rr rc[sq vd[gp ug[pf
黃門飛鞚動塵	hl[gy mf[du fw[vp ks[[ ds[el if[xt
黃山舊繞漢宮斜	hl[gy uj[uk jq[uo rc[sq hj[dy gs[gk xp[rd
荒戍落黃葉	hl[cw uu[wd lo[cd hl[gy ye[ku
黃葉仍風雨	hl[gy ye[ku rg[rn fg[ji yu[hk
黃雲隴底白雪飛	hl[gy yy[es ls[ey di[gu bd[po xt[yx fw[vp
黃雲萬里動風色	hl[gy yy[es wj[hv li[ot ds[el fg[ji se[db
黃雲蕭條白日暗	hl[gy yy[es xn[cx tn[wa bd[po ri[wh an[ol
會當凌絕頂	hv[re dh[xx lk[dt jt[sd dk[dy
悔教夫婿覓封侯	hv[xr jn[tw fu[er xu[np mi[aj fg[tc hz[rv
回看天際下中流	hv[wk kj[fm tm[hd ji[ee xx[hb vs[ku lq[dw
回看血淚相和流	hv[wk kj[fm xt[pm lw[dm xl[am he[hk lq[dw
回樂峰前沙似雪	hv[wk le[px fg[uw qm[bo ua[dx si[rs xt[yx
回眸一笑百媚生	hv[wk mz[ms yi[hh xn[vp bd[eo mw[nm ug[pf
回日樓臺非甲帳	hv[wk ri[wh lz[am td[sk fw[su jx[ou vh[ji
揮手淚沾巾	hv[fg uz[su lw[dm vj[db jb[ku
揮手自茲去	hv[fg uz[su zi[pm zi[by qu[ts
回頭下望人寰處	hv[wk tz[dd xx[hb wh[ww rf[pd hr[gs iu[wb
回鄉偶書	hv[wk xl[sp ou[ro uu[vv
會須一飲三百杯	hv[re xu[py yi[hh yb[ud sj[hh bd[eo bw[ab
回崖沓障凌蒼蒼	hv[wk ya[ui ta[uo vh[el lk[dt ch[cr ch[cr
回舟不待月	hv[wk vz[pk bu[eu dd[rt yt[ke
魂返關塞黑	hy[eg fj[pz gr[bt sd[gt hw[sd
魂來楓林青	hy[eg ld[hm fg[af lb[aa qk[fo
魂魄不曾來入夢	hy[eg po[bg bu[eu cg[bo ld[hm ru[pd mg[ax
渾脫	hy[dg to[ob
渾欲不勝簪	hy[dg yu[bd bu[eu ug[op zj[vj
或從十五北防河	ho[gk cs[rr ui[hu wu[hu bw[ub fh[ef he[dk
或恐是同鄉	ho[gk ks[gx ui[op ts[kh xl[sp
或騎麒麟翳鳳凰	ho[gk qi[md qi[gq lb[gm yi[kx fg[jy hl[jb
霍如羿射九日落	ho[yv ru[nk yi[xc ue[uc jq[pv ri[wh lo[cd
火維地荒足妖怪	ho[dp ww[sv di[ty hl[cw zu[kv yc[np gk[xy
既辨	ji[gj bm[ld
羈泊欲窮年	ji[sg bo[db yu[bd qs[xl nm[rn
即此羨閒逸	ji[ge ci[vb xm[bd xm[ma yi[dz
即從巴峽穿巫峽	ji[ge cs[rr ba[ku xx[uj ir[xy wu[gr xx[uj
幾度隔山川	ji[pv du[gn ge[eh uj[uk ir[pu
即公孫可知矣	ji[ge gs[bs sy[zx ke[dk vi[uk yi[su
寄韓諫議	ji[gd hj[uw jm[yh yi[yd
幾行歸塞盡	ji[pv hh[rh gv[ux sd[gt jb[ud
寂寂花時閉院門	ji[gu ji[gu hx[cr ui[oc bi[mc yr[eg mf[du
寂寂江山搖落處	ji[gu ji[gu jl[dg uj[uk yc[fa lo[cd iu[wb
寂寂竟何待	ji[gu ji[gu jk[lo he[rk dd[rt
幾盡而去	ji[pv jb[ud er[ek qu[ts
即今漂泊干戈際	ji[ge jb[rd pn[dx bo[db gj[hu ge[qp ji[ee
汲井漱寒齒	ji[dj jk[ep uu[dh hj[gd ii[vr
寄李儋元錫	ji[gd li[az dj[rd yr[ee xi[jo
肌理細膩骨肉勻	ji[oj li[wo xi[st ni[oq gu[ko rz[kr yy[bd
集靈臺二首之二	ji[va lk[xh td[sk er[hh uz[be vi[dv er[hh
集靈臺二首之一	ji[va lk[xh td[sk er[hh uz[be vi[dv yi[hh
羈旅長堪醉	ji[sg lv[fr ih[ph kj[tq zv[yw
雞鳴紫陌曙光寒	ji[yn mk[kn zi[vy mo[ee uu[os gl[xe hj[gd
寂寞空庭春欲晚	ji[gu mo[gc ks[xg tk[gq iy[so yu[bd wj[od
寂寞身後事	ji[gu mo[gc uf[pu hz[pk ui[hk
寂寞養殘生	ji[gu mo[gc yh[yp cj[hj ug[pf
寄全椒山中道士	ji[gd qr[rw jn[au uj[uk vs[ku dc[bz ui[uh
幾日到臨洮	ji[pv ri[wh dc[hd lb[uv tc[dv
寄上浮樑大兄	ji[gd uh[bh fu[da ll[da da[hr xs[ke
寄身且喜滄洲近	ji[gd uf[pu qp[ke xi[uk ch[dr vz[dd jb[jz
幾時杯重把	ji[pv ui[oc bw[ab vs[ph ba[fb
寄書長不達	ji[gd uu[vv ih[ph bu[eu da[dz
洎外供奉	ji[dz wd[xb gs[rg fg[sf
羈危萬里身	ji[sg ww[de wj[hv li[ot uf[pu
寄臥郊扉久	ji[gd wo[kb jn[le fw[hf jq[xd
積雪浮雲端	ji[hk xt[yx fu[da yy[es dr[lu
寄揚州韓綽判官	ji[gd yh[fv vz[dp hj[uw io[sb pj[bd gr[gu
際夜轉西壑	ji[ee ye[wr vr[ie xi[hk he[bt
積雨空林煙火遲	ji[hk yu[hk ks[xg lb[aa yj[hw ho[dp ii[uz
積雨輞川莊作	ji[hk yu[hk wh[ik ir[pu vl[gt zo[rv
記於郾城觀公孫氏舞劍器	ji[yk yu[eu yj[ke ig[tw gr[yj gs[bs sy[zx ui[pq wu[rx jm[rd qi[kq
既至金門遠	ji[gj vi[ht jb[rw mf[du yr[ez
掎摭星宿遺羲娥	ji[fd vi[fg xk[op xq[gr yi[vz xi[bh ee[np
機中錦字論長恨	ji[aj vs[ku jb[jb zi[gz ly[yr ih[ph hf[xg
繼周八代爭戰罷	ji[sm vz[kt ba[pd dd[rq vg[dx vj[bg ba[st
即周召伯之甘棠	ji[ge vz[kt vc[dk bo[rb vi[dv gj[nh th[xa
及茲契幽絕	ji[pv zi[by qi[fd yz[yy jt[sd
寄左省杜拾遺	ji[gd zo[ug ug[xm du[at ui[fr yi[vz
嘉賓復滿堂	jx[ul bb[gq fu[ro mj[dc th[xt
賈島	jx[xb dc[nu
嫁得瞿塘賈	jx[ng de[ro qu[mv th[tg jx[xb
家臨九江水	jx[gu lb[uv jq[pv jl[dg uv[uu
佳人	jx[rt rf[pd
賈氏窺簾韓掾少	jx[xb ui[pq kv[xe lm[xj hj[uw yr[fv uc[xp
家書到隔年	jx[gu uu[vv dc[hd ge[eh nm[rn
家書抵萬金	jx[gu uu[vv di[fu wj[hv jb[rw
家童掃蘿徑	jx[gu ts[lo sc[fx lo[cs jk[rs
賈誼上書憂漢室	jx[xb yi[yg uh[bh uu[vv yz[xy hj[dy ui[gh
嫁與弄潮兒	jx[ng yu[hv ns[wc ic[du er[pv
家在蝦蟆陵下住	jx[gu zd[ut ha[ix ma[ic lk[et xx[hb vu[rd
家住層城鄰漢苑	jx[gu vu[rd cg[ue ig[tw lb[re hj[dy yr[cx
餞別王十一南遊	jm[uj bp[kd wh[su ui[hu yi[hh nj[uk yz[df
建德非吾土	jm[yj de[ru fw[su wu[wk tu[uh
澗底束荊薪	jm[dm di[gu uu[hk jk[cd xb[cl
見爾當何秋	jm[ke er[dx dh[xx he[rk qq[hh
劍閣崢嶸而崔嵬	jm[rd ge[mw vg[ud rs[uc er[ek cv[uv ww[ug
間關鶯語花底滑	jm[mo gr[bt yk[cn yu[yw hx[cr di[gu hx[dg
劍河風急雪片闊	jm[rd he[dk fg[ji ji[dx xt[yx pm[pu ko[md
艱難苦恨繁霜鬢	jm[yg nj[yv ku[cg hf[xg fj[ry ul[ya bb[ig
賤日豈殊眾	jm[bj ri[wh qi[uk uu[hp vs[rr
兼示符離及下邽弟妹	jm[bh ui[ex fu[vr li[wk ji[pv xx[hb gv[[ di[bg mw[nh
見螳螂之抱影	jm[ke th[ix lh[il vi[dv bc[fb yk[op
劍外忽傳收薊北	jm[rd wd[xb hu[bx ir[re uz[vw ji[cy bw[ub
揀選撰刻留山阿	jm[fq xr[nz vr[fk ke[wd lq[pt uj[uk ee[ek
建業暮鍾時	jm[yj ye[ub mu[co vs[jv ui[oc
漸與骨肉遠	jm[di yu[hv gu[ko rz[kr yr[ez
薦諸太廟比郜鼎	jm[cu vu[yt td[dd mn[gy bi[bb gc[ne dk[mv
將蟲響悲於前聽	jl[dx is[ks xl[kp bw[fx yu[fr qm[bo tk[kj
江春入舊年	jl[dg iy[so ru[pd jq[uo nm[rn
絳脣珠袖兩寂寞	jl[sw iy[ik vu[wp xq[yy ll[hk ji[gu mo[gc
將村獨歸處	jl[dx cy[ac du[qi gv[ux iu[wb
將登太行雪滿山	jl[dx dg[dd td[dd hh[rh xt[yx mj[dc uj[uk
江楓漁火對愁眠	jl[dg fg[af yu[dy ho[dp dv[yc iz[hx mm[mm
將赴吳興登樂遊原	jl[dx fu[zb wu[kt xk[xb dg[dd le[px yz[df yr[ib
江漢曾為客	jl[dg hj[dy cg[bo ww[dl ke[gw
江湖多風波	jl[dg hu[dg do[xx fg[ji bo[dp
江湖秋水多	jl[dg hu[dg qq[hh uv[uu do[xx
江淮度寒食	jl[dg hk[dv du[gn hj[gd ui[rl
將家就魚麥	jl[dx jx[gu jq[wy yu[dt md[fw
江靜潮初落	jl[dg jk[fd ic[du iu[yd lo[cd
將軍得名三十載	jl[dx jy[gi de[ro mk[xk sj[hh ui[hu zd[ti
將軍畫善蓋有神	jl[dx jy[gi hx[ht uj[yk gd[bm yz[uo uf[uo
將軍角弓不得控	jl[dx jy[gi jn[do gs[kv bu[eu de[ro ks[fx
將軍金甲夜不脫	jl[dx jy[gi jb[rw jx[ou ye[wr bu[eu to[ob
將軍魏武之子孫	jl[dx jy[gi ww[hg wu[hv vi[dv zi[lh sy[zx
將軍下筆開生面	jl[dx jy[gi xx[hb bi[vm kd[hc ug[pf mm[ew
將軍夜引弓	jl[dx jy[gi ye[wr yb[gu gs[kv
將老身反累	jl[dx lc[tb uf[pu fj[py lw[ty
江柳共風煙	jl[dg lq[ap gs[gb fg[ji yj[hw
江流曲似九迴腸	jl[dg lq[dw qu[ou si[rs jq[pv hv[wk ih[ov
江流石不轉	jl[dg lq[dw ui[ek bu[eu vr[ie
江流天地外	jl[dg lq[dw tm[hd di[ty wd[xb
江南逢李龜年	jl[dg nj[uk fg[wz li[az gv[do nm[rn
江南曲	jl[dg nj[uk qu[ou
江南有丹橘	jl[dg nj[uk yz[uo dj[kw ju[ay
江南瘴癘地	jl[dg nj[uk vh[bl li[bw di[ty
江畔洲如月	jl[dg pj[tb vz[dd ru[nk yt[ke
江清月近人	jl[dg qk[df yt[ke jb[jz rf[pd
江入大荒流	jl[dg ru[pd da[hr hl[cw lq[dw
江山故宅空文藻	jl[dg uj[uk gu[gw vd[gp ks[xg wf[wi zc[cd
江山留勝蹟	jl[dg uj[uk lq[pt ug[op ji[yz
江上幾人在	jl[dg uh[bh ji[pv rf[pd zd[ut
江上月明胡雁過	jl[dg uh[bh yt[ke mk[oo hu[go yj[ir go[cz
江水江花豈終極	jl[dg uv[uu jl[dg hx[cr qi[uk vs[sw ji[aj
江頭宮殿鎖千門	jl[dg tz[dd gs[gk dm[uj so[jx qm[pu mf[du
將往復旋如有情	jl[dx wh[rd fu[ro xr[fr ru[nk yz[uo qk[xf
江鄉故人偶集客舍	jl[dg xl[sp gu[gw rf[pd ou[ro ji[va ke[gw ue[rg
江雪	jl[dg xt[yx
將因臥病解朝衣	jl[dx yb[wd wo[kb bk[bh jp[dd ic[uo yi[wy
絳幘雞人送曉籌	jl[sw ze[jf ji[yn rf[pd ss[bz xn[oq iz[vf
江州司馬青衫溼	jl[dg vz[dp si[vh ma[vv qk[fo uj[yp ui[do
江州重別薛六柳八二員外	jl[dg vz[dp vs[ph bp[kd xt[cp lq[wb lq[ap ba[pd er[hh yr[kb wd[xb
椒房阿監青娥老	jn[au fh[hf aa[ek jm[um qk[fo ee[np lc[tb
矯矯珍木巔	jn[up jn[up vf[wr mu[ub dm[uu
蛟龍出沒猩鼯號	jn[il ls[yp iu[ck mo[dj xk[qo wu[jw hc[kk
教妾若為容	jn[tw qp[ln ro[cu ww[dl rs[xr
矯如群帝驂龍翔	jn[up ru[nk qy[xy di[lj cj[ms ls[yp xl[yx
腳著謝公屐	jn[ot vu[ct xp[yu gs[bs ji[ur
嗟爾遠道之人	jp[ky er[dx yr[ez dc[bz vi[dv rf[pd
節候看應晚	jp[ce hz[ru kj[fm yk[gx wj[od
嗟乎	jp[ky hu[pb
羯胡事主終無賴	jp[yo hu[go ui[hk vu[dw vs[sw wu[ee ld[hd
嗟君此別意何如	jp[ky jy[xk ci[vb bp[kd yi[lx he[rk ru[nk
節使三河募年少	jp[ce ui[rh sj[hh he[dk mu[cl nm[rn uc[xp
借問苦心愛者誰	jp[rg wf[mk ku[cg xb[dv ai[au ve[to uv[yv
借問路傍名利客	jp[rg wf[mk lu[zw bh[rl mk[xk li[hd ke[gw
皆向沙場老	jp[bb xl[pk ua[dx ih[tv lc[tb
婕妤傳詔才人索	jp[nh yu[ny ir[re vc[yd cd[hu rf[pd so[uy
皆與此圖筋骨同	jp[bb yu[hv ci[vb tu[ww jb[vo gu[ko ts[kh
嗟予好古生苦晚	jp[ky yu[sv hc[nz gu[uk ug[pf ku[cg wj[od
嗟餘聽鼓應官去	jp[ky yu[re tk[kj gu[uu yk[gx gr[gu qu[ts
嗟哉吾黨二三子	jp[ky zd[tk wu[wk dh[xk er[hh sj[hh zi[lh
今安在	jb[rd an[gn zd[ut
金鞭斷折九馬死	jb[rw bm[gr dr[mj ve[fj jq[pv ma[vv si[hx
金蟾齧鎖燒香入	jb[rw ij[id np[kv so[jx uc[hq xl[ho ru[pd
金昌緒	jb[rw ih[oo xu[st
今成流淚泉	jb[rd ig[wv lq[dw lw[dm qr[bu
錦城雖雲樂	jb[jb ig[tw sv[ki yy[es le[px
近得歸京邑	jb[jz de[ro gv[ux jk[wk yi[kb
錦帆應是到天涯	jb[jb fj[jj yk[gx ui[op dc[hd tm[hd ya[di
錦官城外柏森森	jb[jb gr[gu ig[tw wd[xb bd[ab sf[aa sf[aa
今見功名勝古人	jb[rd jm[ke gs[gl mk[xk ug[op gu[uk rf[pd
錦江春色來天地	jb[jb jl[dg iy[so se[db ld[hm tm[hd di[ty
今看兩楹奠	jb[rd kj[fm ll[hk yk[an dm[bd
津口停舟渡不得	jb[dy kz[uv tk[rw vz[pk du[dg bu[eu de[ro
矜誇紫騮好	jb[yr kx[dh zi[vy lq[mp hc[nz
今來典斯郡	jb[rd ld[hm dm[kb si[qj jy[xe
近淚無干土	jb[jz lw[dm wu[ee gj[hu tu[uh
禁裡疏鍾官舍晚	jb[ae li[ot uu[pw vs[jv gr[gu ue[rg wj[od
金陵津渡小山樓	jb[rw lk[et jb[dy du[dg xn[ub uj[uk lz[am
金陵酒肆留別	jb[rw lk[et jq[dy si[iy lq[pt bp[kd
金陵王氣黯然收	jb[rw lk[et wh[su qi[rh an[hl rj[xd uz[vw
金陵子弟來相送	jb[rw lk[et zi[lh di[bg ld[hm xl[am ss[bz
禁門宮樹月痕過	jb[ae mf[du gs[gk uu[ay yt[ke hf[bg go[cz
今年歡笑復明年	jb[rd nm[rn hr[yd xn[vp fu[ro mk[oo nm[rn
今漂淪憔悴	jb[rd pn[dx ly[dr qn[xv cv[xw
金闕前開二峰長	jb[rw qt[mn qm[bo kd[hc er[hh fg[uw ih[ph
金闕西廂叩玉扃	jb[rw qt[mn xi[hk xl[ia kz[ke yu[wd js[hk
金闕曉鍾開萬戶	jb[rw qt[mn xn[oq vs[jv kd[hc wj[hv hu[du
今人多不彈	jb[rd rf[pd do[xx bu[eu tj[gb
今日垂楊生左肘	jb[rd ri[wh iv[ph yh[av ug[pf zo[ug vz[oc
今日俸錢過十萬	jb[rd ri[wh fg[rs qm[jj go[cz ui[hu wj[hv
今日花開又一年	jb[rd ri[wh hx[cr kd[hc yz[vd yi[hh nm[rn
盡日君王看不足	jb[ud ri[wh jy[xk wh[su kj[fm bu[eu zu[kv
今日龍鍾人共老	jb[rd ri[wh ls[yp vs[jv rf[pd gs[gb lc[tb
今日之日多煩憂	jb[rd ri[wh vi[dv ri[wh do[xx fj[hy yz[xy
近入千家散花竹	jb[jz ru[pd qm[pu jx[gu sj[gw hx[cr vu[rr
錦瑟	jb[jb se[wx
錦瑟無端五十弦	jb[jb se[wx wu[ee dr[lu wu[hu ui[hu xm[gw
金山西見煙塵飛	jb[rw uj[uk xi[hk jm[ke yj[hw if[xt fw[vp
今上岳陽樓	jb[rd uh[bh yt[qu yh[eo lz[am
金繩鐵索鎖鈕壯	jb[rw ug[sk tp[jp so[uy so[jx nq[ji vl[du
近時郭家獅子花	jb[jz ui[oc go[we jx[gu ui[qu zi[lh hx[cr
金石刻畫臣能為	jb[rw ui[ek ke[wd hx[ht if[ku ng[sb ww[dl
近試上張水部	jb[jz ui[yq uh[bh vh[gi uv[uu bu[le
金粟堆前木已拱	jb[rw su[xm dv[tv qm[bo mu[ub yi[kv gs[fg
金粟堆前松柏裡	jb[rw su[xm dv[tv qm[bo ss[ab bd[ab li[ot
今為羌笛出塞聲	jb[rd ww[dl ql[yv di[vy iu[ck sd[gt ug[um
今我不樂思岳陽	jb[rd wo[pf bu[eu le[px si[tx yt[qu yh[eo
今我遊冥冥	jb[rd wo[pf yz[df mk[go mk[go
今無其器存其辭	jb[rd wu[ee qi[cb qi[kq cy[uz qi[cb ci[ql
金屋無人見淚痕	jb[rw wu[uh wu[ee rf[pd jm[ke lw[dm hf[bg
今夕復何夕	jb[rd xi[xd fu[ro he[rk xi[xd
近鄉情更怯	jb[jz xl[sp qk[xf gg[ho qp[xt
金星妝成嬌侍夜	jb[rw xk[op vl[dn ig[wv jn[np ui[rt ye[wr
今夜鄜州月	jb[rd ye[wr lu[[ vz[dp yt[ke
今夜偏知春氣暖	jb[rd ye[wr pm[rh vi[uk iy[so qi[rh nr[oa
今夜聞君琵琶語	jb[rd ye[wr wf[me jy[xk pi[wb pa[wb yu[yw
今朝都到眼前來	jb[rd vc[uo dz[te dc[hd yj[mg qm[bo ld[hm
今朝郡齋冷	jb[rd vc[uo jy[xe vd[we lg[dr
今朝為此別	jb[rd vc[uo ww[dl ci[vb bp[kd
今朝蟢子飛	jb[rd vc[uo xi[[ zi[lh fw[vp
今之新圖有二馬	jb[rd vi[dv xb[lj tu[ww yz[uo er[hh ma[vv
近種籬邊菊	jb[jz vs[hv li[vw bm[lz ju[cb
今茲弟子亦匪盛顏	jb[rd zi[by di[bg zi[lh yi[wy fw[kf ug[wm yj[ly
金樽清酒鬥十千	jb[rw zy[ab qk[df jq[dy dz[du ui[hu qm[pu
經冬復立春	jk[ss ds[wd fu[ro li[lh iy[so
經冬猶綠林	jk[ss ds[wd yz[qy lu[sx lb[aa
驚風亂颭芙蓉水	jk[xw fg[ji lr[qv vj[[ fu[ce rs[cx uv[uu
驚呼熱中腸	jk[xw hu[kp re[fd vs[ku ih[ov
鏡湖三百里	jk[jl hu[dg sj[hh bd[eo li[ot
經歷久遠期無佗	jk[ss li[il jq[xd yr[ez qi[qo wu[ee to[rg
淨理了可悟	jk[dd li[wo le[vu ke[dk wu[xw
京洛縫春衣	jk[wk lo[dw fg[sw iy[so yi[wy
荊門九派通	jk[cd mf[du jq[pv pd[dp ts[sz
旌旆逶迤碣石間	jk[fr pw[fr ww[hz yi[rz jp[eo ui[ek jm[mo
驚破霓裳羽衣曲	jk[xw po[ep ni[yj uh[xy yu[xx yi[wy qu[ou
旌旗無光日色薄	jk[fr qi[fr wu[ee gl[xe ri[wh se[db bo[cd
井稅有常期	jk[ep uv[hb yz[uo ih[xk qi[qo
靜聽松風寒	jk[fd tk[kj ss[ab fg[ji hj[gd
驚聞俗客爭來集	jk[xw wf[me su[rb ke[gw vg[dx ld[hm ji[va
竟夕起相思	jk[lo xi[xd qi[zk xl[am si[tx
竟夕自悲秋	jk[lo xi[xd zi[pm bw[fx qq[hh
徑須沽取對君酌	jk[rs xu[py gu[dg qu[ey dv[yc jy[xk vo[yb
靜夜四無鄰	jk[fd ye[wr si[we wu[ee lb[re
經鄒魯祭孔子而嘆之	jk[ss zz[de lu[yo ji[xe ks[zv zi[lh er[ek tj[ky vi[dv
迥立閶闔生長風	js[kz li[lh ih[mo he[mt ug[pf vh[ph fg[ji
迥若寒空雜煙雪	js[kz ro[cu hj[gd ks[xg za[ja yj[hw xt[yx
九重城闕煙塵生	jq[pv is[ph ig[tw qt[mn yj[hw if[xt ug[pf
九雛鳴鳳亂啾啾	jq[pv iu[dv mk[kn fg[jy lr[qv jq[kh jq[kh
酒舫泛泛然	jq[dy fh[vf fj[dp fj[dp rj[xd
舊國見青山	jq[uo go[ww jm[ke qk[fo uj[uk
舊好隔良緣	jq[uo hc[nz ge[eh ll[dg yr[sv
九華帳裡夢魂驚	jq[pv hx[ru vh[ji li[ot mg[ax hy[eg jk[xw
啾啾棲鳥過	jq[kh jq[kh qi[ax nn[nh go[cz
鷲翎金僕姑	jq[wn lk[rx jb[rw pu[rb gu[ng
九日登望仙台呈劉明府	jq[pv ri[wh dg[dd wh[ww xm[ru td[sk ig[kw lq[wd mk[oo fu[gr
舊時王謝堂前燕	jq[uo ui[oc wh[su xp[yu th[xt qm[bo yj[nk
九天閶闔開宮殿	jq[pv tm[hd ih[mo he[mt kd[hc gs[gk dm[uj
酒徒歷歷坐洲鳥	jq[dy tu[rz li[il li[il zo[rr vz[dd nn[nh
九微片片飛花瑣	jq[pv ww[ru pm[pu pm[pu fw[vp hx[cr so[wx
久為簪組累	jq[xd ww[dl zj[vj zu[sq lw[ty
舊業已隨征戰盡	jq[uo ye[ub yi[kv sv[eu vg[rh vj[bg jb[ud
九月寒砧催木葉	jq[pv yt[ke hj[gd vf[eb cv[ru mu[ub ye[ku
九月九日憶山東兄弟	jq[pv yt[ke jq[pv ri[wh yi[xv uj[uk ds[qx xs[ke di[bg
就中雲幕椒房親	jq[wy vs[ku yy[es mu[cj jn[au fh[hf qb[la
舉杯銷愁愁更愁	ju[xf bw[ab xn[jx iz[hx iz[hx gg[ho iz[hx
舉杯邀明月	ju[xf bw[ab yc[bz mk[oo yt[ke
據湖岸	ju[fu hu[dg an[ui
俱懷逸興壯思飛	ju[rj hk[xb yi[dz xk[xb vl[du si[tx fw[vp
舉酒欲飲無管絃	ju[xf jq[dy yu[bd yb[ud wu[ee gr[vg xm[gw
詎肯感激徒媕婀	ju[yk kf[vo gj[wx ji[db tu[rz an[[ ee[ne
句奇語重喻者少	ju[bk qi[dk yu[yw vs[ph yu[kr ve[to uc[xp
居人共住武陵源	ju[ug rf[pd gs[gb vu[rd wu[hv lk[et yr[di
居人未改秦衣服	ju[ug rf[pd ww[ha gd[kw qb[sh yi[wy fu[oe
舉頭望明月	ju[xf tz[dd wh[ww mk[oo yt[ke
居閒始自遣	ju[ug xm[ma ui[ns zi[pm qm[vz
劇辛樂毅感恩分	ju[ud xb[lu yt[px yi[lj gj[wx en[wx ff[bd
鐫功勒成告萬世	jr[jv gs[gl le[gl ig[wv gc[nk wj[hv ui[nv
卷帷望月空長嘆	jr[be ww[jv wh[ww yt[ke ks[xg ih[ph tj[ky
絕代有佳人	jt[sd dd[rq yz[uo jx[rt rf[pd
覺道資無窮	jt[xj dc[bz zi[db wu[ee qs[xl
絕頂一茅茨	jt[sd dk[dy yi[hh mc[cy ci[cd
絕域蒼茫更何有	jt[sd yu[tg ch[cr mh[cd gg[ho he[rk yz[uo
決眥入歸鳥	jt[dv zi[mv ru[pd gv[ux nn[nh
君不見	jy[xk bu[eu jm[ke
君不見沙場征戰苦	jy[xk bu[eu jm[ke ua[dx ih[tv vg[rh vj[bg ku[cg
君不見走馬川行雪海邊	jy[xk bu[eu jm[ke zz[tv ma[vv ir[pu xk[rh xt[yx hd[dr bm[lz
君不聞	jy[xk bu[eu wf[me
君臣相顧盡沾衣	jy[xk if[ku xl[am gu[iy jb[ud vj[db yi[wy
君臣已與時際會	jy[xk if[ku yi[kv yu[hv ui[oc ji[ee hv[re
君寵益嬌態	jy[xk is[gy yi[bm jn[np td[dx
君歌且休聽我歌	jy[xk ge[kd qp[ke xq[ra tk[kj wo[pf ge[kd
君歌聲酸辭且苦	jy[xk ge[kd ug[um sr[ys ci[ql qp[ke ku[cg
君家何處住	jy[xk jx[gu he[rk iu[wb vu[rd
君今在羅網	jy[xk jb[rd zd[ut lo[sx wh[ki
君憐無是非	jy[xk lm[xr wu[ee ui[op fw[su
君莫停	jy[xk mo[co tk[rw
君王掩面救不得	jy[xk wh[su yj[fd mm[ew jq[hw bu[eu de[ro
君問窮通理	jy[xk wf[mk qs[xl ts[sz li[wo
君言不得意	jy[xk yj[we bu[eu de[ro yi[lx
郡邑浮前浦	jy[xe yi[kb fu[da qm[bo pu[df
郡齋雨中與諸文士燕集	jy[xe vd[we yu[hk vs[ku yu[hv vu[yt wf[wi ui[uh yj[nk ji[va
君自故鄉來	jy[xk zi[pm gu[gw xl[sp ld[hm
君子意如何	jy[xk zi[lh yi[lx ru[nk he[rk
開國何茫然	kd[hc go[ww he[rk mh[cd rj[xd
開帷月初吐	kd[hc ww[jv yt[ke iu[yd tu[kt
開軒覽物華	kd[hc xr[ig lj[uj wu[nb hx[ru
開軒面場圃	kd[hc xr[ig mm[ew ih[tv pu[wf
開軒臥閒敞	kd[hc xr[ig wo[kb xm[ma ih[xw
開元二十六年	kd[hc yr[ee er[hh ui[hu lq[wb nm[rn
開元三載	kd[hc yr[ee sj[hh zd[ti
開元之中常引見	kd[hc yr[ee vi[dv vs[ku ih[xk yb[gu jm[ke
坎軻只得移荊蠻	kj[td ke[ik vi[kb de[ro yi[hx jk[cd mj[yi
客從東方來	ke[gw cs[rr ds[qx fh[dw ld[hm
可憐光彩生門戶	ke[dk lm[xr gl[xe cd[ap ug[pf mf[du hu[du
可憐閨裡月	ke[dk lm[xr gv[mt li[ot yt[ke
可憐九馬爭神駿	ke[dk lm[xr jq[pv ma[vv vg[dx uf[uo jy[ms
可憐王孫泣路隅	ke[dk lm[xr wh[su sy[zx qi[dl lu[zw yu[eo
客路青山外	ke[gw lu[zw qk[fo uj[uk wd[xb
客去波平檻	ke[gw qu[ts bo[dp pk[hb kj[au
柯如青銅根如石	ke[ak ru[nk qk[fo ts[jk gf[ag ru[nk ui[ek
客心洗流水	ke[gw xb[dv xi[dn lq[dw uv[uu
可以橫絕峨眉巔	ke[dk yi[sr hg[ag jt[sd ee[up mw[mm dm[uu
可以薦嘉客	ke[dk yi[sr jm[cu jx[ul ke[gw
客有從御史大夫張公出塞而還者	ke[gw yz[uo cs[rr yu[rw ui[ki da[hr fu[er vh[gi gs[bs iu[ck sd[gt er[ek hd[bz ve[to
客至	ke[gw vi[ht
肯數鄴下黃鬚兒	kf[vo uu[mw ye[ye xx[hb hl[gy xu[py er[pv
肯與鄰翁相對飲	kf[vo yu[hv lb[re wg[bx xl[am dv[yc yb[ud
空城澹月華	ks[xg ig[tw dj[dd yt[ke hx[ru
恐非平生魂	ks[gx fw[su pk[hb ug[pf hy[eg
空見葡萄入漢家	ks[xg jm[ke pu[cb tc[cb ru[pd hj[dy jx[gu
空令歲月易蹉跎	ks[xg lk[rd sv[ux yt[ke yi[ob co[zy to[zg
孔明廟前有老柏	ks[zv mk[oo mn[gy qm[bo yz[uo lc[tb bd[ab
空山百鳥散還合	ks[xg uj[uk bd[eo nn[nh sj[gw hd[bz he[rh
空山不見人	ks[xg uj[uk bu[eu jm[ke rf[pd
空山松子落	ks[xg uj[uk ss[ab zi[lh lo[cd
空山新雨後	ks[xg uj[uk xb[lj yu[hk hz[pk
恐是漢代韓張良	ks[gx ui[op hj[dy dd[rq hj[uw vh[gi ll[dg
空向秋波哭逝川	ks[xg xl[pk qq[hh bo[dp ku[kq ui[fz ir[pu
空憶謝將軍	ks[xg yi[xv xp[yu jl[dx jy[gi
空有羨魚情	ks[xg yz[uo xm[bd yu[dt qk[xf
空園白露滴	ks[xg yr[we bd[po lu[yz di[dl
空知返舊林	ks[xg vi[uk fj[pz jq[uo lb[aa
空中聞天雞	ks[xg vs[ku wf[me tm[hd ji[yn
孔子西行不到秦	ks[zv zi[lh xi[hk xk[rh bu[eu dc[hd qb[sh
扣關無僮僕	kz[fk gr[bt wu[ee ts[rl pu[rb
口角流沫右手胝	kz[uv jt[do lq[dw mo[dh yz[uk uz[su vi[ou
扣門無犬吠	kz[fk mf[du wu[ee qr[dd fw[kq
苦道來不易	ku[cg dc[bz ld[hm bu[eu yi[ob
苦恨年年壓金線	ku[cg hf[xg nm[rn nm[rn ya[it jb[rw xm[sj
枯桑老柏寒颼飀	ku[ag sh[ya lc[tb bd[ab hj[gd sz[fj lq[[
哭聲直上幹雲霄	ku[kq ug[um vi[uj uh[bh gj[hu yy[es xn[yx
枯松倒掛倚絕壁	ku[ag ss[ab dc[rh gx[ft yi[rd jt[sd bi[ut
苦心豈免容螻蟻	ku[cg xb[dv qi[uk mm[dk rs[xr lz[im yi[id
跨馬出郊時極目	kx[zd ma[vv iu[ck jn[le ui[oc ji[aj mu[we
快劍砍斷生蛟鼉	kk[xv jm[rd kj[ed dr[mj ug[pf jn[il to[kk
狂夫富貴在青春	kl[qw fu[er fu[gh gv[vb zd[ut qk[fo iy[so
況復秦兵耐苦戰	kl[dk fu[ro qb[sh bk[qb nd[ec ku[cg vj[bg
狂歌五柳前	kl[qw ge[kd wu[hu lq[ap qm[bo
況乃未休兵	kl[dk nd[vp ww[ha xq[ra bk[qb
況是蔡家親	kl[dk ui[op cd[cx jx[gu qb[la
況餘白首	kl[dk yu[re bd[po uz[be
愧君相訪頻	kv[xg jy[xk xl[am fh[yf pb[vy
愧君猶遣慎風波	kv[xg jy[xk yz[qy qm[vz uf[xu fg[ji bo[dp
窺室惟案几	kv[xe ui[gh ww[xv an[ga ji[pv
蠟炬成灰淚始幹	la[ig ju[hk ig[wv hv[uh lw[dm ui[ns gj[hu
蠟照半籠金翡翠	la[ig vc[od bj[bf ls[vy jb[rw fw[fx cv[xw
來從楚國遊	ld[hm cs[rr iu[ap go[ww yz[df
來對白頭吟	ld[hm dv[yc bd[po tz[dd yb[kr
來去九江側	ld[hm qu[ts jq[pv jl[dg ce[rb
來日綺窗前	ld[hm ri[wh qi[sd il[xp qm[bo
來如雷霆收震怒	ld[hm ru[nk lw[yt tk[yq uz[vw vf[yi nu[nx
來是空言去絕蹤	ld[hm ui[op ks[xg yj[we qu[ts jt[sd zs[zg
來途若夢行	ld[hm tu[rz ro[cu mg[ax xk[rh
來往不逢人	ld[hm wh[rd bu[eu fg[wz rf[pd
來舞魏宮前	ld[hm wu[rx ww[hg gs[gk qm[bo
賴茲託令門	ld[hd zi[by to[fp lk[rd mf[du
藍田日暖玉生煙	lj[cu tm[wu ri[wh nr[oa yu[wd ug[pf yj[hw
蘭葉春葳蕤	lj[bs ye[ku iy[so ww[cw rv[cu
攬衣推枕起徘徊	lj[fu yi[wy tv[fv vf[ag qi[zk pd[rf hk[rw
郎騎竹馬來	lh[le qi[md vu[rr ma[vv ld[hm
老病有孤舟	lc[tb bk[bh yz[uo gu[zp vz[pk
老大嫁作商人婦	lc[tb da[hr jx[ng zo[rv uh[lk rf[pd fu[nx
老夫不知其所往	lc[tb fu[er bu[eu vi[uk qi[cb so[pj wh[rd
老將行	lc[tb jl[dx xk[rh
老去戀明時	lc[tb qu[ts lm[yx mk[oo ui[oc
老至居人下	lc[tb vi[ht ju[ug rf[pd xx[hb
樂極哀來月東出	le[px ji[aj ai[wk ld[hm yt[ke ds[qx iu[ck
樂幽心屢止	le[px yz[yy xb[dv lv[um vi[uh
樂遊原上望昭陵	le[px yz[df yr[ib uh[bh wh[ww vc[od lk[et
雷鼓動山川	lw[yt gu[uu ds[el uj[uk ir[pu
淚溼羅巾夢不成	lw[dm ui[do lo[sx jb[ku mg[ax bu[eu ig[wv
李白	li[az bd[po
離杯惜共傳	li[wk bw[ab xi[xg gs[gb ir[re
離別正堪悲	li[wk bp[kd vg[hv kj[tq bw[fx
李端	li[az dr[lu
李端公	li[az dr[lu gs[bs
驪宮高處入青雲	li[mh gs[gk gc[wk iu[wb ru[pd qk[fo yy[es
李廣無功緣數奇	li[az gl[di wu[ee gs[gl yr[sv uu[mw qi[dk
梨花滿地不開門	li[ha hx[cr mj[dc di[ty bu[eu kd[hc mf[du
梨花一枝春帶雨	li[ha hx[cr yi[hh vi[au iy[so dd[cj yu[hk
理會是非遣	li[wo hv[re ui[op fw[su qm[vz
力盡關山未解圍	li[vp jb[ud gr[bt uj[uk ww[ha jp[dd ww[ww
離離原上草	li[wk li[wk yr[ib uh[bh cc[co
李頻	li[az pb[vy
李頎	li[az qi[jy
麗人行	li[hk rf[pd xk[rh
李商隱	li[az uh[lk yb[ed
吏舍局終年	li[hk ue[rg ju[uv vs[sw nm[rn
慄深林兮驚層巔	li[xa uf[dg lb[aa xi[bk jk[xw cg[ue dm[uu
李斯稅駕苦不早	li[az si[qj uv[hb jx[lm ku[cg bu[eu zc[ou
李益	li[az yi[bm
梨園子弟白髮新	li[ha yr[we zi[lh di[bg bd[po fa[vy xb[lj
梨園子弟散如煙	li[ha yr[we zi[lh di[bg sj[gw ru[nk yj[hw
利洲南渡	li[hd vz[dd nj[uk du[dg
聯步趨丹陛	lm[eb bu[vu qu[zd dj[kw bi[eb
蓮動下漁舟	lm[ci ds[el xx[hb yu[dy vz[pk
連峰去天不盈尺	lm[iz fg[uw qu[ts tm[hd bu[eu yk[nm ii[ud
憐君何事到天涯	lm[xr jy[xk he[rk ui[hk dc[hd tm[hd ya[di
連山接海隅	lm[iz uj[uk jp[fl hd[dr yu[eo
連山若波濤	lm[iz uj[uk ro[cu bo[dp tc[df
簾外春寒賜錦袍	lm[xj wd[xb iy[so hj[gd ci[bo jb[jb pc[yb
兩岸桃花夾古津	ll[hk an[ui tc[av hx[cr jx[hb gu[uk jb[dy
兩岸猿聲啼不住	ll[hk an[ui yr[qt ug[um ti[kl bu[eu vu[rd
兩別泣不休	ll[hk bp[kd qi[dl bu[eu xq[ra
兩朝開濟老臣心	ll[hk ic[uo kd[hc ji[dw lc[tb if[ku xb[dv
兩處茫茫皆不見	ll[hk iu[wb mh[cd mh[cd jp[bb bu[eu jm[ke
涼風起天末	ll[dw fg[ji qi[zk tm[hd mo[ha
梁父吟成恨有餘	ll[da fu[bi yb[kr ig[wv hf[xg yz[uo yu[ur
良人罷遠征	ll[dg rf[pd ba[st yr[ez vg[rh
良人玉勒乘驄馬	ll[dg rf[pd yu[wd le[gl ig[qb cs[mp ma[vv
良人昨夜情	ll[dg rf[pd zo[ov ye[wr qk[xf
兩三星火是瓜州	ll[hk sj[hh xk[op ho[dp ui[op gx[ps vz[dp
涼思	ll[dw si[tx
良相頭上進賢冠	ll[dg xl[am tz[dd uh[bh jb[ez xm[ub gr[ge
兩小無嫌猜	ll[hk xn[ub wu[ee xm[nb cd[qf
涼州詞	ll[dw vz[dp ci[yv
涼州胡人為我吹	ll[dw vz[dp hu[go rf[pd ww[dl wo[pf iv[kd
聊持寶劍動星文	ln[ep ii[ft bc[gw jm[rd ds[el xk[op wf[wi
潦倒新停濁酒杯	ln[dd dc[rh xb[lj tk[rw vo[di jq[dy bw[ab
遼東小婦年十五	ln[lz ds[qx xn[ub fu[nx nm[rn ui[hu wu[hu
寥落古行宮	ln[gx lo[cd gu[uk xk[rh gs[gk
寥落寒山對虛牖	ln[gx lo[cd hj[gd uj[uk dv[yc xu[hy yz[ph
聊書所懷	ln[ep uu[vv so[pj hk[xb
聊為劍器行	ln[ep ww[dl jm[rd qi[kq xk[rh
料知短兵不敢接	ln[md vi[uk dr[ud bk[qb bu[eu gj[vw jp[fl
列郡謳歌惜	lp[hd jy[xe ou[yk ge[kd xi[xg
烈女操	lp[hd nv[vp cc[fk
裂缺霹靂	lp[hy qt[pv pi[yu li[yi
林暗草驚風	lb[aa an[ol cc[co jk[xw fg[ji
林表明霽色	lb[aa bn[fy mk[oo ji[yw se[db
臨別殷勤重寄詞	lb[uv bp[kd yb[pj qb[nl is[ph ji[gd ci[yv
臨風聽暮蟬	lb[uv fg[ji tk[kj mu[co ij[ib
臨感忽難收	lb[uv gj[wx hu[bx nj[yv uz[vw
林昏瘴不開	lb[aa hy[uo vh[bl bu[eu kd[hc
臨邛道士鴻都客	lb[uv qs[ge dc[bz ui[uh hs[dn dz[te ke[gw
林臥愁春盡	lb[aa wo[kb iz[hx iy[so jb[ud
臨行密密縫	lb[uv xk[rh mi[gu mi[gu fg[sw
臨潁美人在白帝	lb[uv yk[by mw[bw rf[pd zd[ut bd[po di[lj
林月低向後	lb[aa yt[ke di[ru xl[pk hz[pk
令彼征斂者	lk[rd bi[rp vg[rh lm[rw ve[to
零淚緣纓流	lk[yr lw[dm yr[sv yk[sb lq[dw
泠泠七絃上	lk[dr lk[dr qi[hv xm[gw uh[bh
玲瓏望秋月	lk[wr ls[wy wh[ww qq[hh yt[ke
零落依草木	lk[yr lo[cd yi[ry cc[co mu[ub
嶺樹重遮千里目	lk[ur uu[ay vs[ph ve[gz qm[pu li[ot mu[we
嶺外音書絕	lk[ur wd[xb yb[lo uu[vv jt[sd
凌煙功臣少顏色	lk[dt yj[hw gs[gl if[ku uc[xp yj[ly se[db
嶺猿同旦暮	lk[ur yr[qt ts[kh dj[oh mu[co
柳邊人歇待船歸	lq[ap bm[lz rf[pd xp[od dd[rt ir[vj gv[ux
留別王侍御維	lq[pt bp[kd wh[su ui[rt yu[rw ww[sv
劉常卿	lq[wd ih[xk qk[pg
劉長卿	lq[wd ih[ph qk[pg
流傳漢地曲轉奇	lq[dw ir[re hj[dy di[ty qu[ou vr[ie qi[dk
劉方平	lq[wd fh[dw pk[hb
柳拂旌旗露未乾	lq[ap fu[ff jk[fr qi[fr lu[yz ww[ha gj[hu
六宮粉黛無顏色	lq[wb gs[gk ff[mf dd[rh wu[ee yj[ly se[db
劉脊虛	lq[wd ji[uo xu[hy
六軍不發無奈何	lq[wb jy[gi bu[eu fa[vy wu[ee nd[de he[rk
劉郎已恨蓬山遠	lq[wd lh[le yi[kv hf[xg pg[cw uj[uk yr[ez
瀏漓頓挫	lq[dw li[dw dy[ty co[fr
流落徵南將	lq[dw lo[cd vg[rh nj[uk jl[dx
六年西顧空吟哦	lq[wb nm[rn xi[hk gu[iy ks[xg yb[kr ee[kp
流水如有意	lq[dw uv[uu ru[nk yz[uo yi[lx
流水十年間	lq[dw uv[uu ui[hu nm[rn jm[mo
劉禹錫	lq[wd yu[pk xi[jo
柳中庸	lq[ap vs[ku ys[gx
柳宗元	lq[ap zs[ge yr[ee
留醉與山翁	lq[pt zv[yw yu[hv uj[uk wg[bx
龍池柳色雨中深	ls[yp ii[dy lq[ap se[db yu[hk vs[ku uf[dg
龍池十日飛霹靂	ls[yp ii[dy ui[hu ri[wh fw[vp pi[yu li[yi
龍媒去盡鳥呼風	ls[yp mw[ng qu[ts jb[ud nn[nh hu[kp fg[ji
隴上羊歸塞草煙	ls[ey uh[bh yh[bs gv[ux sd[gt cc[co yj[hw
龍吟虎嘯一時發	ls[yp yb[kr hu[hj xn[kx yi[hh ui[oc fa[vy
龍種自與常人殊	ls[yp vs[hv zi[pm yu[hv ih[xk rf[pd uu[hp
樓閣玲瓏五雲起	lz[am ge[mw lk[wr ls[wy wu[hu yy[es qi[zk
陋儒編詩不收入	lz[eh ru[ry bm[sh ui[yt bu[eu uz[vw ru[pd
樓上花枝笑獨眠	lz[am uh[bh hx[cr vi[au xn[vp du[qi mm[mm
露草覆寒蟲	lu[yz cc[co fu[xr hj[gd is[ks
路出寒雲外	lu[zw iu[ck hj[gd yy[es wd[xb
露從今夜白	lu[yz cs[rr jb[rd ye[wr bd[po
陸機雄才豈自保	lu[ef ji[aj xs[uv cd[hu qi[uk zi[pm bc[rk
盧家少婦鬱金香	lu[bu jx[gu uc[xp fu[nx yu[ue jb[rw xl[ho
盧綸	lu[bu ly[sr
鹿門月照開煙樹	lu[gb mf[du yt[ke vc[od kd[hc yj[hw uu[ay
路旁時賣故侯瓜	lu[zw ph[lf ui[oc md[ud gu[gw hz[rv gx[ps
虜騎崩騰畏蒺藜	lu[hl qi[md bg[uo tg[ob ww[th ji[cb li[ch
露氣寒光集	lu[yz qi[rh hj[gd gl[xe ji[va
虜騎聞之應膽懾	lu[hl qi[md wf[me vi[dv yk[gx dj[oo ue[xe
虜塞兵氣連雲屯	lu[hl sd[gt bk[qb qi[rh lm[iz yy[es ty[hk
廬山秀出南鬥傍	lu[gh uj[uk xq[hn iu[ck nj[uk dz[du bh[rl
廬山謠寄盧侍御虛舟	lu[gh uj[uk yc[ya ji[gd lu[bu ui[rt yu[rw xu[hy vz[pk
淥水盪漾清猿啼	lu[dx uv[uu dh[cd yh[db qk[df yr[qt ti[kl
路遠不可測	lu[zw yr[ez bu[eu ke[dk ce[db
露重飛難進	lu[yz vs[ph fw[vp nj[yv jb[ez
鸞刀縷切空紛綸	lr[yn dc[vp lv[sm qp[qd ks[xg ff[sf ly[sr
亂山殘雪夜	lr[qv uj[uk cj[hj xt[yx ye[wr
亂我心者	lr[qv wo[pf xb[dv ve[to
鸞翔鳳翥眾仙下	lr[yn xl[yx fg[jy vu[tx vs[rr xm[ru xx[hb
鑾輿迥出千門柳	lr[yj yu[pb js[kz iu[ck qm[pu mf[du lq[ap
論功還欲請長纓	ly[yr gs[gl hd[bz yu[bd qk[yf ih[ph yk[sb
輪臺城北旄頭落	ly[ir td[sk ig[tw bw[ub mc[fr tz[dd lo[cd
輪臺城頭夜吹角	ly[ir td[sk ig[tw tz[dd ye[wr iv[kd jn[do
輪臺東門送君去	ly[ir td[sk ds[qx mf[du ss[bz jy[xk qu[ts
輪臺歌奉送封大夫出師西征	ly[ir td[sk ge[kd fg[sf ss[bz fg[tc dd[hr fu[er iu[ck ui[uh xi[hk vg[rh
輪臺九月風夜吼	ly[ir td[sk jq[pv yt[ke fg[ji ye[wr hz[kz
駱賓王	lo[mw bb[gq wh[su
落帆逗淮鎮	lo[cd fj[jj dz[dz hk[dv vf[ju
落花	lo[cd hx[cr
落花時節又逢君	lo[cd hx[cr ui[oc jp[ce yz[vd fg[wz jy[xk
落落盤踞雖得地	lo[cd lo[cd pj[vm ju[zu sv[ki de[ro di[ty
落日故人情	lo[cd ri[wh gu[gw rf[pd qk[xf
落日滿秋山	lo[cd ri[wh mj[dc qq[hh uj[uk
落日五湖春	lo[cd ri[wh wu[hu hu[dg iy[so
邏娑沙塵哀怨生	lo[sz so[dn ua[dx if[xt ai[wk yr[xx ug[pf
絡緯秋啼金井闌	lo[sw ww[sw qq[hh ti[kl jb[rw jk[ep lj[mh
羅帷送上七香車	lo[sx ww[jv ss[bz uh[bh qi[hv xl[ho ie[qu
洛陽行子空嘆息	lo[dw yh[eo hh[rh zi[lh ks[xg tj[ky xi[zx
洛陽女兒對門居	lo[dw yh[eo nv[vp er[pv dv[yc mf[du ju[ug
洛陽女兒行	lo[dw yh[eo nv[vp er[pv xk[rh
洛陽親友如相問	lo[dw yh[eo qb[la yz[uy ru[nk xl[am wf[mk
落葉滿階紅不掃	lo[cd ye[ku mj[dc jp[er hs[sg bu[eu sc[fx
落葉滿空山	lo[cd ye[ku mj[dc ks[xg uj[uk
落葉秋風早	lo[cd ye[ku qq[hh fg[ji zc[ou
落葉人何在	lo[cd ye[ku rf[pd he[rk zd[ut
落葉他鄉樹	lo[cd ye[ku ta[ry xl[sp uu[ay
落葉添薪仰古槐	lo[cd ye[ku tm[dt xb[cl yh[rp gu[uk hk[ag
羅衣欲換更添香	lo[sx yi[wy yu[bd hr[fd gg[ho tm[dt xl[ho
落月滿屋樑	lo[cd yt[ke mj[dc wu[uh ll[da
旅館無良伴	lv[fr gr[ug wu[ee ll[dg bj[rb
屢貌尋常行路人	lv[um mc[pb xy[xc ih[xk xk[rh lu[zw rf[pd
綠樹村邊合	lv[sx uu[ay cy[ac bm[lz he[rh
旅宿	lv[fr su[gr
旅夜書懷	lv[fr ye[wr uu[vv hk[xb
綠蟻新醅酒	lv[sx yi[id xb[lj pw[yl jq[dy
綠竹入幽徑	lv[sx vu[rr ru[pd yz[yy jk[rs
馬戴	ma[vv dd[tt
馬官廝養森成列	ma[vv gr[gu si[iq yh[yp sf[aa ig[wv lp[hd
馬毛帶雪汗氣蒸	ma[vv mc[sv dd[cj xt[yx hj[dg qi[rh vg[cl
馬上相逢無紙筆	ma[vv uh[bh xl[am fg[wz wu[ee vi[su bi[vm
馬嵬坡下泥土中	ma[vv ww[ug po[tp xx[hb ni[du tu[uh vs[ku
馬蕭蕭	ma[vv xn[cx xn[cx
馬邑龍堆路幾千	ma[vv yi[kb ls[yp dv[tv lu[zw ji[pv qm[pu
漫卷詩書喜欲狂	mj[do jr[be ui[yt uu[vv xi[uk yu[bd kl[qw
漫叟以公田米釀酒	mj[do sz[jy yi[sr gs[bs tm[wu mi[ba nl[yl jq[dy
滿座重聞皆掩泣	mj[dc zo[gr vs[ph wf[me jp[bb yj[fd qi[dl
茫茫江漢上	mh[cd mh[cd jl[dg hj[dy uh[bh
茂陵不見封侯印	mc[cw lk[et bu[eu jm[ke fg[tc hz[rv yb[pe
茅亭宿花影	mc[cy tk[wd su[gr hx[cr yk[op
茅屋訪孤僧	mc[cy wu[uh fh[yf gu[zp sg[rb
沒蕃故人	mw[dj fj[cp gu[gw rf[pd
每逢佳節倍思親	mw[rm fg[wz jx[rt jp[ce bw[rl si[tx qb[la
美服患人指	mw[bw fu[oe hr[kx rf[pd vi[fb
美酒聊共揮	mw[bw jq[dy ln[ep gs[gb hv[fg
美酒一杯聲一曲	mw[bw jq[dy yi[hh bw[ab ug[um yi[hh qu[ou
梅柳渡江春	mw[ar lq[ap du[dg jl[dg iy[so
美人胡為隔秋水	mw[bw rf[pd hu[go ww[dl ge[eh qq[hh uv[uu
美人娟娟隔秋水	mw[bw rf[pd jr[nk jr[nk ge[eh qq[hh uv[uu
美人卷珠簾	mw[bw rf[pd jr[be vu[wp lm[xj
美人清江畔	mw[bw rf[pd qk[df jl[dg pj[tb
美人如花隔雲端	mw[bw rf[pd ru[nk hx[cr ge[eh yy[es dr[lu
美人相併立瓊軒	mw[bw rf[pd xl[am bk[bk li[lh qs[ww xr[ig
美人帳下猶歌舞	mw[bw rf[pd vh[ji xx[hb yz[qy ge[kd wu[rx
莓苔見履痕	mw[cr td[cs jm[ke lv[ur hf[bg
媚眼惟看宿鷺窠	mw[nm yj[mg ww[xv kj[fm su[gr lu[zn ke[xo
沒在石稜中	mw[dj zd[ut ui[ek lg[at vs[ku
每至夕照低陰	mw[rm vi[ht xi[xd vc[od di[ru yb[eo
每逐青溪水	mw[rm vu[uz qk[fo xi[da uv[uu
門前遲行跡	mf[du qm[bo ii[uz xk[rh ji[yz
門前冷落車馬稀	mf[du qm[bo lg[dr lo[cd ie[qu ma[vv xi[hi
門前學種先生柳	mf[du qm[bo xt[xz vs[hv xm[ne ug[pf lq[ap
捫參歷井仰脅息	mf[fm uf[sd li[il jk[ep yh[rp xp[ol xi[zx
門系釣魚船	mf[du xi[py dn[jb yu[dt ir[vj
孟浩然	mg[zm hc[dn rj[xd
夢魂不到關山難	mg[ax hy[eg bu[eu dc[hd gr[bt uj[uk nj[yv
猛將腰間大羽箭	mg[qz jl[dx yc[ox jm[mo da[hr yu[xx jm[vb
孟郊	mg[zm jn[le
夢李白二首之二	mg[ax li[az bd[po er[hh uz[be vi[dv er[hh
夢李白二首之一	mg[ax li[az bd[po er[hh uz[be vi[dv yi[hh
夢啼妝淚紅闌干	mg[ax ti[kl vl[dn lw[dm hs[sg lj[mh gj[hu
夢為遠別啼難喚	mg[ax ww[dl yr[ez bp[kd ti[kl nj[yv hr[kd
夢遊天姥吟留別	mg[ax yz[df tm[hd mu[nt yb[kr lq[pt bp[kd
宓妃留枕魏王才	mi[gx fw[nk lq[pt vf[ag ww[hg wh[su cd[hu
迷花不事君	mi[mz hx[cr bu[eu ui[hk jy[xk
迷花倚石忽已暝	mi[mz hx[cr yi[rd ui[ek hu[bx yi[kv mk[og
迷津欲有問	mi[mz jb[dy yu[bd yz[uo wf[mk
密雨斜侵薜荔牆	mi[gu yu[hk xp[rd qb[rx bi[cu li[cl ql[tt
廟內老人識神意	mn[gy nw[kr lc[tb rf[pd ui[yk uf[uo yi[lx
妙舞此曲神揚揚	mn[nx wu[rx ci[vb qu[ou uf[uo yh[fv yh[fv
滅燭憐光滿	mp[hh vu[hi lm[xr gl[xe mj[dc
黽勉空仰止	mb[ko mm[dl ks[xg yh[rp vi[uh
憫餘	mb[xm yu[ur
明朝掛帆席	mk[oo ic[uo gx[ft fj[jj xi[gn
明朝望鄉處	mk[oo ic[uo wh[ww xl[sp iu[wb
明朝有封事	mk[oo ic[uo yz[uo fg[tc ui[hk
名成八陣圖	mk[xk ig[wv ba[pd vf[ei tu[ww
冥冥孤高多烈風	mk[go mk[go gu[zp gc[wk do[xx lp[hd fg[ji
冥冥花正開	mk[go mk[go hx[cr vg[hv kd[hc
冥冥鳥去遲	mk[go mk[go nn[nh qu[ts ii[uz
冥冥日沈夕	mk[go mk[go ri[wh uf[dg xi[xd
明眸皓齒今何在	mk[oo mz[ms hc[bn ii[vr jb[rd he[rk zd[ut
明年	mk[oo nm[rn
明年秋	mk[oo nm[rn qq[hh
名豈文章著	mk[xk qi[uk wf[wi vh[lo vu[ct
明日巴陵道	mk[oo ri[wh ba[ku lk[et dc[bz
明日隔山嶽	mk[oo ri[wh ge[eh uj[uk yt[qu
明日歲華新	mk[oo ri[wh sv[ux hx[ru xb[lj
名屬教坊第一部	mk[xk uu[up jn[tw fh[tf di[vg yi[hh bu[le
明我長相憶	mk[oo wo[pf ih[ph xl[am yi[xv
明月出天山	mk[oo yt[ke iu[ck tm[hd uj[uk
明月來相照	mk[oo yt[ke ld[hm xl[am vc[od
命曰琵琶行	mk[rh yt[wh pi[wb pa[wb xk[rh
明月松間照	mk[oo yt[ke ss[ab jm[mo vc[od
明朝散發弄扁舟	mk[oo vc[uo sj[gw fa[vy ns[wc pm[hk vz[pk
明朝驛使發	mk[oo vc[uo yi[my ui[rh fa[vy
鳴箏金粟柱	mk[kn vg[vd jb[rw su[xm vu[ad
莫辭更坐彈一曲	mo[co ci[ql gg[ho zo[rr dj[gb yi[hh qu[ou
莫得同車歸	mo[co de[ro ts[kh ie[qu gv[ux
莫見長安行樂處	mo[co jm[ke ih[ph an[gn xk[rh le[px iu[wb
莫教枝上啼	mo[co jn[tw vi[au uh[bh ti[kl
莫買沃洲山	mo[co md[vd wo[dp vz[dd uj[uk
漠漠帆來重	mo[dc mo[dc fj[jj ld[hm vs[ph
漠漠水田飛白鷺	mo[dc mo[dc uv[uu tm[wu fw[vp bd[po lu[zn
莫是藁砧歸	mo[co ui[op gc[ca vf[eb gv[ux
莫使金樽空對月	mo[co ui[rh jb[rw zy[ab ks[xg dv[yc yt[ke
莫嫌舊日雲中守	mo[co xm[nb jq[uo ri[wh yy[es vs[ku uz[gc
莫學武陵人	mo[co xt[xz wu[hv lk[et rf[pd
莫學遊俠兒	mo[co xt[xz yz[df xx[rj er[pv
磨牙吮血	mo[ge ya[hv uy[ks xt[pm
暮從碧山下	mu[co cs[rr bi[we uj[uk xx[hb
木落雁南渡	mu[ub lo[cd yj[ir nj[uk du[dg
暮年詩賦動江關	mu[co nm[rn ui[yt fu[bw ds[el jl[dg gr[bt
暮去朝來顏色故	mu[co qu[ts vc[uo ld[hm yj[ly se[db gu[gw
暮惹御香歸	mu[co re[cx yu[rw xl[ho gv[ux
慕陶真可庶	mu[cx tc[eb vf[uj ke[dk uu[gn
牧童敲火牛礪角	mu[nw ts[lo qn[wb ho[dp nq[pf li[ei jn[do
暮雨相呼失	mu[co yu[hk xl[am hu[kp ui[pe
幕中草檄硯水凝	mu[cj vs[ku cc[co xi[ab yj[ej uv[uu nk[db
暮作吳宮妃	mu[co zo[rv wu[kt gs[gk fw[nk
那堪把剪刀	na[ve kj[tq ba[fb jm[bd dc[vp
那堪玄鬢影	na[ve kj[tq xr[wy bb[ig yk[op
那堪正飄泊	na[ve kj[tq vg[hv pn[xf bo[db
那聞舊人哭	na[ve wf[me jq[uo rf[pd ku[kq
奈何阻重深	nd[de he[rk zu[eq vs[ph uf[dg
乃作歌以長之	nd[vp zo[rv ge[kd yi[sr ih[ph vi[dv
男兒本自重橫行	nj[tl er[pv bf[ah zi[pm vs[ph hg[ag xk[rh
男兒事長征	nj[tl er[pv ui[hk ih[ph vg[rh
南冠客思侵	nj[uk gr[ge ke[gw si[tx qb[rx
南極老人應壽昌	nj[uk ji[aj lc[tb rf[pd yk[gx uz[fc ih[oo
南陵寓使遲	nj[uk lk[et yu[go ui[rh ii[uz
南浦清江萬里橋	nj[uk pu[df qk[df jl[dg wj[hv li[ot qn[ap
南山歸敝廬	nj[uk uj[uk gv[ux bi[bw lu[gh
南山截竹為篳篥	nj[uk uj[uk jp[tv vu[rr ww[dl bi[vb li[vx
內府殷紅瑪瑙盤	nw[kr fu[gr yj[pj hs[sg ma[wm nc[wv pj[vm
能以精誠致魂魄	ng[sb yi[sr jk[mf ig[yw vi[hw hy[eg po[bg
能飲一杯無	ng[sb yb[ud yi[hh bw[ab wu[ee
泥他沽酒拔金釵	ni[du ta[ry gu[dg jq[dy ba[fu jb[rw id[jy
擬託良媒益自傷	ni[fs to[fp ll[dg mw[ng yi[bm zi[pm uh[rr
霓為衣兮風為馬	ni[yj ww[dl yi[wy xi[bk fg[ji ww[dl ma[vv
年年越溪女	nm[rn nm[rn yt[zh xi[da nv[vp
年年戰骨埋荒外	nm[rn nm[rn vj[bg gu[ko md[to hl[cw wd[xb
輦前才人帶弓箭	nm[ei qm[bo cd[hu rf[pd dd[cj gs[kv jm[vb
年深豈免有缺畫	nm[rn uf[dg qi[uk mm[dk yz[uo qt[pv hx[ht
念天地之悠悠	nm[rx tm[hd di[ty vi[dv yz[rx yz[rx
年長色衰	nm[rn vh[ph se[db uk[wk
鳥飛不到吳天長	nn[nh fw[vp bu[eu dc[hd wu[kt tm[hd ih[ph
鳥亦罷其鳴	nn[nh yi[wy ba[st qi[cb mk[kn
凝絕不通聲漸歇	nk[db jt[sd bu[eu ts[sz ug[um jm[di xp[od
凝情自悄然	nk[db qk[xf zi[pm qn[xx rj[xd
牛渚西江夜	nq[pf vu[dt xi[hk jl[dg ye[wr
女樂餘姿映寒日	nv[vp yt[px yu[ur zi[dn yk[ok hj[gd ri[wh
女子今有行	nv[vp zi[lh jb[rd yz[uo xk[rh
偶逢佳士亦寫真	ou[ro fg[wz jx[rt ui[uh yi[wy xp[gh vf[uj
偶然值林叟	ou[ro rj[xd vi[ru lb[aa sz[jy
偶似山林客	ou[ro si[rs uj[uk lb[aa ke[gw
嘔啞嘲哳難為聽	ou[kk ya[kh vc[ku va[kf nj[yv ww[dl tk[kj
排空馭氣奔如電	pd[ff ks[xg yu[my qi[rh bf[du ru[nk dm[ov
盤賜將軍拜舞歸	pj[vm ci[bo jl[dx jy[gi bd[fh wu[rx gv[ux
判司卑官不堪說	pj[bd si[vh bw[bu gr[gu bu[eu kj[tq uo[yb
盤飧市遠無兼味	pj[vm sy[xr ui[wj yr[ez wu[ee jm[bh ww[kh
潘岳悼亡猶費詞	pj[dp yt[qu dc[xb wh[wv yz[qy fw[fb ci[yv
袍褲宮人掃御床	pc[yb ku[yg gs[gk rf[pd sc[fx yu[rw il[ga
裴迪	pw[fy di[yz
佩聲歸向鳳池頭	pw[rj ug[um gv[ux xl[pk fg[jy ii[dy tz[dd
噴雲洩霧藏半腹	pf[ku yy[es xp[dn wu[yw ch[cw bj[bf fu[or
蓬萊此去無多路	pg[cw ld[cl ci[vb qu[ts wu[ee do[xx lu[zw
蓬萊宮中日月長	pg[cw ld[cl gs[gk vs[ku ri[wh yt[ke ih[ph
蓬萊文章建安骨	pg[cw ld[cl wf[wi vh[lo jm[yj an[gn gu[ko
蓬門今始為君開	pg[cw mf[du jb[rd ui[ns ww[dl jy[xk kd[hc
蓬門未識綺羅香	pg[cw mf[du ww[ha ui[yk qi[sd lo[sx xl[ho
烹羊宰牛且為樂	pg[wd yh[bs zd[gl nq[pf qp[ke ww[dl le[px
琵琶聲停欲語遲	pi[wb pa[wb ug[um tk[rw yu[bd yu[yw ii[uz
琵琶行並序	pi[wb pa[wb xk[rh bk[bk xu[gy
披衣覺露滋	pi[fp yi[wy jt[xj lu[yz zi[db
偏驚物候新	pm[rh jk[xw wu[nb hz[ru xb[lj
片影獨何之	pm[pu yk[op du[qi he[rk vi[dv
漂泊西南天地間	pn[dx bo[db xi[hk nj[uk tm[hd di[ty jm[mo
飄飄何所似	pn[xf pn[xf he[rk so[pj si[rs
貧儉誠所尚	pb[fb jm[rr ig[yw so[pj uh[xk
貧賤夫妻百事哀	pb[fb jm[bj fu[er qi[hn bd[eo ui[hk ai[wk
貧賤江頭自浣紗	pb[fb jm[bj jl[dg tz[dd zi[pm hr[dg ua[sx
頻年不解兵	pb[vy nm[rn bu[eu jp[dd bk[qb
貧女	pb[fb nv[vp
屏風九疊雲錦張	pk[ub fg[ji jq[pv dp[yq yy[es jb[jb vh[gi
平海夕漫漫	pk[hb hd[dr xi[xd mj[do mj[do
憑君傳語報平安	pk[rj jy[xk ir[re yu[yw bc[fe pk[hb an[gn
平明吹笛大軍行	pk[hb mk[oo iv[kd di[vy da[hr jy[gi xk[rh
平明閭巷掃花開	pk[hb mk[oo lv[mk xl[gk sc[fx hx[cr kd[hc
平明騎馬入宮門	pk[hb mk[oo qi[md ma[vv ru[pd gs[gk mf[du
平明送客楚山孤	pk[hb mk[oo ss[bz ke[gw iu[ap uj[uk gu[zp
平明尋白羽	pk[hb mk[oo xy[xc bd[po yu[xx
平沙莽莽黃入天	pk[hb ua[dx mh[cq mh[cq hl[gy ru[pd tm[hd
平沙日未沒	pk[hb ua[dx ri[wh ww[ha mw[dj
平生自有分	pk[hb ug[pf zi[pm yz[uo ff[bd
憑軒涕泗流	pk[rj xr[ig ti[db si[ds lq[dw
平陽歌舞新承寵	pk[hb yh[eo ge[kd wu[rx xb[lj ig[lu is[gy
頗得清淨理	po[py de[ro qk[df jk[dd li[wo
破邵	po[ep uc[de
迫之如火煎	po[bz vi[dv ru[nk ho[dp jm[bd
鋪床拂席置羹飯	pu[jf il[ga fu[ff xi[gn vi[su gg[bb fj[up
僕失路艱虞	pu[rb ui[pe lu[zw jm[yg yu[hk
浦樹遠含滋	pu[df uu[ay yr[ez hj[rk zi[db
葡萄美酒夜光杯	pu[cb tc[cb mw[bw jq[dy ye[wr gl[xe bw[ab
豈必局束為人鞿	qi[uk bi[xp ju[uv uu[hk ww[dl rf[pd ji[[
豈不如賊焉	qi[uk bu[eu ru[nk zw[bg yj[hh
七層摩蒼穹	qi[hv cg[ue mo[gf ch[cr qs[xg
豈非正直能感通	qi[uk fw[su vg[hv vi[uj ng[sb gj[wx ts[sz
其間旦暮聞何物	qi[cb jm[mo dj[oh mu[co wf[me he[rk wu[nb
豈力能制敵歟	qi[uk li[vp ng[sb vi[nd di[qw yu[hd
淒涼寶劍篇	qi[dh ll[dw bc[gw jm[rd pm[vh
淒涼蜀故妓	qi[dh ll[dw uu[sb gu[gw ji[nu
齊魯青未了	qi[wp lu[yo qk[fo ww[ha ln[vu
其年始改稱元和	qi[cb nm[rn ui[ns gd[kw ig[hd yr[ee he[hk
悽悽不似向前聲	qi[dh qi[dh bu[eu si[rs xl[pk qm[bo ug[um
萋萋滿別情	qi[ch qi[ch mj[dc bp[kd qk[xf
悽悽去親愛	qi[dh qi[dh qu[ts qb[la ai[au
豈人	qi[uk rf[pd
豈上望夫臺	qi[uk uh[bh wh[ww fu[er td[sk
其所師	qi[cb so[pj ui[uh
岐王宅裡尋常見	qi[uu wh[su vd[gp li[ot xy[xc ih[xk jm[ke
棄我去者	qi[wc wo[pf qu[ts ve[to
綦毋潛	qi[qy wu[vv qm[de
豈無山歌與村笛	qi[uk wu[ee uj[uk ge[kd yu[hv cy[ac di[vy
其險也如此	qi[cb xm[er ye[vu ru[nk ci[vb
豈向人間住	qi[uk xl[pk rf[pd jm[mo vu[rd
七言古詩	qi[hv yj[we gu[uk ui[yt
七言絕句	qi[hv yj[we jt[sd ju[bk
豈伊地氣暖	qi[uk yi[rx di[ty qi[rh nr[oa
豈宜重問後庭花	qi[uk yi[gq vs[ph wf[mk hz[pk tk[gq hx[cr
其由來	qi[cb yz[ou ld[hm
其餘七匹亦殊絕	qi[cb yu[re qi[hv pi[ke yi[wy uu[hp jt[sd
豈曰財賦強	qi[uk yt[wh cd[bc fu[bw ql[gk
七月七日長生殿	qi[hv yt[ke qi[hv ri[wh ih[ph ug[pf dm[uj
氣蒸雲夢澤	qi[rh vg[cl yy[es mg[ax ze[dy
其中綽約多仙子	qi[cb vs[ku io[sb yt[sb do[xx xm[ru zi[lh
遣悲懷三首之二	qm[vz bw[fx hk[xb sj[hh uz[be vi[dv er[hh
遣悲懷三首之三	qm[vz bw[fx hk[xb sj[hh uz[be vi[dv sj[hh
遣悲懷三首之一	qm[vz bw[fx hk[xb sj[hh uz[be vi[dv yi[hh
前不見古人	qm[bo bu[eu jm[ke gu[uk rf[pd
千村萬落生荊杞	qm[pu cy[ac wj[hv lo[cd ug[pf jk[cd qi[ak
千呼萬喚始出來	qm[pu hu[kp wj[hv hr[kd ui[ns iu[ck ld[hm
鉛華不可棄	qm[jj hx[ru bu[eu ke[dk qi[wc
千喚不一回	qm[pu hr[kd bu[eu yi[hh hv[wk
千金裘	qm[pu jb[rw qq[hy
千金散盡還復來	qm[pu jb[rw sj[gw jb[ud hr[bz fu[ro ld[hm
乾坤日夜浮	qm[ur ky[to ri[wh ye[wr fu[da
千里其如何	qm[pu li[ot qi[cb ru[nk he[rk
牽蘿補茅屋	qm[dg lo[cs bu[yb mc[cy wu[uh
前年伐月支	qm[bo nm[rn fa[rg yt[ke vi[uy
錢起	qm[jj qi[zk
千秋尚凜然	qm[pu qq[hh uh[xk lb[dw rj[xd
千秋萬歲名	qm[pu qq[hh wj[hv sv[ux mk[xk
千山鳥飛絕	qm[pu uj[uk nn[nh fw[vp jt[sd
千山響杜鵑	qm[pu uj[uk xl[kp du[at jr[kn
千乘萬騎西南行	qm[pu ug[qb wj[hv qi[md xi[hk nj[uk xk[rh
千樹萬樹梨花開	qm[pu uu[ay wj[hv uu[ay li[ha hx[cr kd[hc
潛心默禱若有應	qm[de xb[dv mo[hq dc[uf ro[cu yz[uo yk[gx
千尋鐵鎖沈江底	qm[pu xy[xc tp[jp so[jx uf[dg jl[dg di[gu
千巖萬壑路不定	qm[pu yj[ue wj[hv he[bt lu[zw bu[eu dk[gp
牽衣頓足攔道哭	qm[dg yi[wy dy[ty zu[kv lj[fb dc[bz ku[kq
千營共一呼	qm[pu yk[ck gs[gb yi[hh hu[kp
乾元初從左拾遺移華州掾	qm[ur yr[ee iu[yd cs[rr zo[ug ui[fr yi[vz yi[hx hx[ru vz[dp yr[fv
前月浮樑買茶去	qm[bo yt[ke fu[da ll[da md[vd ia[cr qu[ts
千載琵琶作胡語	qm[pu zd[ti pi[wb pa[wb zo[rv hu[go yu[yw
將進酒	ql[dx jb[ez jq[dy
羌戎賀勞旋	ql[yv rs[gu he[lb lc[cl xr[fr
強移棲息一枝安	ql[gk yi[hx qi[ax xi[zx yi[hh vi[au an[gn
強欲從君無那老	ql[gk yu[bd cs[rr jy[xk wu[ee na[ve lc[tb
樵客初傳漢姓名	qn[av ke[gw iu[yd ir[re hj[dy xk[np mk[xk
樵人歸欲盡	qn[av rf[pd gv[ux yu[bd jb[ud
妾發初覆額	qp[ln fa[vy iu[yd fu[xr ee[gy
且放白鹿青崖間	qp[ke fh[fw bd[po lu[gb qk[fo ya[ui jm[mo
且樂生前一杯酒	qp[ke le[px ug[pf qm[bo yi[hh bw[ab jq[dy
且如今年冬	qp[ke ru[nk jb[rd nm[rn ds[wd
且為王孫立斯須	qp[ke ww[dl wh[su sy[zx li[lh si[qj xu[py
竊聞天子已傳位	qp[xq wf[me tm[hd zi[lh yi[kv ir[re ww[rl
妾心井中水	qp[ln xb[dv jk[ep vs[ku uv[uu
且欲竟尋彭澤宰	qp[ke yu[bd jk[lo xy[xc pg[up ze[dy zd[gl
妾住在橫塘	qp[ln vu[rd zd[ut hg[ag th[tg
秦地羅敷女	qb[sh di[ty lo[sx fu[fw nv[vp
琴歌	qb[wr ge[kd
親朋無一字	qb[la pg[oo wu[ee yi[hh zi[gz
秦桑低綠枝	qb[sh sh[ya di[ru lv[sx vi[au
秦韜玉	qb[sh tc[wa yu[wd
琴心三疊道初成	qb[wr xb[dv sj[hh dp[yq dc[bz iu[yd ig[wv
秦中感秋寄遠上人	qb[sh vs[ku gj[wx qq[hh ji[gd yr[ez uh[bh rf[pd
青靄入看無	qk[fo ai[yy ru[pd kj[fm wu[ee
清晨入古寺	qk[df if[oi ru[pd gu[uk si[tc
清晨再拜鋪丹墀	qk[df if[oi zd[hk bd[fh pu[jf dj[kw ii[tu
清川帶長薄	qk[df ir[pu dd[cj ih[ph bo[cd
清川澹如此	qk[df ir[pu dj[dd ru[nk ci[vb
晴川歷歷漢陽樹	qk[of ir[pu li[il li[il hj[dy yh[eo uu[ay
晴翠接荒城	qk[of cv[xw jp[fl hl[cw ig[tw
清風吹空月舒波	qk[df fg[ji iv[kd ks[xg yt[ke uu[ry bo[dp
青楓江上秋帆遠	qk[fo fg[af jl[dg uh[bh qq[hh fj[jj yr[ez
青楓葉赤天雨霜	qk[fo fg[af ye[ku ii[ty tm[hd yu[hk ul[ya
清光猶為君	qk[df gl[xe yz[qy ww[dl jy[xk
晴光轉綠蘋	qk[of gl[xe vr[ie lv[sx pk[cp
青海頭	qk[fo hd[dr tz[dd
清淮奉使千餘裡	qk[df hk[dv fg[sf ui[rh qm[pu yu[ur li[ot
青槐夾馳道	qk[fo hk[ag jx[hb ii[my dc[bz
清輝淡水木	qk[df hv[xg dj[dh uv[uu mu[ub
清輝玉臂寒	qk[df hv[xg yu[wd bi[uo hj[gd
清輝照衣裳	qk[df hv[xg vc[od yi[wy uh[xy
請君試問東流水	qk[yf jy[xk ui[yq wf[mk ds[qx lq[dw uv[uu
請君為我側耳聽	qk[yf jy[xk ww[dl wo[pf ce[rb er[hu tk[kj
請留盤石上	qk[yf lq[pt pj[vm ui[ek uh[bh
輕攏慢捻抹復挑	qk[is ls[fy mj[xo nm[fr mo[fh fu[ro tn[fv
青樓自管絃	qk[fo lz[am zi[pm gr[vg xm[gw
青蘿拂行衣	qk[fo lo[cs fu[ff xk[rh yi[wy
青冥浩蕩不見底	qk[fo mk[go hc[dn dh[cd bu[eu jm[ke di[gu
清明日宴梅道士房	qk[df mk[oo ri[wh yj[go mw[ar dc[bz ui[uh fh[hf
青泥何盤盤	qk[fo ni[du he[rk pj[vm pj[vm
青鳥飛去銜紅巾	qk[fo nn[nh fw[vp qu[ts xm[rj hs[sg jb[ku
青鳥殷勤為探看	qk[fo nn[nh yb[pj qb[nl ww[dl tj[fg kj[fm
情親見君意	qk[xf qb[la jm[ke jy[xk yi[lx
清秋幕府井梧寒	qk[df qq[hh mu[cj fu[gr jk[ep wu[aw hj[gd
清泉石上流	qk[df qr[bu ui[ek uh[bh lq[dw
情人怨遙夜	qk[xf rf[pd yr[xx yc[az ye[wr
清瑟怨遙夜	qk[df se[wx yr[xx yc[az ye[wr
青山澹吾慮	qk[fo uj[uk dj[dd wu[wk lv[hx
青山獨歸遠	qk[fo uj[uk du[qi gv[ux yr[ez
青山郭外斜	qk[fo uj[uk go[we wd[xb xp[rd
青山橫北郭	qk[fo uj[uk hg[ag bw[ub go[we
青山空復情	qk[fo uj[uk ks[xg fu[ro qk[xf
青山空向人	qk[fo uj[uk ks[xg xl[pk rf[pd
青山朝別暮還見	qk[fo uj[uk vc[uo bp[kd mu[co hd[bz jm[ke
輕生一劍知	qk[is ug[pf yi[hh jm[rd vi[uk
清時有味是無能	qk[df ui[oc yz[uo ww[kh ui[op wu[ee ng[sb
青松如膏沐	qk[fo ss[ab ru[nk gc[wk mu[da
青天無片雲	qk[fo tm[hd wu[ee pm[pu yy[es
蜻蜓飛上玉搔頭	qk[if tk[iq fw[vp uh[bh yu[wd sc[fy tz[dd
輕紈細綺相追飛	qk[is wj[sj xi[st qi[sd xl[am vv[pz fw[vp
清渭東流劍閣深	qk[df ww[dt ds[qx lq[dw jm[rd ge[mw uf[dg
清畏人知	qk[df ww[th rf[pd vi[uk
青溪	qk[fo xi[da
青溪幾曲到雲林	qk[fo xi[da ji[pv qu[ou dc[hd yy[es lb[aa
清溪深不測	qk[df xi[da uf[dg bu[eu ce[db
清心拂塵服	qk[df xb[dv fu[ff if[xt fu[oe
輕煙散入五侯家	qk[is yj[hw sj[gw ru[pd wu[hu hz[rv jx[gu
青陽逼歲除	qk[fo yh[eo bi[hz sv[ux iu[er
清月出嶺光入扉	qk[df yt[ke iu[ck lk[ur gl[xe ru[pd fw[hf
青雲羨鳥飛	qk[fo yy[es xm[bd nn[nh fw[vp
輕舟已過萬重山	qk[is vz[pk yi[kv go[cz wj[hv is[ph uj[uk
請奏鳴琴廣陵客	qk[yf zz[st mk[kn qb[wr gl[di lk[et ke[gw
窮邊有客遊	qs[xl bm[lz yz[uo ke[gw yz[df
窮巷牛羊歸	qs[xl xl[gk nq[pf yh[bs gv[ux
秋邊一雁聲	qq[hh bm[lz yi[hh yj[ir ug[um
秋草獨尋人去後	qq[hh cc[co du[qi xy[xc rf[pd qu[ts hz[pk
秋蟬疏引	qq[hh ij[ib uu[pw yb[gu
秋登蘭山寄張五	qq[hh dg[dd lj[bs uj[uk ji[gd vh[gi wu[hu
秋風吹不盡	qq[hh fg[ji iv[kd bu[eu jb[ud
秋風忽憶江東行	qq[hh fg[ji hu[bx yi[xv jl[dg ds[qx xk[rh
秋歌	qq[hh ge[kd
秋花落更遲	qq[hh hx[cr lo[cd gg[ho ii[uz
秋來未著花	qq[hh ld[hm ww[ha vu[ct hx[cr
丘巒崩摧	qq[jh lr[yu bg[uo cv[fu
秋日登吳公臺上寺遠眺	qq[hh ri[wh dg[dd wu[kt gs[bs td[sk uh[bh si[tc yr[ez tn[mv
秋日赴闕題潼關驛樓	qq[hh ri[wh fu[zb qt[mn ti[oy ts[dl gr[bt yi[my lz[am
秋日望鄉心	qq[hh ri[wh wh[ww xl[sp xb[dv
秋色從西來	qq[hh se[db cs[rr xi[hk ld[hm
秋山又幾重	qq[hh uj[uk yz[vd ji[pv is[ph
秋水日潺湲	qq[hh uv[uu ri[wh ij[du yr[[
邱為	qq[qe ww[dl
虯鬚虎眉仍大顙	qq[iv xu[py hu[hj mw[mm rg[rn da[hr sh[yy
秋雁又南迴	qq[hh yj[ir yz[vd nj[uk hv[wk
秋夜寄邱員外	qq[hh ye[wr ji[gd qq[qe yr[kb wd[xb
秋雨梧桐葉落時	qq[hh yu[hk wu[aw ts[ak ye[ku lo[cd ui[oc
秋月春風等閒度	qq[hh yt[ke iy[so fg[ji dg[vt xm[ma du[gn
秋雲暗幾重	qq[hh yy[es an[ol ji[pv is[ph
曲罷曾教善才服	qu[ou ba[st cg[bo jn[tw uj[yk cd[hu fu[oe
曲罷憫然	qu[ou ba[st mb[xm rj[xd
驅車登古原	qu[mk ie[qu dg[dd gu[uk yr[ib
取代幽憂云爾	qu[ey dd[rq yz[yy yz[xy yy[es er[dx
曲島蒼茫接翠微	qu[ou dc[nu ch[cr mh[cd jp[fl cv[xw ww[ru
驅兒羅酒漿	qu[mk er[pv lo[sx jq[dy jl[du
曲盡河星稀	qu[ou jb[ud he[dk xk[op xi[hi
曲徑通幽處	qu[ou jk[rs ts[sz yz[yy iu[wb
去來江口守空船	qu[ts ld[hm jl[dg kz[uv uz[gc ks[xg ir[vj
去年花裡逢君別	qu[ts nm[rn hx[cr li[ot fg[wz jy[xk bp[kd
去世法舟輕	qu[ts ui[nv fa[dt vz[pk qk[is
去時冠劍是丁年	qu[ts ui[oc gr[ge jm[rd ui[op dk[hu nm[rn
去時里正與裹頭	qu[ts ui[oc li[ot vg[hv yu[hv go[wo tz[dd
去時雪滿天山路	qu[ts ui[oc xt[yx mj[dc tm[hd uj[uk lu[zw
瞿塘石城草蕭瑟	qu[mv th[tg ui[ek ig[tw cc[co xn[cx se[wx
瞿塘灩預堆	qu[mv th[tg yj[df yu[yy dv[tv
趣途無百里	qu[ze tu[rz wu[ee bd[eo li[ot
屈原終投湘水濱	qu[ui yr[ib vs[sw tz[fj xl[da uv[uu bb[dg
曲終收撥當心畫	qu[ou vs[sw uz[vw bo[fv dh[xx xb[dv hx[ht
去住彼此無消息	qu[ts vu[rd bi[rp ci[vb wu[ee xn[dx xi[zx
權德輿	qr[ay de[ru yu[pb
泉壑帶茅茨	qr[bu he[bt dd[cj mc[cy ci[cd
泉聲咽危石	qr[bu ug[um yj[kw ww[de ui[ek
勸我識作石鼓歌	qr[yl wo[pf ui[yk zo[rv ui[ek gu[uu ge[kd
泉源在庭戶	qr[bu yr[di zd[ut tk[gq hu[du
卻顧所來徑	qt[te gu[iy so[pj ld[hm jk[rs
卻看妻子愁何在	qt[te kj[fm qi[hn zi[lh iz[hx he[rk zd[ut
闕題	qt[mn ti[oy
卻下水晶簾	qt[te xx[hb uv[uu jk[oo lm[xj
卻嫌脂粉汙顏色	qt[te xm[nb vi[ob ff[mf wu[dh yj[ly se[db
卻坐促弦弦轉急	qt[te zo[rr cu[rz xm[gw xm[gw vr[ie ji[dx
群壑倏已暝	qy[xy he[bt uu[ru yi[kv mk[og
群山萬壑赴荊門	qy[xy uj[uk wj[hv he[bt fu[zb jk[cd mf[du
群彥今汪洋	qy[xy yj[lp jb[rd wh[dw yh[dy
然後天梯石棧方鉤連	rj[xd hz[pk tm[hd ti[ab ui[ek vj[aj fh[dw gz[jb lm[iz
苒苒幾盈虛	rj[ck rj[ck ji[pv yk[nm xu[hy
繞船月明江水寒	rc[sq ir[vj yt[ke mk[oo jl[dg uv[uu hj[gd
繞床弄青梅	rc[sq il[ga ns[wc qk[fo mw[ar
繞弦風雨哀	rc[sq xm[gw fg[ji yu[hk ai[wk
人歸暮雪時	rf[pd gv[ux mu[co xt[yx ui[oc
人歸山郭暗	rf[pd gv[ux uj[uk go[we an[ol
人間亦自有丹丘	rf[pd jm[mo yi[wy zi[pm yz[uo dj[kw qq[jh
人間又見真乘黃	rf[pd jm[mo yz[vd jm[ke vf[uj ig[qb hl[gy
人看隘若耶	rf[pd kj[fm ai[eb ro[cu ye[ee
人貧傷可憐	rf[pd pb[fb uh[rr ke[dk lm[xr
人生不相見	rf[pd ug[pf bu[eu xl[am jm[ke
人生得意須盡歡	rf[pd ug[pf de[ro yi[lx xu[py jb[ud hr[yd
人生如此自可樂	rf[pd ug[pf ru[nk ci[vb zi[pm ke[dk le[px
人生由命非由他	rf[pd ug[pf yz[ou mk[rh fw[su yz[ou ta[ry
人生有情淚沾臆	rf[pd ug[pf yz[uo qk[xf lw[dm vj[db yi[ol
人生在世不稱意	rf[pd ug[pf zd[ut ui[nv bu[eu if[hd yi[lx
忍使驊騮氣凋喪	rf[dx ui[rh hx[mr lq[mp qi[rh dn[dk sh[ty
人世幾回傷往事	rf[pd ui[nv ji[pv hv[wk uh[rr wh[rd ui[hk
人事音書漫寂寥	rf[pd ui[hk yb[lo uu[vv mj[do ji[gu ln[gx
人事有代謝	rf[pd ui[hk yz[uo dd[rq xp[yu
人誰感至精	rf[pd uv[yv gj[wx vi[ht jk[mf
人隨沙路向江村	rf[pd sv[eu ua[dx lu[zw xl[pk jl[dg cy[ac
仁恤庶無尤	rf[re xu[xp uu[gn wu[ee yz[yd
人在木蘭舟	rf[pd zd[ut mu[ub lj[bs vz[pk
仍憐故鄉水	rg[rn lm[xr gu[gw xl[sp uv[uu
日出霧露餘	ri[wh iu[ck wu[yw lu[yz yu[ur
日出雲中雞犬喧	ri[wh iu[ck yy[es vs[ku ji[yn qr[dd xr[kg
日高花影重	ri[wh gc[wk hx[cr yk[op is[ph
日光斜照集靈臺	ri[wh gl[xe xp[rd vc[od ji[va lk[xh td[sk
日暮復何之	ri[wh mu[co fu[ro he[rk vi[dv
日暮漢宮傳蠟燭	ri[wh mu[co hj[dy gs[gk ir[re la[ig vu[hi
日暮客愁新	ri[wh mu[co ke[gw iz[hx xb[lj
日暮聊為梁父吟	ri[wh mu[co ln[ep ww[dl ll[da fu[bi yb[kr
日暮鄉關何處是	ri[wh mu[co xl[sp gr[bt he[rk iu[wb ui[op
日暮掩柴扉	ri[wh mu[co yj[fd id[va fw[hf
日暮倚修竹	ri[wh mu[co yi[rd xq[ru vu[rr
日色才臨仙掌動	ri[wh se[db cd[hu lb[uv xm[ru vh[xf ds[el
日色冷青松	ri[wh se[db lg[dr qk[fo ss[ab
日色已盡花含煙	ri[wh se[db yi[kv jb[ud hx[cr hj[rk yj[hw
日夕懷空意	ri[wh xi[xd hk[xb ks[xg yi[lx
日夕涼風至	ri[wh xi[xd ll[dw fg[ji vi[ht
日夕望君抱琴至	ri[wh xi[xd wh[ww jy[xk bc[fb qb[wr vi[ht
日銷月鑠就埋沒	ri[wh xn[jx yt[ke uo[jp jq[wy md[to mo[dj
日晏猶得眠	ri[wh yj[og yz[qy de[ro mm[mm
日夜經過趙李家	ri[wh ye[wr jk[ss go[cz vc[zi li[az jx[gu
日月照耀金銀臺	ri[wh yt[ke vc[od yc[xx jb[rw yb[jg td[sk
戎馬關山北	rs[gu ma[vv gr[bt uj[uk bw[ub
容止順其猷	rs[xr vi[uh uy[iy qi[cb yz[bq
入蔡縛賊獻太廟	ru[pd cd[cx fu[sf zw[bg xm[uq td[dd mn[gy
如此至寶存豈多	ru[nk ci[vb vi[ht bc[gw cy[uz qi[uk do[xx
汝從事愈宜為辭	ru[dn cs[rr ui[hk yu[rx yi[gq ww[dl ci[ql
濡染大筆何淋漓	ru[dy rj[da da[hr bi[vm he[rk lb[da li[dw
如聽萬壑松	ru[nk tk[kj wj[hv he[bt ss[ab
如聽仙樂耳暫明	ru[nk tk[kj xm[ru yt[px er[hu zj[io mk[oo
若非巾柴車	ro[cu fw[su jb[ku id[va ie[qu
若負平生志	ro[cu fu[db pk[hb ug[pf vi[ux
颯颯東風細雨來	sa[lf sa[lf ds[qx fg[ji xi[st yu[hk ld[hm
塞上曲	sd[gt uh[bh qu[ou
塞下曲	sd[gt xx[hb qu[ou
塞下曲四首之二	sd[gt xx[hb qu[ou si[we uz[be vi[dv er[hh
塞下曲四首之三	sd[gt xx[hb qu[ou si[we uz[be vi[dv sj[hh
塞下曲四首之四	sd[gt xx[hb qu[ou si[we uz[be vi[dv si[we
塞下曲四首之一	sd[gt xx[hb qu[ou si[we uz[be vi[dv yi[hh
三邊曙色動危旌	sj[hh bm[lz uu[os se[db ds[el ww[de jk[fr
散步詠涼天	sj[gw bu[vu ys[kd ll[dw tm[hd
三春白雪歸青冢	sj[hh iy[so bd[po xt[yx gv[ux qk[fo vs[gu
散發乘夜涼	sj[gw fa[vy ig[qb ye[wr ll[dw
三分割據紆籌策	sj[hh ff[bd ge[gd ju[fu yu[se iz[vf ce[vc
三顧頻煩天下計	sj[hh gu[iy pb[vy fj[hy tm[hd xx[hb ji[yu
三晉雲山皆北向	sj[hh jb[ho yy[es uj[uk jp[bb bw[ub xl[pk
三徑苦無資	sj[hh jk[rs ku[cg wu[ee zi[db
三軍大呼陰山動	sj[hh jy[gi da[hr hu[kp yb[eo uj[uk ds[el
三年謫宦此棲遲	sj[hh nm[rn ve[yl hr[gk ci[vb qi[ax ii[uz
三千寵愛在一身	sj[hh qm[pu is[gy ai[au zd[ut yi[hh uf[pu
三日入廚下	sj[hh ri[wh ru[pd iu[id xx[hb
散入珠簾溼羅幕	sj[gw ru[pd vu[wp lm[xj ui[do lo[sx mu[cj
三峽樓臺淹日月	sj[hh xx[uj lz[am td[sk yj[dd ri[wh yt[ke
三峽星河影動搖	sj[hh xx[uj xk[op he[dk yk[op ds[el yc[fa
三湘愁鬢逢秋色	sj[hh xl[da iz[hx bb[ig fg[wz qq[hh se[db
三夜頻夢君	sj[hh ye[wr pb[vy mg[ax jy[xk
三月三日天氣新	sj[hh yt[ke sj[hh ri[wh tm[hd qi[rh xb[lj
三朝出入榮	sj[hh vc[uo iu[ck ru[pd rs[ca
色靜深松裡	se[db jk[fd uf[dg ss[ab li[ot
色難腥腐餐楓香	se[db nj[yv xk[oo fu[gk cj[br fg[af xl[ho
森然魄動下馬拜	sf[aa rj[xd po[bg ds[el xx[hb ma[vv bd[fh
僧皎然	sg[rb jn[bl rj[xd
僧言古壁佛畫好	sg[rb yj[we gu[uk bi[ut fo[rf hx[ht hc[nz
沙場烽火侵胡月	ua[dx ih[tv fg[hw ho[dp qb[rx hu[go yt[ke
紗窗日落漸黃昏	ua[sx il[xp ri[wh lo[cd jm[di hl[gy hy[uo
沙口石凍馬蹄脫	ua[dx kz[uv ui[ek ds[dq ma[vv ti[zl to[ob
沙平水息聲影絕	ua[dx pk[hb uv[uu xi[zx ug[um yk[op jt[sd
殺氣三時作陣雲	ua[ia qi[rh sj[hh ui[oc zo[rv vf[ei yy[es
殺人莫敢前	ua[ia rf[pd mo[co gj[vw qm[bo
殺人如麻	ua[ia rf[pd ru[nk ma[ga
沙行渡頭歇	ua[dx xk[rh du[dg tz[dd xp[od
山愛夕陽時	uj[uk ai[au xi[xd yh[eo ui[oc
扇裁月魄羞難掩	uj[hx cd[ty yt[ke po[bg xq[yi nj[yv yj[fd
山川蕭條極邊土	uj[uk ir[pu xn[cx tn[wa ji[aj bm[lz tu[uh
山光忽西落	uj[uk gl[xe hu[bx xi[hk lo[cd
山光悅鳥性	uj[uk gl[xe yt[xb nn[nh xk[xp
山紅澗碧紛爛漫	uj[uk hs[sg jm[dm bi[we ff[sf lj[hb mj[do
珊瑚碧樹交枝柯	uj[wk hu[wg bi[we uu[ay jn[li vi[au ke[ak
山迴路轉不見君	uj[uk hv[wk lu[zw vr[ie bu[eu jm[ke jy[xk
山居秋暝	uj[uk ju[ug qq[hh mk[og
山開曠望旋平陸	uj[uk kd[hc kl[og wh[ww xr[fr pk[hb lu[ef
山口潛行始隈隩	uj[uk kz[uv qm[de xk[rh ui[ns ww[et ao[[
山林二十年	uj[uk lb[aa er[hh ui[hu nm[rn
山暝聽猿愁	uj[uk mk[og tk[kj yr[qt iz[hx
山色遙連秦樹晚	uj[uk se[db yc[az lm[iz qb[sh uu[ay wj[od
山色有無中	uj[uk se[db yz[uo wu[ee vs[ku
山石	uj[uk ui[ek
山石犖确行徑微	uj[uk ui[ek lo[cn qt[ed xk[rh jk[rs ww[ru
山寺鐘鳴晝已昏	uj[uk si[tc vs[jv mk[kn vz[uo yi[kv hy[uo
山隨平野盡	uj[uk sv[eu pk[hb ye[oy jb[ud
山為樽	uj[uk ww[dl zy[ab
繕性何由熟	uj[sy xk[xp he[rk yz[ou uu[wd
山形依舊枕寒流	uj[uk xk[kp yi[ry jq[uo vf[ag hj[gd lq[dw
山夷又紛然	uj[uk yi[hg yz[vd ff[sf rj[xd
山月隨人歸	uj[uk yt[ke sv[eu rf[pd gv[ux
山月照彈琴	uj[uk yt[ke vc[od tj[gb qb[wr
山在虛無縹緲間	uj[uk zd[ut xu[hy wu[ee pn[sx mn[sm jm[mo
山中習靜觀朝槿	uj[uk vs[ku xi[vd jk[fd gr[yj ic[uo jb[an
山中相送罷	uj[uk vs[ku xl[am ss[bz ba[st
山中一夜雨	uj[uk vs[ku yi[hh ye[wr yu[hk
上蔡蒼鷹何足道	uh[bh cd[cx ch[cr yk[gn he[rk zu[kv dc[bz
上國隨緣住	uh[bh go[ww sv[eu yr[sv vu[rd
上將擁旄西出徵	uh[bh jl[dx ys[fo mc[fr xi[hk iu[ck vg[rh
上林繁花照眼新	uh[bh lb[aa fj[ry hx[cr vc[od yj[mg xb[lj
傷麟怨道窮	uh[rr lb[gm yr[xx dc[bz qs[xl
商女不知亡國恨	uh[lk nv[vp bu[eu vi[uk wh[wv go[ww hf[xg
上窮碧落下黃泉	uh[bh qs[xl bi[we lo[cd xx[hb hl[gy qr[bu
商人重利輕別離	uh[lk rf[pd vs[ph li[hd qk[is bp[kd li[wk
尚想舊情憐婢僕	uh[xk xl[ax jq[uo qk[xf lm[xr bi[nb pu[rb
尚衣方進翠雲裘	uh[xk yi[wy fh[dw jb[ez cv[xw yy[es qq[hy
上有黃鸝深樹鳴	uh[bh yz[uo hl[gy li[hn uf[dg uu[ay mk[kn
上有六龍回日之高標	uh[bh yz[uo lq[wb ls[yp hv[wk ri[wh vi[dv gc[wk bn[ae
上有青冥之長天	uh[bh yz[uo qk[fo mk[go vi[dv ih[ph tm[hd
少婦城南欲斷腸	uc[xp fu[nx ig[tw nj[uk yu[bd dr[mj ih[ov
少婦今春意	uc[xp fu[nx jb[rd iy[so yi[lx
少孤為客早	uc[xp gu[zp ww[dl ke[gw zc[ou
少陵無人謫仙死	uc[xp lk[et wu[ee rf[pd ve[yl xm[ru si[hx
少陵野老吞生哭	uc[xp lk[et ye[oy lc[tb ty[tk ug[pf ku[kq
少年十五二十時	uc[xp nm[rn ui[hu wu[hu er[hh ui[hu ui[oc
少小離家老大回	uc[xp xn[ub li[wk jx[gu lc[tb da[hr hv[wk
少小雖非投筆吏	uc[xp xn[ub sv[ki fw[su tz[fj bi[vm li[hk
少小幽燕客	uc[xp xn[ub yz[yy yj[nk ke[gw
少壯能幾時	uc[xp vl[du ng[sb ji[pv ui[oc
舍南舍北皆春水	ue[rg nj[uk ue[rg bw[ub jp[bb iy[so uv[uu
射殺山中白額虎	ue[uc ua[ia uj[uk vs[ku bd[po ee[gy hu[hj
捨生亦如此	ue[rg ug[pf yi[wy ru[nk ci[vb
赦書一日行萬里	ue[tw uu[vv yi[hh ri[wh xk[rh wj[hv li[ot
麝薰微度繡芙蓉	ue[gu xy[pd ww[ru du[gn xq[sh fu[ce rs[cx
誰人更掃黃金臺	uw[yv rf[pd gg[ho sc[fx hl[gy jb[rw td[sk
審藏用之機	uf[go ch[cw ys[ou vi[dv ji[aj
身當恩遇常輕敵	uf[pu dh[xx en[wx yu[oz ih[xk qk[is di[qw
身登青雲梯	uf[pu dg[dd qk[fo yy[es ti[ab
身多疾病思田裡	uf[pu do[xx ji[bu bk[bh si[tx tm[wu li[ot
深宮二十年	uf[dg gs[gk er[hh ui[hu nm[rn
神歡體自輕	uf[uo hr[yd ti[ra zi[pm qk[is
深林人不知	uf[dg lb[aa rf[pd bu[eu vi[uk
深柳讀書堂	uf[dg lq[ap du[yu uu[vv th[xt
神妙獨數江都王	uf[uo mn[nx du[qi uu[mw jl[dg du[te wh[su
慎莫近前丞相嗔	uf[xu mo[co jb[jz qm[bo ig[lh xl[am if[ku
神女生涯原是夢	uf[uo nv[vp ug[pf ya[di yr[ib ui[op mg[ax
沈全期	uf[dg qr[rw qi[qo
深山何處鐘	uf[dg uj[uk he[rk iu[wb vs[jv
深山竊聽來妖精	uf[dg uj[uk qp[xq tk[kj ld[hm yc[np jk[mf
身上無有完肌膚	uf[pu uh[bh wu[ee yz[uo wj[ge ji[oj fu[oe
深鎖春光一院愁	uf[dg so[jx iy[so gl[xe yi[hh yr[eg iz[hx
身為賈人婦	uf[pu ww[dl gu[xb rf[pd fu[nx
身無綵鳳雙飛翼	uf[pu wu[ee cd[ap fg[jy ul[yy fw[vp yi[xt
慎勿出口他人狙	uf[xu wu[bp iu[ck kz[uv ta[ry rf[pd ju[qq
沈吟放撥插弦中	uf[dg yb[kr fh[fw bo[fv ia[fq xm[gw vs[ku
身欲奮飛病在床	uf[pu yu[bd ff[dt fw[vp bk[bh zd[ut il[ga
深竹暗浮煙	uf[dg vu[rr an[ol fu[da yj[hw
神縱慾福難為功	uf[uo zs[sr yu[bd fu[uh nj[yv ww[dl gs[gl
深坐蹙蛾眉	uf[dg zo[rr cu[wz ee[ip mw[mm
生別常惻惻	ug[pf bp[kd ih[xk ce[xb ce[xb
聖朝無闕事	ug[yt ic[uo wu[ee qt[mn ui[hk
聖代即今多雨露	ug[yt dd[rq ji[ge jb[rd do[xx yu[hk lu[yz
聖代無隱者	ug[yt dd[rq wu[ee yb[ed ve[to
聖德北服南單于	ug[yt de[ru bw[ub fu[oe nj[uk ij[bo yu[eu
聖恩若許留太學	ug[yt en[wx ro[cu xu[yw lq[pt td[dd xt[xz
生兒不象賢	ug[pf er[pv bu[eu xl[dk xm[ub
升階傴僂薦脯酒	ug[pc jp[er yu[rk lv[rm jm[cu pu[of jq[dy
生男埋沒隨百草	ug[pf nj[tl md[to mo[dj sv[eu bd[eo cc[co
生女猶得嫁比鄰	ug[pf nv[vp yz[qy de[ro jx[ng bi[bb lb[re
勝事空自知	ug[op ui[hk ks[xg zi[pm vi[uk
生事且瀰漫	ug[pf ui[hk qp[ke mi[gd mj[do
升堂坐階新雨足	ug[pc th[xt zo[rr jp[er xb[lj yu[hk zu[kv
昇天入地求之遍	ug[pc tm[hd ru[pd di[ty qq[hu vi[dv bm[hz
聖文神武皇帝初	ug[yt wf[wi uf[uo wu[hv hl[bw di[lj iu[yd
生小不相識	ug[pf xn[ub bu[eu xl[am ui[yk
聲喧亂石中	ug[um xr[kg lr[qv ui[ek vs[ku
生涯豈料承優詔	ug[pf ya[di qi[uk ln[md ig[lu yz[ry vc[yd
聲以動容	ug[um yi[sr ds[el rs[xr
勝因夙所宗	ug[op yb[wd su[jh so[pj zs[ge
生長明妃尚有村	ug[pf vh[ph mk[oo fw[nk uh[xk yz[uo cy[ac
聲之寂寞	ug[um vi[dv ji[gu mo[gc
省中啼鳥吏人稀	ug[xm vs[ku ti[kl nn[nh li[hk rf[pd xi[hi
聖主朝朝暮暮情	ug[yt vu[dw vc[uo vc[uo mu[co mu[co qk[xf
勢拔五嶽掩赤城	ui[fl ba[fu wu[hu yt[qu yj[fd ii[ty ig[tw
侍婢賣珠回	ui[rt bi[nb md[ud vu[wp hv[wk
使臣將王命	ui[rh if[ku jl[dx wh[su mk[rh
侍兒扶起嬌無力	ui[rt er[pv fu[fe qi[zk jn[np wu[ee li[vp
十二樓中盡曉妝	ui[hu er[hh lz[am vs[ku jb[ud xn[oq vl[dn
是法廳事也	ui[op fa[dt tk[id ui[hk ye[vu
使舫載之	ui[rh fh[vf zd[ti vi[dv
勢分三足鼎	ui[fl ff[bd sj[hh zu[kv dk[mv
試拂鐵衣如雪色	ui[yq fu[ff tp[jp yi[wy ru[nk xt[yx se[db
石鼓歌	ui[ek gu[uu ge[kd
事姑貽我憂	ui[hk gu[ng yi[bs wo[pf yz[xy
石鼓之歌止於此	ui[ek gu[uu vi[dv ge[kd vi[uh yu[eu ci[vb
十鼓只載數駱駝	ui[hu gu[uu vi[kb zd[ti uu[mw lo[mw to[mg
示官吏	ui[ex gr[gu li[hk
石磯西畔問漁船	ui[ek ji[ej xi[hk pj[tb wf[mk yu[dy ir[vj
時見歸村人	ui[oc jm[ke gv[ux cy[ac rf[pd
時見松櫪皆十圍	ui[oc jm[ke ss[ab li[ai jp[bb ui[hu ww[ww
世間行樂亦如此	ui[nv jm[mo xk[rh le[px yi[wy ru[nk ci[vb
誓將報主靜邊塵	ui[fy jl[dx bc[fe vu[dw jk[fd bm[lz if[xt
誓將掛冠去	ui[fy jl[dx gx[ft gr[ge qu[ts
誓將上雪列聖恥	ui[fy jl[dx uh[bh xt[yx lp[hd ug[yt ii[ev
世界微塵裡	ui[nv jp[tr ww[ru if[xt li[ot
始覺屏障生光輝	ui[ns jt[xj pk[ub vh[el ug[pf gl[xe hv[xg
始覺有遷謫意	ui[ns jt[xj yz[uo qm[qz ve[yl yi[lx
使快彈數曲	ui[rh kk[xv dj[gb uu[mw qu[ou
石廩騰擲堆祝融	ui[ek lb[gw tg[ob vi[fb dv[tv vu[uk rs[hi
誓令疏勒出飛泉	ui[fy lk[rd uu[pw le[gl iu[ck fw[vp qr[bu
十六君遠行	ui[hu lq[wb jy[xk yr[ez xk[rh
世亂同南去	ui[nv lr[qv ts[kh nj[uk qu[ts
時難年荒世業空	ui[oc nj[yv nm[rn hl[cw ui[nv ye[ub ks[xg
十年離亂後	ui[hu nm[rn li[wk lr[qv hz[pk
十年征戍憶遼陽	ui[hu nm[rn vg[rh uu[wd yi[xv ln[lz yh[eo
侍女金盤膾鯉魚	ui[rt nv[vp jb[rw pj[vm kk[or li[yo yu[dt
是妾斷腸時	ui[op qp[ln dr[mj ih[ov ui[oc
時清獨北還	ui[oc qk[df du[qi bw[ub hd[bz
世情惡衰歇	ui[nv qk[xf ee[hx uk[wk xp[od
時取一醉	ui[oc qu[ey yi[hh zv[yw
世人解聽不解賞	ui[nv rf[pd jp[dd tk[kj bu[eu jp[dd uh[xk
使人聽此凋朱顏	ui[rh rf[pd tk[kj ci[vb dn[dk vu[ph yj[ly
時人已知處	ui[oc rf[pd yi[kv vi[uk iu[wb
是日牽來赤墀下	ui[op ri[wh qm[dg ld[hm ii[ty ii[tu xx[hb
十三學得琵琶成	ui[hu sj[hh xt[xz de[ro pi[wb pa[wb ig[wv
世上未有如公貧	ui[nv uh[bh ww[ha yz[uo ru[nk gs[bs pb[fb
十觴亦不醉	ui[hu uh[dr yi[wy bu[eu zv[yw
十生九死到官所	ui[hu ug[pf jq[pv si[hx dc[hd gr[gu so[pj
世事波上舟	ui[nv ui[hk bo[dp uh[bh vz[pk
世事蹉跎成白首	ui[nv ui[hk co[zy to[zg ig[wv bd[po uz[be
世事空知學醉歌	ui[nv ui[hk ks[xg vi[uk xt[xz zv[yw ge[kd
世事兩茫茫	ui[nv ui[hk ll[hk mh[cd mh[cd
世事茫茫難自料	ui[nv ui[hk mh[cd mh[cd nj[yv zi[pm ln[md
時時誤拂弦	ui[oc ui[oc wu[yk fu[ff xm[gw
始是新承恩澤時	ui[ns ui[op xb[lj ig[lu en[wx ze[dy ui[oc
十四萬眾猶虎貔	ui[hu si[we wj[hv vs[rr yz[qy hu[hj pi[pp
十四為君婦	ui[hu si[we ww[dl jy[xk fu[nx
使我不得開心顏	ui[rh wo[pf bu[eu de[ro kd[hc xb[dv yj[ly
使我三軍淚如雨	ui[rh wo[pf sj[hh jy[gi lw[dm ru[nk yu[hk
十五始展眉	ui[hu wu[hu ui[ns vj[ug mw[mm
是夕	ui[op xi[xd
失向來之煙霞	ui[pe xl[pk ld[hm vi[dv yj[hw xx[yk
是夜越吟苦	ui[op ye[wr yt[zh yb[kr ku[cg
是以陷鄰境	ui[op yi[sr xm[ed lb[re jk[tl
時有落花至	ui[oc yz[uo lo[cd hx[cr vi[ht
石魚湖	ui[ek yu[dt hu[dg
石魚湖上醉歌並序	ui[ek yu[dt hu[dg uh[bh zv[yw ge[kd bk[bk xu[gy
始與秦塞通人煙	ui[ns yu[hv qb[sh sd[gt ts[sz rf[pd yj[hw
世中遙望空雲山	ui[nv vs[ku yc[az wh[ww ks[xg yy[es uj[uk
手把芙蓉朝玉京	uz[su ba[fb fu[ce rs[cx ic[uo yu[wd jk[wk
手持杯珓導我擲	uz[su ii[ft bw[ab jn[[ dc[kc wo[pf vi[fb
手持綠玉杖	uz[su ii[ft lv[sx yu[wd vh[ah
受降城外月如霜	uz[ay xl[ew ig[tw wd[xb yt[ke ru[nk ul[ya
書被催成墨未濃	uu[vv bw[yp cv[ru ig[wv mo[ht ww[ha ns[dg
書邊事	uu[vv bm[lz ui[hk
數嘗於	uu[mw ih[xe yu[fr
數叢沙草群鷗散	uu[mw cs[rh ua[dx cc[co qy[xy ou[kn sj[gw
蜀道難	uu[sb dc[bz nj[yv
蜀道之難難於上青天	uu[sb dc[bz vi[dv nj[yv nj[yv yu[eu uh[bh qk[fo tm[hd
輸肝剖膽效英才	uu[ir gj[og pz[ld dj[oo xn[lw yk[ck cd[hu
戍鼓斷人行	uu[wd gu[uu dr[mj rf[pd xk[rh
蔬果幸見嘗	uu[cp go[oa xk[tb jm[ke ih[xe
蜀江水碧蜀山青	uu[sb jl[dg uv[uu bi[we uu[sb uj[uk qk[fo
戍客望邊色	uu[wd ke[gw wh[ww bm[lz se[db
數裡入雲峰	uu[mw li[ot ru[pd yy[es fg[uw
疏糲亦足飽我飢	uu[pw li[mi yi[wy zu[kv bc[ub wo[pf ji[uj
戍樓西望煙塵黑	uu[wd lz[am xi[hk wh[ww yj[hw if[xt hw[sd
樹杪百重泉	uu[ay mn[ax bd[eo vs[ph qr[bu
樹木猶為人愛惜	uu[ay mu[ub yz[qy ww[dl rf[pd ai[au xi[xg
淑氣催黃鳥	uu[du qi[rh cv[ru hl[gy nn[nh
蜀琴欲奏鴛鴦弦	uu[sb qb[wr yu[bd zz[st yr[xn yh[kn xm[gw
庶情沿物應	uu[gn qk[xf yj[dj wu[nb yk[gx
樹色隨山迥	uu[ay se[db sv[eu uj[uk js[kz
蜀僧抱綠綺	uu[sb sg[rb bc[fb lv[sx qi[sd
疏鬆影落空壇靜	uu[pw ss[ab yk[op lo[cd ks[xg tj[te jk[fd
數歲親戎旃	uu[mw sv[ux qb[la rs[gu vj[fr
數問夜如何	uu[mw wf[mk ye[wr ru[nk he[rk
蜀先主廟	uu[sb xm[ne vu[dw mn[gy
蜀相	uu[sb xl[am
疏雨過中條	uu[pw yu[hk go[cz vs[ku tn[wa
孰雲網恢恢	uu[wj yy[es wh[ki hv[xu hv[xu
孰雲吾道非	uu[wj yy[es wu[wk dc[bz fw[su
數紙尚可博白鵝	uu[mw vi[su uh[xk ke[dk bo[uf bd[po ee[pn
樹之微風	uu[ay vi[dv ww[ru fg[ji
蜀主徵吳幸三峽	uu[sb vu[dw vg[rh wu[kt xk[tb sj[hh xx[uj
雙飛西園草	ul[yy fw[vp xi[hk yr[we cc[co
雙淚落君前	ul[yy lw[dm lo[cd jy[xk qm[bo
雙皮溜雨四十圍	ul[yy pi[vp lq[dp yu[hk si[we ui[hu ww[ww
霜悽萬樹風入衣	ul[ya qi[dh wj[hv uu[ay fg[ji ru[pd yi[wy
霜蹄蹴踏長楸間	ul[ya ti[zl cu[zw ta[zu ih[ph qq[ah jm[mo
雙袖龍鍾淚不幹	ul[yy xq[yy ls[yp vs[jv lw[dm bu[eu gj[hu
雙照淚痕幹	ul[yy vc[od lw[dm hf[bg gj[hu
誰愛風流高格調	uv[yv ai[au fg[ji lq[dw gc[wk ge[aw dn[yk
水澹澹兮生煙	uv[uu dj[dd dj[dd xi[bk ug[pf yj[hw
水滴銅龍晝漏長	uv[uu di[dl ts[jk ls[yp vz[uo lz[du ih[ph
誰復著手為摩挲	uv[yv fu[ro vu[ct uz[su ww[dl ma[gf sa[df
水寒風似刀	uv[uu hj[gd fg[ji si[rs dc[vp
誰見汀洲上	uv[yv jm[ke tk[dd vz[dd uh[bh
誰解乘舟尋范蠡	uv[yv jp[dd ig[qb vz[pk xy[xc fj[cd li[vi
水晶簾卷近秋河	uv[uu jk[oo lm[xj jr[be jb[jz qq[hh he[dk
水精之盤行素鱗	uv[uu jk[mf vi[dv pj[vm xk[rh su[fy lb[ym
誰憐越女顏如玉	uv[yv lm[xr yt[zh nv[vp yj[ly ru[nk yu[wd
水落魚梁淺	uv[uu lo[cd yu[dt ll[da qm[dj
誰能將旗鼓	uv[yv ng[sb jl[dx qi[fr gu[uu
誰能絕人命	uv[yv ng[sb jt[sd rf[pd mk[rh
水泉冷澀弦凝絕	uv[uu qr[bu lg[dr se[dd xm[gw nk[db jt[sd
水深波浪闊	uv[uu uf[dg bo[dp lh[dl ko[md
水聲激激風吹衣	uv[uu ug[um ji[db ji[db fg[ji iv[kd yi[wy
誰為表予心	uv[yv ww[dl bn[fy yu[sv xb[dv
誰為含愁獨不見	uv[yv ww[dl hj[rk iz[hx du[qi bu[eu jm[ke
水為沼	uv[uu ww[dl vc[dd
誰言寸草心	uv[yv yj[we cy[hu cc[co xb[dv
水月通禪寂	uv[uu yt[ke ts[sz ij[ub ji[gu
誰知林棲者	uv[yv vi[uk lb[aa qi[ax ve[to
順陰陽之數	uy[iy yb[eo yh[eo vi[dv uu[mw
朔方健兒好身手	uo[no fh[dw jm[ry er[pv hc[nz uf[pu uz[su
說盡心中無限事	uo[yb jb[ud xb[dv vs[ku wu[ee xm[eg ui[hk
愬武古通作牙爪	uo[[ wu[hv gu[uk ts[sz zo[rv ya[hv vc[pu
四邊伐鼓雪海湧	si[we bm[lz fa[rg gu[uu xt[yx hd[dr ys[ds
死別已吞聲	si[hx bp[kd yi[kv ty[tk ug[um
似洞庭	si[rs ds[dk tk[gq
四方環鎮嵩當中	si[we fh[dw hr[wb vf[ju ss[uw dh[xx vs[ku
思歸多苦顏	si[tx gv[ux do[xx ku[cg yj[ly
嗣皇繼聖登夔皋	si[kv hl[bw ji[sm ug[yt dg[dd kv[bb gc[bd
四角礙白日	si[we jn[do ai[eo bd[po ri[wh
四郊秋葉驚摵摵	si[we jn[le qq[hh ye[ku jk[xw se[[ se[[
死節從來豈顧勳	si[hx jp[ce cs[rr ld[hm qi[uk gu[iy xy[kl
司空曙	si[vh ks[xg uu[os
嘶馬出門思故鄉	si[kq ma[vv iu[ck mf[du si[tx gu[gw xl[sp
斯人不可聞	si[qj rf[pd bu[eu ke[dk wf[me
斯人獨憔悴	si[qj rf[pd du[qi qn[xv cv[xw
死生長別離	si[hx ug[pf vh[ph bp[kd li[wk
似訴平生不得志	si[rs su[yj pk[hb ug[pf bu[eu de[ro vi[ux
嘶酸雛雁失群夜	si[kq sr[ys iu[dv yj[ir ui[pe qy[xy ye[wr
似聞昨者赤松子	si[rs wf[me zo[ov ve[to ii[ty ss[ab zi[lh
四弦一聲如裂帛	si[we xm[gw yi[hh ug[um ru[nk lp[hy bo[bj
斯須九重真龍出	si[qj xu[py jq[pv is[ph vf[uj ls[yp iu[ck
思欲委符節	si[tx yu[bd ww[hn fu[vr jp[ce
四月南風大麥黃	si[we yt[ke nj[uk fg[ji da[hr md[fw hl[gy
四座無言星欲稀	si[we zo[gr wu[ee yj[we xk[op yu[bd xi[hi
松柏一逕趨靈宮	ss[ab bd[ab yi[hh jk[sz qu[zd lk[xh gs[gk
送別	ss[bz bp[kd
送陳章甫	ss[bz if[eq vh[lo fu[uo
送崔九	ss[bz cv[uv jq[pv
送杜少府之任蜀州	ss[bz du[at uc[xp fu[gr vi[dv rf[rq uu[sb vz[dp
松風吹解帶	ss[ab fg[ji iv[kd jp[dd dd[cj
松際露微月	ss[ab ji[ee lu[yz ww[ru yt[ke
送客湓浦口	ss[bz ke[gw pf[df pu[df kz[uv
送李少府貶峽中王少府貶長沙	ss[bz li[az uc[xp fu[gr bm[bp xx[uj vs[ku wh[su uc[xp fu[gr bm[bp ih[ph ua[dx
送李中丞歸漢陽別業	ss[bz li[az vs[ku ig[lh gv[ux hj[dy yh[eo bp[kd ye[ub
送靈澈	ss[bz lk[xh ie[dw
送孟浩然之廣陵	ss[bz mg[zm hc[dn rj[xd vi[dv gl[di lk[et
送人東遊	ss[bz rf[pd ds[qx yz[df
送僧歸日本	ss[bz sg[rb gv[ux ri[wh bf[ah
送上人	ss[bz uh[bh rf[pd
松聲晚窗裡	ss[ab ug[um wj[od il[xp li[ot
訟斯在	ss[yb si[qj zd[ut
送魏萬之京	ss[bz ww[hg wj[hv vi[dv jk[wk
送我至剡溪	ss[bz wo[pf vi[ht uj[hd xi[da
松下清齋折露葵	ss[ab xx[hb qk[df vd[we ve[fj lu[yz kv[cd
松下問童子	ss[ab xx[hb wf[mk ts[lo zi[lh
送楊氏女	ss[bz yh[av ui[pq nv[vp
送友人	ss[bz yz[uy rf[pd
松月生夜涼	ss[ab yt[ke ug[pf ye[wr ll[dw
松月夜窗墟	ss[ab yt[ke ye[wr il[xp xu[th
宋之問	ss[ga vi[dv wf[mk
送梓州李使君	ss[bz zi[al vz[dp li[az ui[rh jy[xk
搜於岐陽騁雄俊	sz[fj yu[eu qi[uu yh[eo ig[my xs[uv jy[rs
宿府	su[gr fu[gr
宿建德江	su[gr jm[yj de[ru jl[dg
素手抽針冷	su[fy uz[su iz[fy vf[ju lg[dr
素手青條上	su[fy uz[su qk[fo tn[wa uh[bh
素手玉房前	su[fy uz[su yu[wd fh[hf qm[bo
宿桐廬江寄廣陵舊遊	su[gr ts[ak lu[gh jl[dg ji[gd gl[di lk[et jq[uo yz[df
宿王昌齡隱居	su[gr wh[su ih[oo lk[vr yb[ed ju[ug
蘇武魂銷漢使前	su[cl wu[hv hy[eg xn[jx hj[dy ui[rh qm[bo
蘇武廟	su[cl wu[hv mn[gy
宿業師山房待丁大不至	su[gr ye[ub ui[uh uj[uk fh[hf dd[rt dk[hu da[hr bu[eu vi[ht
隨風滿地石亂走	sv[eu fg[ji mj[dc di[ty ui[ek lr[qv zz[tv
隋宮	sv[eu gs[gk
遂教方士殷勤覓	sv[bz jn[tw fh[dw ui[uh yb[pj qb[nl mi[aj
遂令東山客	sv[bz lk[rd ds[qx uj[uk ke[gw
遂令天下父母心	sv[bz lk[rd tm[hd xx[hb fu[bi mu[vv xb[dv
遂命酒	sv[bz mk[rh jq[dy
歲暮歸南山	sv[ux mu[co gv[ux nj[uk uj[uk
歲暮陰陽催短景	sv[ux mu[co yb[eo yh[eo cv[ru dr[ud jk[ow
隨山到水源	sv[eu uj[uk dc[hd uv[uu yr[di
隨山將萬轉	sv[eu uj[uk jl[dx wj[hv vr[ie
雖生意可知	sv[ki ug[pf yi[lx ke[dk vi[uk
歲時伏臘走村翁	sv[ux ui[oc fu[rq la[og zz[tv cy[ac wg[bx
歲歲金河復玉關	sv[ux sv[ux jb[rw he[dk fu[ro yu[wd gr[bt
雖無賓主意	sv[ki wu[ee bb[gq vu[dw yi[lx
睢盱偵伺能鞠躬	sv[mv xu[me vf[rb si[rv ng[sb ju[gb gs[ug
歲夜高堂列明燭	sv[ux ye[wr gc[wk th[xt lp[hd mk[oo vu[hi
隨意春芳歇	sv[eu yi[lx iy[so fh[cf xp[od
雖有絕頂誰能窮	sv[ki yz[uo jt[sd dk[dy uv[yv ng[sb qs[xl
所得是沾衣	so[pj de[ro ui[op vj[db yi[wy
所守或匪親	so[pj uz[gc ho[gk fw[kf qb[la
鎖銜金獸連環冷	so[jx xm[rj jb[rw uz[bh lm[iz hr[wb lg[dr
他年錦裡經祠廟	ta[ry nm[rn jb[jb li[ot jk[ss ci[uv mn[gy
榻上庭前屹相向	ta[ao uh[bh tk[gq qm[bo yi[ur xl[am xl[pk
他生緣會更難期	ta[ry ug[pf yr[sv hv[re gg[ho nj[yv qi[qo
塔勢如湧出	ta[tc ui[fl ru[nk ys[ds iu[ck
他鄉復行役	ta[ry xl[sp fu[ro xk[rh yi[rj
他鄉生白髮	ta[ry xl[sp ug[pf bd[po fa[vy
態濃意遠淑且真	td[dx ns[dg yi[lx yr[ez uu[du qp[ke vf[uj
苔色連深竹	td[cs se[db lm[iz uf[dg vu[rr
苔深不能掃	td[cs uf[dg bu[eu ng[sb sc[fx
太液芙蓉未央柳	td[dd ye[dw fu[ce rs[cx ww[ha yh[kd lq[ap
太乙近天都	td[dd yi[vv jb[jz tm[hd du[te
太真含笑入簾來	td[dd vf[uj hj[rk xn[vp ru[pd lm[xj ld[hm
嘆鳳嗟身否	tj[ky fg[jy jp[ky uf[pu fz[bk
彈劍作歌奏苦聲	tj[gb jm[rd zo[rv ge[kd zz[st ku[cg ug[um
彈琴	tj[gb qb[wr
彈琴復長嘯	tj[gb qb[wr fu[ro ih[ph xn[kx
嘆息未應閒	tj[ky xi[zx ww[ha yk[gx xm[ma
潭煙飛溶溶	tj[dx yj[hw fw[vp rs[dx rs[dx
潭影空人心	tj[dx yk[op ks[xg rf[pd xb[dv
湯盤孔鼎有述作	th[dv pj[vm ks[zv dk[mv yz[uo uu[az zo[rv
唐玄宗	th[gx xr[wy zs[ge
桃花盡日隨流水	tc[av hx[cr jb[ud ri[wh sv[eu lq[dw uv[uu
桃花溪	tc[av hx[cr xi[da
桃李陰陰柳絮飛	tc[av li[az yb[eo yb[eo lq[ap xu[ny fw[vp
陶然共忘機	tc[eb rj[xd gs[gb wh[wx ji[aj
陶然共醉菊花杯	tc[eb rj[xd gs[gb zv[yw ju[cb hx[cr bw[ab
桃源行	tc[av yr[di xk[rh
騰驤磊落三萬匹	tg[ob xl[mw lw[ee lo[cd sj[hh wj[hv pi[ke
題大庾嶺北驛	ti[oy da[hr yu[gj lk[ur bw[ub yi[my
題金陵渡	ti[oy jb[rw lk[et du[dg
剔開紅焰救飛蛾	ti[od kd[hc hs[sg yj[hd jq[hw fw[vp ee[ip
題破山寺後禪院	ti[oy po[ep uj[uk si[tc hz[pk ij[ub yr[eg
啼時驚妾夢	ti[kl ui[oc jk[xw qp[ln mg[ax
天邊樹若薺	tm[hd bm[lz uu[ay ro[cu ji[cw
天長地久有時盡	tm[hd ih[ph di[ty jq[xd yz[uo ui[oc jb[ud
天長路遠魂飛苦	tm[hd ih[ph lu[zw yr[ez hy[eg fw[vp ku[cg
天地為之久低昂	tm[hd di[ty ww[dl vi[dv jq[xd di[ru ah[op
天地一沙鷗	tm[hd di[ty yi[hh ua[dx ou[kn
天地英雄氣	tm[hd di[ty yk[ck xs[uv qi[rh
田夫荷鋤立	tm[wu fu[er he[cr iu[jq li[lh
天寒翠袖薄	tm[hd hj[gd cv[xw xq[yy bo[cd
天寒夢澤深	tm[hd hj[gd mg[ax ze[dy uf[dg
天假神柄專其雄	tm[hd jx[rk uf[uo bk[ah vr[ev qi[cb xs[uv
添酒回燈重開宴	tm[dt jq[dy hv[wk dg[hd is[ph kd[hc yj[go
天路幽險難追攀	tm[hd lu[zw yz[yy xm[er nj[yv vv[pz pj[ad
天明獨去無道路	tm[hd mk[oo du[qi qu[ts wu[ee dc[bz lu[zw
天末懷李白	tm[hd mo[ha hk[xb li[az bd[po
天姥連天向天橫	tm[hd mu[nt lm[iz tm[hd xl[pk tm[hd hg[ag
天畔獨潸然	tm[hd pj[tb du[qi uj[da rj[xd
天氣晚來秋	tm[hd qi[rh wj[od ld[hm qq[hh
天秋月又滿	tm[hd qq[hh yt[ke yz[vd mj[dc
天上人間會相見	tm[hd uh[bh rf[pd jm[mo hv[re xl[am jm[ke
天生麗質難自棄	tm[hd ug[pf li[hk vi[pu nj[yv zi[pm qi[wc
天生我材必有用	tm[hd ug[pf wo[pf cd[ac bi[xp yz[uo ys[ou
天台四萬八千丈	tm[hd td[sk si[we wj[hv ba[pd qm[pu vh[hi
天外三峰削不成	tm[hd wd[xb sj[hh fg[uw xt[xd bu[eu ig[wv
天旋地轉回龍馭	tm[hd xr[fr di[ty vr[ie hv[wk ls[yp yu[my
天涯共此時	tm[hd ya[di gs[gb ci[vb ui[oc
天涯孤棹還	tm[hd ya[di gu[zp vc[ab hd[bz
天涯哭此時	tm[hd ya[di ku[kq ci[vb ui[oc
天涯若比鄰	tm[hd ya[di ro[cu bi[bb lb[re
天涯霜雪霽寒霄	tm[hd ya[di ul[ya xt[yx ji[yw hj[gd xn[yx
天涯涕淚一身遙	tm[hd ya[di ti[db lw[dm yi[hh uf[pu yc[az
天涯占夢數	tm[hd ya[di vj[bk mg[ax uu[mw
天陰雨溼聲啾啾	tm[hd yb[eo yu[hk ui[do ug[um jq[kh jq[kh
田園寥落干戈後	tm[wu yr[we ln[gx lo[cd gj[hu ge[qp hz[pk
天子非常賜顏色	tm[hd zi[lh fw[su ih[xk ci[bo yj[ly se[db
迢遞三巴路	tn[dz di[bz sj[hh ba[ku lu[zw
迢遞嵩高下	tn[dz di[bz ss[uw gc[wk xx[hb
迢遞送斜暉	tn[dz di[bz ss[bz xp[rd hv[og
岧嶢太華俯鹹京	tn[[ yc[[ td[dd hx[ru fu[rg xm[wh jk[wk
鐵騎突出刀槍鳴	tp[jp qi[md tu[xq iu[ck dc[vp ql[ar mk[kn
鐵衣遠戍辛勤久	tp[jp yi[wy yr[ez uu[wd xb[lu qb[nl jq[xd
聽安萬善吹篳篥歌	tk[kj an[gn wj[hv uj[yk iv[kd bi[vb li[vx ge[kd
停杯投箸不能食	tk[rw bw[ab tz[fj vu[vt bu[eu ng[sb ui[rl
停船暫借問	tk[rw ir[vj zj[io jp[rg wf[mk
聽董大彈胡笳聲兼寄語弄房給事	tk[kj ds[cp da[hr dj[gb hu[go jx[vl ug[um jm[bh ji[gd yu[yw ns[wc fh[hf gw[sr ui[hk
停舫臨孤驛	tk[rw fh[vf lb[uv gu[zp yi[my
聽其音	tk[kj qi[cb yb[lo
聽蜀僧浚彈琴	tk[kj uu[sb sg[rb jy[ds tj[gb qb[wr
聽箏	tk[kj vg[vd
聽鍾未眠客	tk[kj vs[jv ww[ha mm[mm ke[gw
汀洲無浪復無煙	tk[dd vz[dd wu[ee lh[dl fu[ro wu[ee yj[hw
同從弟南齋玩月憶山陰崔少府	ts[kh cs[rr di[bg nj[uk vd[we wj[we yt[ke yi[xv uj[uk yb[eo cv[uv uc[xp fu[gr
同居長幹裡	ts[kh ju[ug ih[ph gj[hu li[ot
銅爐華燭燭增輝	ts[jk lu[hh hx[ru vu[hi vu[hi zg[tb hv[xg
同輦隨君侍君側	ts[kh nm[ei sv[eu jy[xk ui[rt jy[xk ce[rb
銅雀春深鎖二喬	ts[jk qt[xv iy[so uf[dg so[jx er[hh qn[pp
通神明	ts[sz uf[uo mk[oo
同時輩流多上道	ts[kh ui[oc bw[fi lq[dw do[xx uh[bh dc[bz
同是長幹人	ts[kh ui[op ih[ph gj[hu rf[pd
同是宦遊人	ts[kh ui[op hr[gk yz[df rf[pd
同是天涯淪落人	ts[kh ui[op tm[hd ya[di ly[dr lo[cd rf[pd
同題仙遊觀	ts[kh ti[oy xm[ru yz[df gr[yj
同心與我違	ts[kh xb[dv yu[hv wo[pf ww[wz
同穴窅冥何所望	ts[kh xt[gb yc[[ mk[go he[rk so[pj wh[ww
童顏若可駐	ts[lo yj[ly ro[cu ke[dk vu[md
同殷仲文之古樹	ts[kh yb[pj vs[rv wf[wi vi[dv gu[uk uu[ay
童稚開荊扉	ts[lo vi[hv kd[hc jk[cd fw[hf
頭上何所有	tz[dd uh[bh he[rk so[pj yz[uo
投詩贈汨羅	tz[fj ui[yt zg[bb mi[do lo[sx
徒此挹清芬	tu[rz ci[vb yi[fk qk[df ff[cf
塗改清廟生民詩	tu[dr gd[kw qk[df mn[gy ug[pf mb[kv ui[yt
徒勞恨費聲	tu[rz lc[cl hf[xg fw[fb ug[um
徒令上將揮神筆	tu[rz lk[rd uh[bh jl[dx hv[fg uf[uo bi[vm
塗窮反遭俗眼白	tu[dr qs[xl fj[py zc[hz su[rb yj[mg bd[po
突兀壓神州	tu[xq wu[he ya[it uf[uo vz[dp
徒言樹桃李	tu[rz yj[we uu[ay tc[av li[az
蛻其皮也	tv[ib qi[cb pi[vp ye[vu
晚次鄂州	wj[od ci[dd ee[ke vz[dp
萬方多難此登臨	wj[hv fh[dw do[xx nj[yv ci[vb dg[dd lb[uv
晚風吹行舟	wj[od fg[ji iv[kd xk[rh vz[pk
萬夫莫開	wj[hv fu[er mo[co kd[hc
萬古青濛濛	wj[hv gu[uk qk[fo mg[ch mg[ch
萬古惟留楚客悲	wj[hv gu[uk ww[xv lq[pt iu[ap ke[gw bw[fx
萬古雲霄一羽毛	wj[hv gu[uk yy[es xn[yx yi[hh yu[xx mc[sv
萬國衣冠拜冕旒	wj[hv go[ww yi[wy gr[ge bd[fh mm[od lq[fr
萬壑樹參天	wj[hv he[bt uu[ay cj[sd tm[hd
萬戶搗衣聲	wj[hv hu[du dc[fn yi[wy ug[um
晚家南山陲	wj[od jx[gu nj[uk uj[uk iv[ei
晚見雁行頻	wj[od jm[ke yj[ir hh[rh pb[vy
萬徑人蹤滅	wj[hv jk[rs rf[pd zs[zg mp[hh
萬籟百泉相與秋	wj[hv ld[vh bd[eo qr[bu xl[am yu[hv qq[hh
萬籟此俱寂	wj[hv ld[vh ci[vb ju[rj ji[gu
晚來天欲雪	wj[od ld[hm tm[hd yu[bd xt[yx
萬里悲秋常作客	wj[hv li[ot bw[fx qq[hh ih[xk zo[rv ke[gw
萬里浮雲陰且晴	wj[hv li[ot fu[da yy[es yb[eo qp[ke qk[of
萬里歸心對月明	wj[hv li[ot gv[ux xb[dv dv[yc yt[ke mk[oo
萬里寒光生積雪	wj[hv li[ot hj[gd gl[xe ug[pf ji[hk xt[yx
萬里黃河繞黑山	wj[hv li[ot hl[gy he[dk rc[sq hw[sd uj[uk
萬里禽獸皆遮羅	wj[hv li[ot qb[rw uz[bh jp[bb ve[gz lo[sx
萬里送行舟	wj[hv li[ot ss[bz xk[rh vz[pk
萬里眼中明	wj[hv li[ot yj[mg vs[ku mk[oo
萬里雲羅一雁飛	wj[hv li[ot yy[es lo[sx yi[hh yj[ir fw[vp
晚年惟好靜	wj[od nm[rn ww[xv hc[nz jk[fd
萬牛回首丘山重	wj[hv nq[pf hv[wk uz[be qq[jh uj[uk vs[ph
萬頃江田一鷺飛	wj[hv qk[by jl[dg tm[wu yi[hh lu[zn fw[vp
萬事不關心	wj[hv ui[hk bu[eu gr[bt xb[dv
萬事隨轉燭	wj[hv ui[hk sv[eu vr[ie vu[hi
剜苔剔蘚露節角	wj[gd td[cs ti[od xm[cy lu[yz jp[ce jn[do
晚有弟子傳芬芳	wj[od yz[uo di[bg zi[lh ir[re ff[cf fh[cf
宛轉蛾眉馬前死	wj[gx vr[ie ee[ip mw[mm ma[vv qm[bo si[hx
王勃	wh[su bo[ul
王昌齡	wh[su ih[oo lk[vr
輞川閒居贈裴秀才迪	wh[ik ir[pu xm[ma ju[ug zg[bb pw[fy xq[hn cd[hu di[yz
望帝春心託杜鵑	wh[ww di[lj iy[so xb[dv to[fp du[at jr[kn
望洞庭湖贈張丞相	wh[ww ds[dk tk[gq hu[dg zg[bb vh[gi ig[lh xl[am
王翰	wh[su hj[ur
望薊門	wh[ww ji[cy mf[du
忘跡世所逐	wh[wx ji[yz ui[nv so[pj vu[uz
王建	wh[su jm[yj
王浚樓船下益州	wh[su jy[ds lz[am ir[vj xx[hb yi[bm vz[dp
望君煙水闊	wh[ww jy[xk yj[hw uv[uu ko[md
往來成古今	wh[rd ld[hm ig[wv gu[uk jb[rd
王孫歸不歸	wh[su sy[zx gv[ux bu[eu gv[ux
王孫善保千金軀	wh[su sy[zx uj[yk bc[rk qm[pu jb[rw qu[uk
王孫自可留	wh[su sy[zx zi[pm ke[dk lq[pt
王灣	wh[su wj[dy
往往取酒還獨傾	wh[rd wh[rd qu[ey jq[dy hd[bz du[qi qk[rb
王維	wh[su ww[sv
望仙樓上望君王	wh[ww xm[ru lz[am uh[bh wh[ww jy[xk wh[su
望嶽	wh[ww yt[qu
望月懷遠	wh[ww yt[ke hk[xb yr[ez
王之渙	wh[su vi[dv hr[dd
未諳姑食性	ww[ha an[yl gu[ng ui[rl xk[xp
未必逢矰繳	ww[ha bi[xp fg[wz zg[[ jn[sb
未成曲調先有情	ww[ha ig[wv qu[ou dn[yk xm[ne yz[uo qk[xf
為乘陽氣行時令	ww[dl ig[qb yh[eo qi[rh xk[rh ui[oc lk[rd
渭川田家	ww[dt ir[pu tm[wu jx[gu
未辭剪伐誰能送	ww[ha ci[ql jm[bd fa[rg uv[yv ng[sb ss[bz
未得報恩不能歸	ww[ha de[ro bc[fe en[wx bu[eu ng[sb gv[ux
未睹斯民康	ww[ha du[mt si[qj mb[kv kh[gx
未妨惆悵是清狂	ww[ha fh[nf iz[xk ih[xi ui[op qk[df kl[qw
微風吹蘭杜	ww[ru fg[ji iv[kd lj[bs du[at
韋諷錄事宅觀曹將軍畫馬圖	ww[hh fg[yf lu[xu ui[hk vd[gp gr[yj cc[ho jl[dx jy[gi hx[ht ma[vv tu[ww
為感君王輾轉思	ww[dl gj[wx jy[xk wh[su vj[iu vr[ie si[tx
危乎高哉	ww[de hu[pb gc[wk zd[tk
未幾拂荊扉	ww[ha ji[pv fu[ff jk[cd fw[hf
危機之未安	ww[de ji[aj vi[dv ww[ha an[gn
惟見長江天際流	ww[xv jm[ke ih[ph jl[dg tm[hd ji[ee lq[dw
唯見江心秋月白	ww[kv jm[ke jl[dg xb[dv qq[hh yt[ke bd[po
唯見林花落	ww[kv jm[ke lb[aa hx[cr lo[cd
唯將遲暮供多病	ww[kv jl[dx ii[uz mu[co gs[rg do[xx bk[bh
唯將舊物表深情	ww[kv jl[dx jq[uo wu[nb bn[fy uf[dg qk[xf
惟將終夜長開眼	ww[xv jl[dx vs[sw ye[wr ih[ph kd[hc yj[mg
未解憶長安	ww[ha jp[dd yi[xv ih[ph an[gn
惟覺時之枕蓆	ww[xv jt[xj ui[oc vi[dv vf[ag xi[gn
為君翻作琵琶行	ww[dl jy[xk fj[px zo[rv pi[wb pa[wb xk[rh
惟憐一燈影	ww[xv lm[xr yi[hh dg[hd yk[op
未免捶楚塵埃間	ww[ha mm[dk iv[fi iu[ap if[xt ai[ts jm[mo
危檣獨夜舟	ww[de ql[at du[qi ye[wr vz[pk
衛青不敗由天幸	ww[eh qk[fo bu[eu bd[bw yz[ou tm[hd xk[tb
微霜悽悽簟色寒	ww[ru ul[ya qi[dh qi[dh dm[vx se[db hj[gd
渭水自縈秦塞曲	ww[dt uv[uu zi[pm yk[cy qb[sh sd[gt qu[ou
為他人作嫁衣裳	ww[dl ta[ry rf[pd zo[rv jx[ng yi[wy uh[xy
畏塗巉巖不可攀	ww[th tu[dr ij[[ yj[ue bu[eu ke[dk pj[ad
為問天戎竇車騎	ww[dl wf[mk tm[hd rs[gu dz[xu ie[qu qi[md
為我度量掘臼科	ww[dl wo[pf du[gn ll[oh jt[fu jq[pu ke[hd
帷幄未改神慘傷	ww[jv wo[ju ww[ha gd[kw uf[uo cj[xs uh[rr
為我一揮手	ww[dl wo[pf yi[hh hv[fg uz[su
未休關西卒	ww[ha xq[ra gr[bt xi[hk zu[wr
未央前殿月輪高	ww[ha yh[kd qm[bo dm[uj yt[ke ly[ir gc[wk
微陽下楚丘	ww[ru yh[eo xx[hb iu[ap qq[jh
維揚憶舊遊	ww[sv yh[fv yi[xv jq[uo yz[df
未搖落而先衰	ww[ha yc[fa lo[cd er[ek xm[ne uk[wk
韋應物	ww[hh yk[gx wu[nb
未有涓埃答聖朝	ww[ha yz[uo jr[dk ai[ts da[vr ug[yt ic[uo
惟有飲者留其名	ww[xv yz[uo yb[ud ve[to lq[pt qi[cb mk[xk
惟有幽人自來去	ww[xv yz[uo yz[yy rf[pd zi[pm ld[hm qu[ts
微雨靄芳原	ww[ru yu[hk ai[yy fh[cf yr[ib
惟餘鐘磬音	ww[xv yu[ur vs[jv qk[ue yb[lo
韋莊	ww[hh vl[gt
文采風流今尚存	wf[wi cd[aa fg[ji lq[dw jb[rd uh[xk cy[uz
聞蟬但益悲	wf[me ij[ib dj[ro yi[bm bw[fx
文成破體書在紙	wf[wi ig[wv po[ep ti[ra uu[vv zd[ut vi[su
聞船中夜彈琵琶者	wf[me ir[vj vs[ku ye[wr tj[gb pi[wb pa[wb ve[to
問答乃未已	wf[mk da[vr nd[vp ww[ha yi[kv
聞道故林相識多	wf[me dc[bz gu[gw lb[aa xl[am ui[yk do[xx
問道歸鳳翔	wf[mk dc[bz gv[ux fg[jy xl[yx
聞道漢家天子使	wf[me dc[bz hj[dy jx[gu tm[hd zi[lh ui[rh
聞道黃龍戍	wf[me dc[bz hl[gy ls[yp uu[wd
聞道欲來相問訊	wf[me dc[bz yu[bd ld[hm xl[am wf[mk xy[yv
聞道玉門猶被遮	wf[me dc[bz yu[wd mf[du yz[qy bw[yp ve[gz
聞風坐相悅	wf[me fg[ji zo[rr xl[am yt[xb
聞官軍收河南河北	wf[me gr[gu jy[gi uz[vw he[dk nj[uk he[dk bw[ub
聞蟪蛄之流聲	wf[me hv[ih gu[ig vi[dv lq[dw ug[um
問君何所之	wf[mk jy[xk he[rk so[pj vi[dv
問客何為來	wf[mk ke[gw he[rk ww[dl ld[hm
問劉十九	wf[mk lq[wd ui[hu jq[pv
問其人	wf[mk qi[cb rf[pd
溫泉水滑洗凝脂	wf[do qr[bu uv[uu hx[dg xi[dn nk[db vi[ob
溫庭筠	wf[do tk[gq yy[vt
文翁翻教授	wf[wi wg[bx fj[px jn[tw uz[fa
問我來何方	wf[mk wo[pf ld[hm he[rk fh[dw
問姓驚初見	wf[mk xk[np jk[xw iu[yd jm[ke
文章憎命達	wf[wi vh[lo zg[xb mk[rh da[dz
問之不肯道姓名	wf[mk vi[dv bu[eu kf[vo dc[bz xk[np mk[xk
我輩復登臨	wo[pf bw[fi fu[ro dg[dd lb[uv
我本楚狂人	wo[pf bf[ah iu[ap kl[qw rf[pd
我持長瓢坐巴丘	wo[pf ii[ft ih[ph pn[xp zo[rr ba[ku qq[jh
我從去年辭帝京	wo[pf cs[rr qu[ts nm[rn ci[ql di[lj jk[wk
我獨不得出	wo[pf du[qi bu[eu de[ro iu[ck
我歌今與君殊科	wo[pf ge[kd jb[rd yu[hv jy[xk uu[hp ke[hd
我歌月徘徊	wo[pf ge[kd yt[ke pd[rf hk[rw
我行殊未已	wo[pf hh[rh uu[hp ww[ha yi[kv
臥後清宵細細長	wo[kb hz[pk qk[df xn[gx xi[st xi[st ih[ph
我家襄水曲	wo[pf jx[gu xl[wk uv[uu qu[ou
我來正逢秋雨節	wo[pf ld[hm vg[hv fg[wz qq[hh yu[hk jp[ce
臥龍躍馬終黃土	wo[kb ls[yp yt[zp ma[vv vs[sw hl[gy tu[uh
我聞琵琶已嘆息	wo[pf wf[me pi[wb pa[wb yi[kv tj[ky xi[zx
我舞影凌亂	wo[pf wu[rx yk[op lk[dt lr[qv
我心素已閒	wo[pf xb[dv su[fy yi[kv xm[ma
我亦舉家清	wo[pf yi[wy ju[xf jx[gu qk[df
我欲因之夢吳越	wo[pf yu[bd yb[wd vi[dv mg[ax wu[kt yt[zh
我醉君復樂	wo[pf zv[yw jy[xk fu[ro le[px
吾愛孟夫子	wu[wk ai[au mg[zm fu[er zi[lh
無邊落木蕭蕭下	wu[ee bm[lz lo[cd mu[ub xn[cx xn[cx xx[hb
無才日衰老	wu[ee cd[hu ri[wh uk[wk lc[tb
吳楚東南坼	wu[kt iu[ap ds[qx nj[uk ie[tj
武帝祠前雲欲散	wu[hv di[lj ci[uv qm[bo yy[es yu[bd sj[gw
屋底達官走避胡	wu[uh di[gu da[dz gr[gu zz[tv bi[uz hu[go
無復射蛟江水中	wu[ee fu[ro ue[uc jn[il jl[dg uv[uu vs[ku
五更鼓角聲悲壯	wu[hu gg[ho gu[uu jn[do ug[um bw[fx vl[du
五更疏欲斷	wu[hu gg[ho uu[pw yu[bd dr[mj
吾觀自古賢達人	wu[wk gr[yj zi[pm gu[uk xm[ub da[dz rf[pd
武侯祠屋常鄰近	wu[hv hz[rv ci[uv wu[uh ih[xk lb[re jb[jz
嗚呼聖皇及聖相	wu[kw hu[kp ug[yt hl[bw ji[pv ug[yt xl[am
嗚呼吾意其蹉跎	wu[kw hu[kp wu[wk yi[lx qi[cb co[zy to[zg
五湖煙水獨忘機	wu[hu hu[dg yj[hw uv[uu du[qi wh[wx ji[aj
五花連錢旋作冰	wu[hu hx[cr lm[iz qm[jj xr[fr zo[rv bk[du
五花馬	wu[hu hx[cr ma[vv
武皇開邊意未已	wu[hv hl[bw kd[hc bm[lz yi[lx ww[ha yi[kv
吳姬壓酒喚客嘗	wu[kt ji[nk ya[it jq[dy hr[kd ke[gw ih[xe
無家問死生	wu[ee jx[gu wf[mk si[hx ug[pf
烏江十五兄	wu[bv jl[dg ui[hu wu[hu xs[ke
五陵北原上	wu[hu lk[et bw[ub yr[ib uh[bh
五陵佳氣無時無	wu[hu lk[et jx[rt qi[rh wu[ee ui[oc wu[ee
五陵年少爭纏頭	wu[hu lk[et nm[rn uc[xp vg[dx ij[sg tz[dd
五馬莫留連	wu[hu ma[vv mo[co lq[pt lm[iz
吾謀適不用	wu[wk mz[yg ui[qz bu[eu ys[ou
吾寧愛與憎	wu[wk nk[gd ai[au yu[hv zg[xb
悟平反之已奏	wu[xw pk[hb fj[py vi[dv yi[kv zz[st
無人收廢帳	wu[ee rf[pd uz[vw fw[gv vh[ji
無人收拾理則那	wu[ee rf[pd uz[vw ui[fr li[wo ze[bd na[ve
無人信高潔	wu[ee rf[pd xb[ry gc[wk jp[du
無如此處學長生	wu[ee ru[nk ci[vb iu[wb xt[xz vh[ph ug[pf
無使蛟龍得	wu[ee ui[rh jn[il ls[yp de[ro
五十年間似反掌	wu[hu ui[hu nm[rn jm[mo si[rs fj[py vh[xf
烏孫部落家鄉遠	wu[bv sy[zx bu[le lo[cd jx[gu xl[sp yr[ez
無題	wu[ee ti[oy
無題二首之二	wu[ee ti[oy er[hh uz[be vi[dv er[hh
無題二首之一	wu[ee ti[oy er[hh uz[be vi[dv yi[hh
梧桐相待老	wu[aw ts[ak xl[am dd[rt lc[tb
無為在歧路	wu[ee ww[dl zd[ut qi[vu lu[zw
勿謂知音稀	wu[bp ww[yt vi[uk yb[lo xi[hi
五溪衣服共雲山	wu[hu xi[da yi[wy fu[oe gs[gb yy[es uj[uk
巫峽啼猿數行淚	wu[gr xx[uj ti[kl yr[qt uu[mw hh[rh lw[dm
五言絕句	wu[hu yj[we jt[sd ju[bk
五言樂府	wu[hu yj[we yt[px fu[gr
烏衣巷	wu[bv yi[wy xl[gk
烏衣巷口夕陽斜	wu[bv yi[wy xl[gk kz[uv xi[xd yh[eo xp[rd
五月不可觸	wu[hu yt[ke bu[eu ke[dk iu[di
五嶽祭秩皆三公	wu[hu yt[qu ji[xe vi[hp jp[bb sj[hh gs[bs
五月西施採	wu[hu yt[ke xi[hk ui[fr cd[aa
悟悅心自足	wu[xw yt[xb xb[dv zi[pm zu[kv
五嶽尋仙不辭遠	wu[hu yt[qu xy[xc xm[ru bu[eu ci[ql yr[ez
吳中盛文史	wu[kt vs[ku ug[wm wf[wi ui[ki
吳中張翰稱達生	wu[kt vs[ku vh[gi hj[ur ig[hd da[dz ug[pf
戲罷曾無理曲時	xi[yg ba[st cg[bo wu[ee li[wo qu[ou ui[oc
夕避長蛇	xi[xd bi[uz ih[ph ue[ig
西鄙人	xi[hk bi[ke rf[pd
昔別君未婚	xi[go bp[kd jy[xk ww[ha hy[nu
細草微風岸	xi[st cc[co ww[ru fg[ji an[ui
細草香閒小洞幽	xi[st cc[co xl[ho xm[ma xn[ub ds[dk yz[yy
西出都門百餘裡	xi[hk iu[ck dz[te mf[du bd[eo yu[ur li[ot
夕次盱眙縣	xi[xd ci[dd xu[me yi[ms xm[qs
西當太白有鳥道	xi[hk dh[xx td[dd bd[po yz[uo nn[nh dc[bz
夕殿螢飛思悄然	xi[xd dm[uj yk[ci fw[vp si[tx qn[xx rj[xd
西風生翠蘿	xi[hk fg[ji ug[pf cv[xw lo[cs
夕奉天書拜瑣闈	xi[xd fg[sf tm[hd uu[vv bd[fh so[wx ww[mw
西宮南內多秋草	xi[hk gs[gk nj[uk nw[kr do[xx qq[hh cc[co
昔何勇銳今何愚	xi[go he[rk ys[sl rv[jb jb[rd he[rk yu[ox
溪花與禪意	xi[da hx[cr yu[hv ij[ub yi[lx
喜見外弟又言別	xi[uk jm[ke wd[xb di[bg yz[vd yj[we bp[kd
西郊胡正繁	xi[hk jn[le hu[go vg[hv fj[ry
溪居	xi[da ju[ug
細柳新蒲為誰綠	xi[st lq[ap xb[lj pu[cd ww[dl uv[yv lv[sx
西樓望月幾回圓	xi[hk lz[am wh[ww yt[ke ji[pv hv[wk yr[wk
西路蟬聲唱	xi[hk lu[zw ij[ib ug[um ih[ko
昔人已乘黃鶴去	xi[go rf[pd yi[kv ig[qb hl[gy he[gn qu[ts
昔日長城戰	xi[go ri[wh ih[ph ig[tw vj[bg
昔日橫波目	xi[go ri[wh hg[ag bo[dp mu[we
昔日太宗拳毛騧	xi[go ri[wh td[dd zs[ge qr[bf mc[sv gx[[
昔日戲言身後事	xi[go ri[wh xi[yg yj[we uf[pu hz[pk ui[hk
西塞山懷古	xi[hk sd[gt uj[uk hk[xb gu[uk
西山白雪三城戍	xi[hk uj[uk bd[po xt[yx sj[hh ig[tw uu[wd
西山寇盜莫相侵	xi[hk uj[uk kz[ge dc[dm mo[co xl[am qb[rx
西山鸞鶴群	xi[hk uj[uk lr[yn he[gn qy[xy
昔時飛箭無全目	xi[go ui[oc fw[vp jm[vb wu[ee qr[rw mu[we
西施寧久微	xi[hk ui[fr nk[gd jq[xd ww[ru
昔時燕家重郭隗	xi[go ui[oc yj[nk jx[gu vs[ph go[we ww[eg
西施詠	xi[hk ui[fr ys[kd
洗手作羹湯	xi[dn uz[su zo[rv gg[bb th[dv
昔歲逢太平	xi[go sv[ux fg[wz td[dd pk[hb
昔隨劉氏定長安	xi[go sv[eu lq[wd ui[pq dk[gp ih[ph an[gn
喜外弟盧綸見宿	xi[uk wd[xb di[bg lu[bu ly[sr jm[ke su[gr
昔聞洞庭水	xi[go wf[me ds[dk tk[gq uv[uu
棲棲一代中	xi[ax xi[ax yi[hh dd[rq vs[ku
西下峨眉峰	xi[hk xx[hb ee[up mw[mm fg[uw
夕陽度西嶺	xi[xd yh[eo du[gn xi[hk lk[ur
夕陽無限好	xi[xd yh[eo wu[ee xm[eg hc[nz
夕陽依舊壘	xi[xd yh[eo yi[ry jq[uo lw[st
昔有佳人公孫氏	xi[go yz[uo jx[rt rf[pd gs[bs sy[zx ui[pq
惜與故人違	xi[xg yu[hv gu[gw rf[pd ww[wz
西原賊入道州	xi[hk yr[ib zw[bg ru[pd dc[bz vz[dp
昔者吳人張旭善草書書帖	xi[go ve[to wu[kt rf[pd vh[gi xu[jo uj[yk cc[co uu[vv uu[vv tp[jb
羲之俗書趁姿媚	xi[bh vi[dv su[rb uu[vv if[zr zi[dn mw[nm
犀箸饜飫久未下	xi[uu vu[vt yj[ir yu[up jq[xd ww[ha xx[hb
下床畏蛇食畏藥	xx[hb il[ga ww[th ue[ig ui[rl ww[th yc[cs
夏歌	xx[ew ge[kd
下江陵	xx[hb jl[dg lk[et
下窺指高鳥	xx[hb kv[xe vi[fb gc[wk nn[nh
峽裡誰知有人事	xx[uj li[ot uv[yv vi[uk yz[uo rf[pd ui[hk
下馬飲君酒	xx[hb ma[vv yb[ud jy[xk jq[dy
夏日南亭懷辛大	xx[ew ri[wh nj[uk tk[wd hk[xb xb[lu da[hr
夏水欲滿君山青	xx[ew uv[uu yu[bd mj[dc jy[xk uj[uk qk[fo
下有衝波逆折之回川	xx[hb yz[uo is[dv bo[dp ni[nz ve[fj vi[dv hv[wk ir[pu
下有淥水之波瀾	xx[hb yz[uo lu[dx uv[uu vi[dv bo[dp lj[dm
下終南山過斛斯山人宿置酒	xx[hb vs[sw nj[uk uj[uk go[cz hu[dd si[qj uj[uk rf[pd su[gr vi[su jq[dy
閒愛孤雲靜愛僧	xm[ma ai[au gu[zp yy[es jk[fd ai[au sg[rb
閒持貝葉書	xm[ma ii[ft bw[kr ye[ku uu[vv
先帝侍女八千人	xm[ne di[lj ui[rt nv[vp ba[pd qm[pu rf[pd
先帝天馬玉花驄	xm[ne di[lj tm[hd ma[vv yu[wd hx[cr cs[mp
鮮肥屬時禁	xm[yy fw[ob uu[up ui[oc jb[ae
先拂聲弦后角羽	xm[ne fu[ff ug[um xm[gw hz[pk jn[do yu[xx
獻賦十年猶未遇	xm[uq fu[bw ui[hu nm[rn yz[qy ww[ha yu[oz
縣官急索租	xm[qs gr[gu ji[dx so[uy zu[hq
閒窺石鏡清我心	xm[ma kv[xe ui[ek jk[jl qk[df wo[pf xb[dv
閒來垂釣碧溪上	xm[ma ld[hm iv[ph dn[jb bi[we xi[da uh[bh
閒鷺棲常早	xm[ma lu[zn qi[ax ih[xk zc[ou
閒門向山路	xm[ma mf[du xl[pk uj[uk lu[zw
先期汗漫九垓上	xm[ne qi[qo hj[dg mj[do jq[pv gd[tw uh[bh
先遣小姑嘗	xm[ne qm[vz xn[ub gu[ng ih[xe
仙人掌上雨初晴	xm[ru rf[pd vh[xf uh[bh yu[hk iu[yd qk[of
先時已入人肝脾	xm[ne ui[oc yi[kv ru[pd rf[pd gj[og pi[ob
仙台初見五城樓	xm[ru td[sk iu[yd jm[ke wu[hu ig[tw lz[am
仙桃正發花	xm[ru tc[av vg[hv fa[vy hx[cr
弦弦掩抑聲聲思	xm[gw xm[gw yj[fd yi[fp ug[um ug[um si[tx
鹹言意氣高	xm[wh yj[we yi[lx qi[rh gc[wk
閒依農圃鄰	xm[ma yi[ry ns[gy pu[wf lb[re
閒倚一枝藤	xm[ma yi[rd yi[hh vi[au tg[co
仙樂風飄處處聞	xm[ru yt[px fg[ji pn[xf iu[wb iu[wb wf[me
纖雲四卷天無河	xm[sq yy[es si[we jr[be tm[hd wu[ee he[dk
仙之人兮列如麻	xm[ru vi[dv rf[pd xi[bk lp[hd ru[nk ma[ga
先主武侯同閟宮	xm[ne vu[dw wu[hv hz[rv ts[kh bi[[ gs[gk
閒坐悲君亦自悲	xm[ma zo[rr bw[fx jy[xk yi[wy zi[pm bw[fx
閒坐說玄宗	xm[ma zo[rr uo[yb xr[wy zs[ge
相悲各問年	xl[am bw[fx ge[wk wf[mk nm[rn
相對亦忘言	xl[am dv[yc yi[wy wh[wx yj[we
相逢何必曾相識	xl[am fg[wz he[rk bi[xp cg[bo xl[am ui[yk
相見時難別亦難	xl[am jm[ke ui[oc nj[yv bp[kd yi[wy nj[yv
相見語依依	xl[am jm[ke yu[yw yi[ry yi[ry
相看白刃血紛紛	xl[am kj[fm bd[po rf[dd xt[pm ff[sf ff[sf
向來吟秀句	xl[pk ld[hm yb[kr xq[hn ju[bk
鄉淚客中盡	xl[sp lw[dm ke[gw vs[ku jb[ud
相留畏曉鍾	xl[am lq[pt ww[th xn[oq vs[jv
香爐瀑布遙相望	xl[ho lu[hh pu[do bu[uj yc[az xl[am wh[ww
相期邈雲漢	xl[am qi[qo mn[pz yy[es hj[dy
鄉書不可寄	xl[sp uu[vv bu[eu ke[dk ji[gd
鄉書何處達	xl[sp uu[vv he[rk iu[wb da[dz
湘水無情吊豈知	xl[da uv[uu wu[ee qk[xf dn[kj qi[uk vi[uk
相思	xl[am si[tx
相思愁白蘋	xl[am si[tx iz[hx bd[po pk[cp
相送情無限	xl[am ss[bz qk[xf wu[ee xm[eg
向晚意不適	xl[pk wj[od yi[lx bu[eu ui[qz
相望始登高	xl[am wh[ww ui[ns dg[dd gc[wk
香霧雲鬟溼	xl[ho wu[yw yy[es hr[is ui[do
相攜及田家	xl[am xp[fv ji[pv tm[wu jx[gu
鄉心新歲切	xl[sp xb[dv xb[lj sv[ux qp[qd
香菸欲傍袞龍浮	xl[ho yj[hw yu[bd bh[rl gy[ls ls[yp fu[da
襄陽好風日	xl[wk yh[eo hc[nz fg[ji ri[wh
香葉終經宿鸞鳳	xl[ho ye[ku vs[sw jk[ss su[gr lr[yn fg[jy
相憶採芙蓉	xl[am yi[xv cd[aa fu[ce rs[cx
鄉音無改鬢毛衰	xl[sp yb[lo wu[ee gd[kw bb[ig mc[sv uk[wk
相迎不道遠	xl[am yk[pz bu[eu dc[bz yr[ez
相與烜赫流淳熙	xl[am yu[hv xr[[ he[tt lq[dw iy[dw xi[kd
銷愁鬥幾千	xn[jx iz[hx dz[du ji[pv qm[pu
曉耕翻露草	xn[oq gg[le fj[px lu[yz cc[co
孝恭遵婦道	xn[tz gs[gx zy[bz fu[nx dc[bz
簫鼓哀吟感鬼神	xn[vx gu[uu ai[wk yb[kr gj[wx gv[be uf[uo
小姑居處本無郎	xn[ub gu[ng ju[ug iu[wb bf[ah wu[ee lh[le
簫鼓喧喧漢將營	xn[vx gu[uu xr[kg xr[kg hj[dy jl[dx yk[ck
霄漢長懷捧日心	xn[yx hj[dy ih[ph hk[xb pg[fs ri[wh xb[dv
曉汲清湘燃楚燭	xn[oq ji[dj qk[df xl[da rj[hx iu[ap vu[hi
曉鏡但愁雲鬢改	xn[oq jk[jl dj[ro iz[hx yy[es bb[ig gd[kw
效顰安可希	xn[lw pb[vb an[gn ke[dk xi[iu
曉是舞者	xn[oq ui[op wu[rx ve[to
蕭疏鬢已斑	xn[cx uu[pw bb[ig yi[kv bj[ww
曉隨天仗入	xn[oq sv[eu tm[hd vh[rh ru[pd
蕭條異代不同時	xn[cx tn[wa yi[kc dd[rq bu[eu ts[kh ui[oc
校尉羽書飛瀚海	xn[al ww[uc yu[xx uu[vv fw[vp hj[du hd[dr
笑問客從何處來	xn[vp wf[mk ke[gw cs[rr he[rk iu[wb ld[hm
小弦切切如私語	xn[ub xm[gw qp[qd qp[qd ru[nk si[hs yu[yw
蕭蕭班馬鳴	xn[cx xn[cx bj[wd ma[vv mk[kn
逍遙池閣涼	xn[xz yc[az ii[dy ge[mw ll[dw
小園花亂飛	xn[ub yr[we hx[cr lr[qv fw[vp
曉月過殘壘	xn[oq yt[ke go[cz cj[hj lw[st
斜拔玉釵燈影畔	xp[rd ba[fu yu[wd id[jy dg[hd yk[op pj[tb
謝公宿處今尚在	xp[yu gs[bs su[gr iu[wb jb[rd uh[xk zd[ut
謝公行處蒼苔沒	xp[yu gs[bs xk[rh iu[wb ch[cr td[cs mw[dj
謝公最小偏憐女	xp[yu gs[bs zv[oe xn[ub pm[rh lm[xr nv[vp
斜光照墟落	xp[rd gl[xe vc[od xu[th lo[cd
斜倚薰籠坐到明	xp[rd yi[rd xy[cp ls[vy zo[rr dc[hd mk[oo
新炊間黃粱	xb[lj iv[hd jm[mo hl[gy ll[dm
心斷新豐酒	xb[dv dr[mj xb[lj fg[su jq[dy
新鬼煩冤舊鬼哭	xb[lj gv[be fj[hy yr[gd jq[uo gv[be ku[kq
新嫁娘	xb[lj jx[ng nl[nl
新年作	xb[lj nm[rn zo[rv
心期臥亦賒	xb[dv qi[qo wo[kb yi[wy ue[br
心輕萬事皆鴻毛	xb[dv qk[is wj[hv ui[hk jp[bb hs[dn mc[sv
新人美如玉	xb[lj rf[pd mw[bw ru[nk yu[wd
心隨明月到胡天	xb[dv sv[eu mk[oo yt[ke dc[hd hu[go tm[hd
心隨雁飛滅	xb[dv sv[eu yj[ir fw[vp mp[hh
欣欣此生意	xb[jd xb[jd ci[vb ug[pf yi[lx
心異於曩時	xb[dv yi[kc yu[fr nh[ow ui[oc
心有靈犀一點通	xb[dv yz[uo lk[xh xi[uu yi[hh dm[bd ts[sz
信知生男惡	xb[ry vi[uk ug[pf nj[tl ee[hx
新知遭薄俗	xb[lj vi[uk zc[hz bo[cd su[rb
新妝宜面下朱樓	xb[lj vl[dn yi[gq mm[ew xx[hb vu[ph lz[am
星垂平野闊	xk[op iv[ph pk[hb ye[oy ko[md
幸此南夷謫	xk[tb ci[vb nj[uk yi[hg ve[yl
性達形跡忘	xk[xp da[dz xk[kp ji[yz wh[wx
行到水窮處	xk[rh dc[hd uv[uu qs[xl iu[wb
行到中庭數花朵	xk[rh dc[hd vs[ku tk[gq uu[mw hx[cr do[ja
行宮	xk[rh gs[gk
行宮見月傷心色	xk[rh gs[gk jm[ke yt[ke uh[rr xb[dv se[db
星宮之君醉瓊漿	xk[op gs[gk vi[dv jy[xk zv[yw qs[ww jl[du
星河秋一雁	xk[op he[dk qq[hh yi[hh yj[ir
興盡方下山	xk[xb jb[ud fh[dw xx[hb uj[uk
行盡青溪不見人	xk[rh jb[ud qk[fo xi[da bu[eu jm[ke rf[pd
行經華陰	xk[rh jk[ss hx[ru yb[eo
行軍司馬智且勇	xk[rh jy[gi si[vh ma[vv vi[uo qp[ke ys[sl
興來美獨往	xk[xb ld[hm mw[bw du[qi wh[rd
行樂須及春	xk[rh le[px xu[py ji[pv iy[so
星臨萬戶動	xk[op lb[uv wj[hv hu[du ds[el
行路難	xk[rh lu[zw nj[yv
行路難三首之二	xk[rh lu[zw nj[yv sj[hh uz[be vi[dv er[hh
行路難三首之三	xk[rh lu[zw nj[yv sj[hh uz[be vi[dv sj[hh
行路難三首之一	xk[rh lu[zw nj[yv sj[hh uz[be vi[dv yi[hh
行人但云點行頻	xk[rh rf[pd dj[ro yy[es dm[bd hh[rh pb[vy
行人刁斗風沙暗	xk[rh rf[pd dn[vh dz[du fg[ji ua[dx an[ol
行人弓箭各在腰	xk[rh rf[pd gs[kv jm[vb ge[wk zd[ut yc[ox
興是清秋髮	xk[xb ui[op qk[df qq[hh fa[vy
醒時同交歡	xk[yo ui[oc ts[kh jn[li hr[yd
興因廬山發	xk[xb yb[wd lu[gh uj[uk fa[vy
星月掩映雲朣朧	xk[op yt[ke yj[fd yk[ok yy[es ts[[ ls[oy
行舟綠水前	xk[rh vz[pk lv[sx uv[uu qm[bo
兄弟離散	xs[ke di[bg li[wk sj[gw
兄弟遭殺戮	xs[ke di[bg zc[hz ua[ia lu[xg
雄飛雌從繞林間	xs[uv fw[vp ci[vv cs[rr rc[sq lb[aa jm[mo
匈奴草黃馬正肥	xs[bi nu[ny cc[co hl[gy ma[vv vg[hv fw[ob
熊咆龍吟殷巖泉	xs[sd pc[kb ls[yp yb[kr yb[pj yj[ue qr[bu
羞將白髮對華簪	xq[yi jl[dx bd[po fa[vy dv[yc hx[ru zj[vj
繡羅衣裳照暮春	xq[sh lo[sx yi[wy uh[xy vc[od mu[co iy[so
羞顏未嘗開	xq[yi yj[ly ww[ha ih[xe kd[hc
羞逐長安社中兒	xq[yi vu[uz ih[ph an[gn ue[ut vs[ku er[pv
許渾	xu[yw hy[dg
須盡丘壑美	xu[py jb[ud qq[jh he[bt mw[bw
墟里上孤煙	xu[th li[ot uh[bh gu[zp yj[hw
須如蝟毛磔	xu[py ru[nk ww[qt mc[sv ve[ex
須行即騎訪名山	xu[py xk[rh ji[ge qi[md fh[yf mk[xk uj[uk
須臾靜掃眾峰出	xu[py yu[jr jk[fd sc[fx vs[rr fg[uw iu[ck
宣王憤起揮天戈	xr[gh wh[su ff[xu qi[zk hv[fg tm[hd ge[qp
宣州謝朓樓餞別校書叔雲	xr[gh vz[dp xp[yu tn[[ lz[am jm[uj bp[kd xn[al uu[vv uu[uy yy[es
薛逢	xt[cp fg[wz
雪膚花貌參差是	xt[yx fu[oe hx[cr mc[pb cf[sd ci[yg ui[op
血色羅裙翻酒汙	xt[pm se[db lo[sx qy[yx fj[px jq[dy wu[dh
雪上空留馬行處	xt[yx uh[bh ks[xg lq[pt ma[vv xk[rh iu[wb
學書初學衛夫人	xt[xz uu[vv iu[yd xt[xz ww[eh fu[er rf[pd
血汙遊魂歸不得	xt[pm wu[dh yz[df hy[eg gv[ux bu[eu de[ro
循環不可尋	xy[rp hr[wb bu[eu ke[dk xy[xc
尋陸鴻漸不遇	xy[xc lu[ef hs[dn jm[di bu[eu yu[oz
尋南溪常山道人隱居	xy[xc nj[uk xi[da ih[xk uj[uk dc[bz rf[pd yb[ed ju[ug
尋聲暗問彈者誰	xy[xc ug[um an[ol wf[mk dj[gb ve[to uv[yv
尋西山隱者不遇	xy[xc xi[hk uj[uk yb[ed ve[to bu[eu yu[oz
潯言江頭夜送客	xy[dx yj[we jl[dg tz[dd ye[wr ss[bz ke[gw
潯陽地僻無音樂	xy[dx yh[eo di[ty pi[ru wu[ee yb[lo yt[px
尋隱者不遇	xy[xc yb[ed ve[to bu[eu yu[oz
亞相勤王甘苦辛	ya[hy xl[am qb[nl wh[su gj[nh ku[cg xb[lu
煙波江上使人愁	yj[hw bo[dp jl[dg uh[bh ui[rh rf[pd iz[hx
燕草如碧絲	yj[nk cc[co ru[nk bi[we si[sh
言遲更速皆應手	yj[we ii[uz gg[ho su[hz jp[bb yk[gx uz[su
眼穿仍欲歸	yj[mg ir[xy rg[rn yu[bd gv[ux
焉得置之貢玉堂	yj[hh de[ro vi[su vi[dv gs[gb yu[wd th[xt
巖扉松徑長寂寥	yj[ue fw[hf ss[ab jk[rs ih[ph ji[gu ln[gx
燕歌行並序	yj[nk ge[kd xk[rh bk[bk xu[gy
煙花三月下揚州	yj[hw hx[cr sj[hh yt[ke xx[hb yh[fv vz[dp
沿洄安得住	yj[dj hv[dw an[gn de[ro vu[rd
掩淚空相向	yj[fd lw[dm ks[xg xl[am xl[pk
煙籠寒水月籠沙	yj[hw ls[vy hj[gd uv[uu yt[ke ls[vy ua[dx
煙鳥棲初定	yj[hw nn[nh qi[ax iu[yd dk[gp
言訖屢頷天子頤	yj[we qi[yr lv[um hj[ry tm[hd zi[lh yi[ky
宴寢凝清香	yj[go qb[gd nk[db qk[df xl[ho
言入黃花川	yj[we ru[pd hl[gy hx[cr ir[pu
豔色天下重	yj[fd se[db tm[hd xx[hb vs[ph
巖上無心雲相逐	yj[ue uh[bh wu[ee xb[dv yy[es xl[am vu[uz
言師採藥去	yj[we ui[uh cd[aa yc[cs qu[ts
燕臺一去客心驚	yj[nk td[sk yi[hh qu[ts ke[gw xb[dv jk[xw
煙濤微茫信難求	yj[hw tc[df ww[ru mh[cd xb[ry nj[yv qq[hu
燕尾繡蝥弧	yj[nk ww[um xq[sh mc[yi hu[gp
雁下蘆洲白	yj[ir xx[hb lu[ch vz[dd bd[po
煙銷日出不見人	yj[hw xn[jx ri[wh iu[ck bu[eu jm[ke rf[pd
演漾在窗戶	yj[dg yh[db zd[ut il[xp hu[du
焉知二十載	yj[hh vi[uk er[hh ui[hu zd[ti
陽春一曲和皆難	yh[eo iy[so yi[hh qu[ou he[hk jp[bb nj[yv
羊公碑字在	yh[bs gs[bs bw[eb zi[gz zd[ut
陽和不散窮途恨	yh[eo he[hk bu[eu sj[gw qs[xl tu[rz hf[xg
楊花雪落覆白蘋	yh[av hx[cr xt[yx lo[cd fu[xr bd[po pk[cp
楊家有女初長成	yh[av jx[gu yz[uo nv[vp iu[yd vh[ph ig[wv
仰見突兀撐青空	yh[rp jm[ke tu[xq wu[he ig[fx qk[fo ks[xg
仰聆金玉章	yh[rp lk[er jb[rw yu[wd vh[lo
楊柳散和風	yh[av lq[ap sj[gw he[hk fg[ji
漾漾泛菱荇	yh[db yh[db fj[dp lk[ct xk[cr
揚揚燕新乳	yh[fv yh[fv yj[nk xb[lj ru[av
陽月南飛雁	yh[eo yt[ke nj[uk fw[vp yj[ir
養在深閨人未識	yh[yp zd[ut uf[dg gv[mt rf[pd ww[ha ui[yk
遙隔楚雲端	yc[az ge[eh iu[ap yy[es dr[lu
遙寄海西頭	yc[az ji[gd hd[dr xi[hk tz[dd
遙見仙人彩雲裡	yc[az jm[ke xm[ru rf[pd cd[ap yy[es li[ot
遙看一處攢雲樹	yc[az kj[fm yi[hh iu[wb cr[fn yy[es uu[ay
遙窺正殿簾開處	yc[az kv[xe vg[hv dm[uj lm[xj kd[hc iu[wb
遙憐小兒女	yc[az lm[xr xn[ub er[pv nv[vp
搖落深知宋玉悲	yc[fa lo[cd uf[dg vi[uk ss[ga yu[wd bw[fx
邀人傅脂粉	yc[bz rf[pd fu[rf vi[ob ff[mf
邀入赤松家	yc[bz ru[pd ii[ty ss[ab jx[gu
窈窕丹青戶牖空	yc[xy tn[xv dj[kw qk[fo hu[du yz[ph ks[xg
邀我至田家	yc[bz wo[pf vi[ht tm[wu jx[gu
腰下寶玦青青珊瑚	yc[ox xx[hb bc[gw jt[wv qk[fo qk[fo uj[wk hu[wg
腰懸相印作都統	yc[ox xr[qx xl[am yb[pe zo[rv du[te ts[sw
杳杳鐘聲晚	yc[ao yc[ao vs[jv ug[um wj[od
遙夜泛清瑟	yc[az ye[wr fj[dp qk[df se[wx
藥院滋苔紋	yc[cs yr[eg zi[db td[cs wf[sw
遙知兄弟登高處	yc[az vi[uk xs[ke di[bg dg[dd gc[wk iu[wb
夜半無人私語時	ye[wr bj[bf wu[ee rf[pd si[hs yu[yw ui[oc
夜半鐘聲到客船	ye[wr bj[bf vs[jv ug[um dc[hd ke[gw ir[vj
夜榜響溪石	ye[wr bh[al xl[kp xi[da ui[ek
夜泊牛渚懷古	ye[wr bo[db nq[pf vu[dt hk[xb gu[uk
夜泊秦淮近酒家	ye[wr bo[db qb[sh hk[dv jb[jz jq[dy jx[gu
也曾因夢送錢財	ye[vu cg[bo yb[wd mg[ax ss[bz qm[jj cd[bc
野渡無人舟自橫	ye[oy du[dg wu[ee rf[pd vz[pk zi[pm hg[ag
夜飛延秋門上呼	ye[wr fw[vp yj[pj qq[hh mf[du uh[bh hu[kp
業復五銖錢	ye[ub fu[ro wu[hu vu[jp qm[jj
夜歸鹿門山歌	ye[wr gv[ux lu[gb mf[du uj[uk ge[kd
謁衡岳廟遂宿嶽寺題門樓	ye[yo hg[rd yt[qu mn[gy sv[bz su[gr yt[qu si[tc ti[oy mf[du lz[am
野火燒不盡	ye[oy ho[dp uc[hq bu[eu jb[ud
野徑入桑麻	ye[oy jk[rs ru[pd sh[ya ma[ga
夜久侵羅襪	ye[wr jq[xd qb[rx lo[sx wa[yh
曳裾王門不稱情	ye[ov ju[yu wh[su mf[du bu[eu ig[hd qk[xf
野哭千家聞戰伐	ye[oy ku[kq qm[pu jx[gu wf[me vj[bg fa[rg
野曠天低樹	ye[oy kl[og tm[hd di[ru uu[ay
夜來風雨聲	ye[wr ld[hm fg[ji yu[hk ug[um
野老念牧童	ye[oy lc[tb nm[rx mu[nw ts[lo
野老與人爭席罷	ye[oy lc[tb yu[hv rf[pd vg[dx xi[gn ba[st
野鹿呦呦走堂下	ye[oy lu[gb yz[ky yz[ky zz[tv th[xt xx[hb
野幕蔽瓊筵	ye[oy mu[cj bi[cb qs[ww yj[vp
耶孃妻子走相送	ye[ee nl[nl qi[hn zi[lh zz[tv xl[am ss[bz
夜上受降城聞笛	ye[wr uh[bh uz[ay xl[ew ig[tw wf[me di[vy
夜深忽夢少年事	ye[wr uf[dg hu[bx mg[ax uc[xp nm[rn ui[hk
夜深靜臥百蟲絕	ye[wr uf[dg jk[fd wo[kb bd[eo is[ks jt[sd
夜深前殿按歌聲	ye[wr uf[dg qm[bo dm[uj an[fg ge[kd ug[um
野蔬充膳甘長藿	ye[oy uu[cp is[we uj[oy gj[nh ih[ph ho[cy
夜思	ye[wr si[tx
野寺人來少	ye[oy si[tc rf[pd ld[hm uc[xp
夜投佛寺上高閣	ye[wr tz[fj fo[rf si[tc uh[bh gc[wk ge[mw
野望	ye[oy wh[ww
鄴縣見公孫大娘舞西河劍器	ye[ye xm[qs jm[ke gs[bs sy[zx da[hr nl[nl wu[rx xi[hk he[dk jm[rd qi[kq
夜吟應覺月光寒	ye[wr yb[kr yk[gx jt[xj yt[ke gl[xe hj[gd
夜雨剪春韭	ye[wr yu[hk jm[bd iy[so jq[fh
夜雨聞鈴腸斷聲	ye[wr yu[hk wf[me lk[jr ih[ov dr[mj ug[um
夜月愁空山	ye[wr yt[ke iz[hx ks[xg uj[uk
野雲萬里無城郭	ye[oy yy[es wj[hv li[ot wu[ee ig[tw go[we
一杯相屬君當歌	yi[hh bw[ab xl[am vu[up jy[xk dh[xx ge[kd
一別音容兩渺茫	yi[hh bp[kd yb[lo rs[xr ll[hk mn[dm mh[cd
儀曹外郎載筆隨	yi[rd cc[ho wd[xb lh[le zd[ti bi[vm sv[eu
一川碎石大如鬥	yi[hh ir[pu sv[ew ui[ek da[hr ru[nk dz[du
移船相近邀相見	yi[hx ir[vj xl[am jb[jz yc[bz xl[am jm[ke
依叢適自憩	yi[ry cs[rh ui[qz zi[pm qi[qx
一寸相思一寸灰	yi[hh cy[hu xl[am si[tx yi[hh cy[hu hv[uh
一夫當關	yi[hh fu[er dh[xx gr[bt
役夫敢申恨	yi[rj fu[er gj[vw uf[ou hf[xg
夷歌數處起漁樵	yi[hg ge[kd uu[mw iu[wb qi[zk yu[dy qn[av
移官豈至尊	yi[hx gr[gu qi[uk vi[ht zy[bc
遺恨失吞吳	yi[vz hf[xg ui[pe ty[tk wu[kt
以火來照所見稀	yi[sr ho[dp ld[hm vc[od so[pj jm[ke xi[hi
移家雖帶郭	yi[hx jx[gu sv[ki dd[cj go[we
一劍曾當百萬師	yi[hh jm[rd cg[bo dh[xx bd[eo wj[hv ui[uh
一箭正墜雙飛翼	yi[hh jm[vb vg[hv vv[et ul[yy fw[vp yi[xt
意匠慘淡經營中	yi[lx jl[kj cj[xs dj[dh jk[ss yk[ck vs[ku
已經百日竄荊棘	yi[kv jk[ss bd[eo ri[wh cr[xk jk[cd ji[cc
一舉累十觴	yi[hh ju[xf lw[ty ui[hu uh[dr
憶君迢迢隔青天	yi[xv jy[xk tn[dz tn[dz ge[eh qk[fo tm[hd
意恐遲遲歸	yi[lx ks[gx ii[uz ii[uz gv[ux
一覽眾山小	yi[hh lj[uj vs[rr uj[uk xn[ub
倚立自移時	yi[rd li[lh zi[pm yi[hx ui[oc
一路經行處	yi[hh lu[zw jk[ss xk[rh iu[wb
亦能畫馬窮殊相	yi[wy ng[sb hx[ht ma[vv qs[xl uu[hp xl[am
一年明月今宵多	yi[hh nm[rn mk[oo yt[ke jb[rd xn[gx do[xx
一片冰心在玉壺	yi[hh pm[pu bk[du xb[dv zd[ut yu[wd hu[uy
一片降幡出石頭	yi[hh pm[pu jl[ew fj[jp iu[ck ui[ek tz[dd
意氣驕奢劇季倫	yi[lx qi[rh jn[mp ue[dt ju[ud ji[hz ly[rr
一丘嘗欲臥	yi[hh qq[jh ih[xe yu[bd wo[kb
一曲紅綃不知數	yi[hh qu[ou hs[sg xn[sx bu[eu vi[uk uu[mw
一去紫臺連朔漠	yi[hh qu[ts zi[vy td[sk lm[iz uo[no mo[dc
怡然敬父執	yi[xs rj[xd jk[cw fu[bi vi[fj
已忍伶俜十年事	yi[kv rf[dx lk[rr pk[ry ui[hu nm[rn ui[hk
衣上灞陵雨	yi[wy uh[bh ba[dy lk[et yu[hk
衣裳已施行看盡	yi[wy uh[xy yi[kv ui[fr xk[rh kj[fm jb[ud
一身轉戰三千里	yi[hh uf[pu vr[ie vj[bg sj[hh qm[pu li[ot
一生好入名山遊	yi[hh ug[pf hc[nz ru[pd mk[xk uj[uk yz[df
一聲何滿子	yi[hh ug[um he[rk mj[dc zi[lh
一聲已動物皆靜	yi[hh ug[um yi[kv ds[el wu[nb jp[bb jk[fd
衣食才足甘長終	yi[wy ui[rl cd[hu zu[kv gj[nh ih[ph vs[sw
疑是地上霜	yi[bs ui[op di[ty uh[bh ul[ya
以手撫膺坐長嘆	yi[sr uz[su fu[fe yk[go zo[rr ih[ph tj[ky
一樹碧無情	yi[hh uu[ay bi[we wu[ee qk[xf
驛樹西連漢畤平	yi[my uu[ay xi[hk lm[iz hj[dy iz[[ pk[hb
已似長沙傅	yi[kv si[rs ih[ph ua[dx fu[rf
一歲一枯榮	yi[hh sv[ux yi[hh ku[ag rs[ca
一彈一十有八拍	yi[hh tj[gb yi[hh ui[hu yz[uo ba[pd pd[fb
一體君臣祭祀同	yi[hh ti[ra jy[xk if[ku ji[xe si[uk ts[kh
義往難復留	yi[di wh[rd nj[yv fu[ro lq[pt
以為封禪玉檢明堂基	yi[sr ww[dl fg[tc uj[ub yu[wd jm[ar mk[oo th[xt ji[qt
一為取龍城	yi[hh ww[dl qu[ey ls[yp ig[tw
以我獨沉久	yi[sr wo[pf du[qi if[dg jq[xd
一舞劍器動四方	yi[hh wu[rx jm[rd qi[kq ds[el si[we fh[dw
疑誤有新知	yi[bs wu[yk yz[uo xb[lj vi[uk
憶昔初蒙博士徵	yi[xv xi[go iu[yd mg[ch bo[uf ui[uh vg[rh
憶昔霓旌下南苑	yi[xv xi[go ni[yj jk[fr xx[hb nj[uk yr[cx
一洗萬古凡馬空	yi[hh xi[dn wj[hv gu[uk fj[jd ma[vv ks[xg
憶昔巡幸新豐宮	yi[xv xi[go xy[vz xk[tb xb[lj fg[su gs[gk
一弦一柱思華年	yi[hh xm[gw yi[hh vu[ad si[tx hx[ru nm[rn
一宿行人自可愁	yi[hh xq[gr xk[rh rf[pd zi[pm ke[dk iz[hx
噫吁戲	yi[kl xu[ke xi[yg
遺言冀可冥	yi[vz yj[we ji[bt ke[dk mk[go
一夜飛渡鏡湖月	yi[hh ye[wr fw[vp du[dg jk[jl hu[dg yt[ke
一夜鄉心五處同	yi[hh ye[wr xl[sp xb[dv wu[hu iu[wb ts[kh
一夜絮徵袍	yi[hh ye[wr xu[ny vg[rh pc[yb
一夜徵人盡望鄉	yi[hh ye[wr vg[rh rf[pd jb[ud wh[ww xl[sp
一一生綠苔	yi[hh yi[hh ug[pf lv[sx td[cs
意疑倚巴丘	yi[lx yi[bs yi[rd ba[ku qq[jh
邑有流亡愧俸錢	yi[kb yz[uo lq[dw wh[wv kv[xg fg[rs qm[jj
意欲凌風翔	yi[lx yu[bd lk[dt fg[ji xl[yx
倚杖柴門外	yi[rd vh[ah id[va mf[du wd[xb
倚杖候荊扉	yi[rd vh[ah hz[ru jk[cd fw[hf
一朝選在君王側	yi[hh vc[uo xr[nz zd[ut jy[xk wh[su ce[rb
弋者何所慕	yi[qd ve[to he[rk so[pj mu[cx
移舟泊煙渚	yi[hx vz[pk bo[db yj[hw vu[dt
貽諸知己	yi[bs vu[yt vi[uk ji[kv
憶昨路繞錦亭東	yi[xv zo[ov lu[zw rc[sq jb[jb tk[wd ds[qx
以作時世賢	yi[sr zo[rv ui[oc ui[nv xm[ub
引臂向魚取酒	yb[gu bi[uo xl[pk yu[dt qu[ey jq[dy
因出此門	yb[wd iu[ck ci[vb mf[du
隱處唯孤雲	yb[ed iu[wb ww[kv gu[zp yy[es
因而和焉	yb[wd er[ek he[hk yj[hh
陰風慘澹天王旗	yb[eo fg[ji cj[xs dj[dd tm[hd wh[su qi[fr
因風想玉珂	yb[wd fg[ji xl[ax yu[wd ke[wk
引竿自刺船	yb[gu gj[vg zi[pm ci[cd ir[vj
飲高秋之墜露	yb[ud gc[wk qq[hh vi[dv vv[et lu[yz
銀河倒掛三石樑	yb[jg he[dk dc[rh gx[ft sj[hh ui[ek ll[da
飲馬渡秋水	yb[ud ma[vv du[dg qq[hh uv[uu
銀瓶乍破水漿迸	yb[jg pk[bw va[ru po[ep uv[uu jl[du bg[bz
陰氣晦昧無清風	yb[eo qi[rh hv[or mw[oh wu[ee qk[df fg[ji
吟喬	yb[kr qn[pp
陰晴眾壑殊	yb[eo qk[of vs[rr he[bt uu[hp
因望月有感	yb[wd wh[ww yt[ke yz[uo gj[wx
因為長句	yb[wd ww[dl ih[ph ju[bk
因休暇	yb[wd xq[ra xx[ok
陰陽割昏曉	yb[eo yh[eo ge[gd hy[uo xn[oq
隱隱飛橋隔野煙	yb[ed yb[ed fw[vp qn[ap ge[eh ye[oy yj[hw
陰陰夏木囀黃鸝	yb[eo yb[eo xx[ew mu[ub vr[ki hl[gy li[hn
隱者自怡悅	yb[ed ve[to zi[pm yi[xs yt[xb
因之傳遠情	yb[wd vi[dv ir[re yr[ez qk[xf
影動倒景搖瀟湘	yk[op ds[el dc[rh jk[ow yc[fa xn[dc xl[da
應共冤魂語	yk[gx gs[gb yr[gd hy[eg yu[yw
應見隴頭梅	yk[gx jm[ke ls[ey tz[dd mw[ar
應將性命逐輕車	yk[gx jl[dx xk[xp mk[rh vu[uz qk[is ie[qu
映階碧草自春色	yk[ok jp[er bi[we cc[co zi[pm iy[so se[db
應節為變	yk[gx jp[ce ww[dl bm[yy
英靈盡來歸	yk[ck lk[xh jb[ud ld[hm gv[ux
影落明湖青黛光	yk[op lo[cd mk[oo hu[dg qk[fo dd[rh gl[xe
應是釣秋水	yk[gx ui[op dn[jb qq[hh uv[uu
鶯啼送客聞	yk[cn ti[kl ss[bz ke[gw wf[me
鶯啼燕語報新年	yk[cn ti[kl yj[nk yu[yw bc[fe xb[lj nm[rn
影徒隨我身	yk[op tu[rz sv[eu wo[pf uf[pu
鸚鵡前頭不敢言	yk[bn wu[wn qm[bo tz[dd bu[eu gj[vw yj[we
英雄割據雖已矣	yk[ck xs[uv ge[gd ju[fu sv[ki yi[kv yi[su
應有未招魂	yk[gx yz[uo ww[ha vc[fd hy[eg
應知故鄉事	yk[gx vi[uk gu[gw xl[sp ui[hk
鶯囀皇州春色闌	yk[cn vr[ki hl[bw vz[dp iy[so se[db lj[mh
英姿颯爽猶酣戰	yk[ck zi[dn sa[lf ul[di yz[qy hj[yg vj[bg
永懷愁不寐	ys[dv hk[xb iz[hx bu[eu mw[gp
永懷當此節	ys[dv hk[xb dh[xx ci[vb jp[ce
詠懷古蹟五首之二	ys[kd hk[xb gu[uk ji[yz wu[hu uz[be vi[dv er[hh
詠懷古蹟五首之三	ys[kd hk[xb gu[uk ji[yz wu[hu uz[be vi[dv sj[hh
詠懷古蹟五首之四	ys[kd hk[xb gu[uk ji[yz wu[hu uz[be vi[dv si[we
詠懷古蹟五首之五	ys[kd hk[xb gu[uk ji[yz wu[hu uz[be vi[dv wu[hu
詠懷古蹟五首之一	ys[kd hk[xb gu[uk ji[yz wu[hu uz[be vi[dv yi[hh
擁彗折節無嫌猜	ys[fo hv[fx ve[fj jp[ce wu[ee xm[nb cd[qf
永結無情遊	ys[dv jp[su wu[ee qk[xf yz[df
永日方慼慼	ys[dv ri[wh fh[dw qi[wu qi[wu
詠神聖功書之碑	ys[kd uf[uo ug[yt gs[gl uu[vv vi[dv bw[eb
永夜角聲悲自語	ys[dv ye[wr jn[do ug[um bw[fx zi[pm yu[yw
猶抱琵琶半遮面	yz[qy bc[fb pi[wb pa[wb bj[bf ve[gz mm[ew
有悲往事	yz[uo bw[fx wh[rd ui[hk
有弟皆分散	yz[uo di[bg jp[bb ff[bd sj[gw
有耳莫洗潁川水	yz[uo er[hu mo[co xi[dn yk[by ir[pu uv[uu
有古槐數株焉	yz[uo gu[uk hk[ag uu[mw vu[ap yj[hh
有酒不飲奈明何	yz[uo jq[dy bu[eu yb[ud nd[de mk[oo he[rk
幽居默默如藏逃	yz[yy ju[ug mo[hq mo[hq ru[nk ch[cw tc[vz
幽居在空谷	yz[yy ju[ug zd[ut ks[xg gu[bk
猶堪一戰取功勳	yz[qy kj[tq yi[hh vj[bg qu[ey gs[gl xy[kl
有口莫食首陽蕨	yz[uo kz[uv mo[co ui[rl uz[be yh[eo jt[ci
由來輕七尺	yz[ou ld[hm qk[is qi[hv ii[ud
由來征戰地	yz[ou ld[hm vg[rh vj[bg di[ty
有目斯開	yz[uo mu[we si[qj kd[hc
有切嘗聞	yz[uo qp[qd ih[xe wf[me
幽人歸獨臥	yz[yy rf[pd gv[ux du[qi wo[kb
幽人應未眠	yz[yy rf[pd yk[gx ww[ha mm[mm
猶是孤帆一日程	yz[qy ui[op gu[zp fj[jj yi[hh ri[wh ig[hk
有時空望孤雲高	yz[uo ui[oc ks[xg wh[ww gu[zp yy[es gc[wk
猶似霓裳羽衣舞	yz[qy si[rs ni[yj uh[xy yu[xx yi[wy wu[rx
又送王孫去	yz[vd ss[bz wh[su sy[zx qu[ts
幼為長所育	yz[yl ww[dl vh[ph so[pj yu[wo
又聞此語重唧唧	yz[vd wf[me ci[vb yu[yw vs[ph ji[kg ji[kg
又聞子規啼	yz[vd wf[me zi[lh gv[ej ti[kl
有仙都羽化之靈姿	yz[uo xm[ru du[te yu[xx hx[rq vi[dv lk[xh zi[dn
又向人家啄大屋	yz[vd xl[pk rf[pd jx[gu vo[ku da[hr wu[uh
幽咽泉流水下灘	yz[yy ye[kw qr[bu lq[dw uv[uu xx[hb tj[dy
幽意無斷絕	yz[yy yi[lx wu[ee dr[mj jt[sd
猶疑照顏色	yz[qy yi[bs vc[od yj[ly se[db
有翼自薄	yz[uo yi[xt zi[pm bo[cd
幽音變調忽飄灑	yz[yy yb[lo bm[yy dn[yk hu[bx pn[xf sa[dx
幽映每白日	yz[yy yk[ok mw[rm bd[po ri[wh
悠悠生死別經年	yz[rx yz[rx ug[pf si[hx bp[kd jk[ss nm[rn
遊子久不至	yz[df zi[lh jq[xd bu[eu vi[ht
猶自夢漁樵	yz[qy zi[pm mg[ax yu[dy qn[av
遊子身上衣	yz[df zi[lh uf[pu uh[bh yi[wy
遊子吟	yz[df zi[lh yb[kr
猶自音書滯一鄉	yz[qy zi[pm yb[lo uu[vv vi[dc yi[hh xl[sp
語罷暮天鍾	yu[yw ba[st mu[co tm[hd vs[jv
欲把一麾江海去	yu[bd ba[fb yi[hh hv[gm jl[dg hd[dr qu[ts
愈拜稽首蹈且舞	yu[rx bd[fh qi[hy uz[be dc[za qp[ke wu[rx
欲持一瓢酒	yu[bd ii[ft yi[hh pn[xp jq[dy
予出官二年恬然自安	yu[sv iu[ck gr[gu er[hh nm[rn tm[xq rj[xd zi[pm an[gn
御廚絡繹送八珍	yu[rw iu[id lo[sw yi[sy ss[bz ba[pd vf[wr
玉璫緘札何由達	yu[wd dh[wx jm[sw va[av he[rk yz[ou da[dz
欲得周郎顧	yu[bd de[ro vz[kt lh[le gu[iy
玉殿虛無野寺中	yu[wd dm[uj xu[hy wu[ee ye[oy si[tc vs[ku
欲渡黃河冰塞川	yu[bd du[dg hl[gy he[dk bk[du sd[gt ir[pu
與爾同消萬古愁	yu[hv er[dx ts[kh xn[dx wj[hv gu[uk iz[hx
與高適薛據登慈恩寺浮圖	yu[hv gc[wk ui[qz xt[cp ju[fu dg[dd ci[bx en[wx si[tc fu[da tu[ww
漁歌入浦深	yu[dy ge[kd ru[pd pu[df uf[dg
餘公孫大娘弟子也	yu[re gs[bs sy[zx da[hr nl[nl di[bg zi[lh ye[vu
玉虎牽絲汲井回	yu[wd hu[hj qm[dg si[sh ji[dj jk[ep hv[wk
玉花卻在御榻上	yu[wd hx[cr qt[te zd[ut yu[rw ta[ao uh[bh
欲濟無舟楫	yu[bd ji[dw wu[ee vz[pk ji[ak
欲祭疑君在	yu[bd ji[xe yi[bs jy[xk zd[ut
欲將輕騎逐	yu[bd jl[dx qk[is qi[md vu[uz
預將書報家	yu[yy jl[dx uu[vv bc[fe jx[gu
玉階生白露	yu[wd jp[er ug[pf bd[po lu[yz
玉階仙仗擁千官	yu[wd jp[er xm[ru vh[rh ys[fo qm[pu gr[gu
玉階怨	yu[wd jp[er yr[xx
於今腐草無螢火	yu[fr jb[rd fu[gk cc[co wu[ee yk[ci ho[dp
餘禁所禁垣西	yu[re jb[ae so[pj jb[ae yr[th xi[hk
於今為庶為青門	yu[eu jb[rd ww[dl uu[gn ww[dl qk[fo mf[du
玉筋應啼別離後	yu[wd jb[vo yk[gx ti[kl bp[kd li[wk hz[pk
玉京群帝集北斗	yu[wd jk[wk qy[xy di[lj ji[va bw[ub dz[du
與君歌一曲	yu[hv jy[xk ge[kd yi[hh qu[ou
與君離別意	yu[hv jy[xk li[wk bp[kd yi[lx
與君營奠復營齋	yu[hv jy[xk yk[ck dm[bd fu[ro yk[ck vd[we
玉壘浮雲變古今	yu[wd lw[st fu[da yy[es bm[yy gu[uk jb[rd
漁梁渡頭爭渡喧	yu[dy ll[da du[dg tz[dd vg[dx du[dg xr[kg
雨淋日炙野火燎	yu[hk lb[da ri[wh vi[xh ye[oy ho[dp ln[hd
魚龍聽梵聲	yu[dt ls[yp tk[kj fj[aj ug[um
玉樓天半起笙歌	yu[wd lz[am tm[hd bj[bf qi[zk ug[vp ge[kd
玉樓宴罷醉和春	yu[wd lz[am yj[go ba[st zv[yw he[hk iy[so
玉貌錦衣	yu[wd mc[pb jb[jb yi[wy
玉盤珍羞值萬錢	yu[wd pj[vm vf[wr xq[yi vi[ru wj[hv qm[jj
於潛七兄	yu[eu qm[de qi[hv xs[ke
與親	yu[hv qb[la
欲窮千里目	yu[bd qs[xl qm[pu li[ot mu[we
欲取鳴琴彈	yu[bd qu[ey mk[kn qb[wr dj[gb
欲去問西家	yu[bd qu[ts wf[mk xi[hk jx[gu
欲取蕪城作帝家	yu[bd qu[ey wu[ce ig[tw zo[rv di[lj jx[gu
圉人太僕皆惆悵	yu[wt rf[pd td[dd pu[rb jp[bb iz[xk ih[xi
羽人稀少不在旁	yu[xx rf[pd xi[hi uc[xp bu[eu zd[ut ph[lf
玉容寂寞淚闌干	yu[wd rs[xr ji[gu mo[gc lw[dm lj[mh gj[hu
欲上青天覽明月	yu[bd uh[bh qk[fo tm[hd lj[uj mk[oo yt[ke
餘尚童稚	yu[re uh[xk ts[lo vi[hv
羽書昨夜過渠黎	yu[xx uu[vv zo[ov ye[wr go[cz qu[da li[hr
玉臺體	yu[wd td[sk ti[ra
欲投人處宿	yu[bd tz[fj rf[pd iu[wb su[gr
欲往城南望城北	yu[bd wh[rd ig[tw nj[uk wh[ww ig[tw bw[ub
漁翁	yu[dy wg[bx
漁翁夜傍西巖宿	yu[dy wg[bx ye[wr bh[rl xi[hk yj[ue su[gr
玉璽不緣歸日角	yu[wd xi[dw bu[eu yr[sv gv[ux ri[wh jn[do
羽檄交馳日夕聞	yu[xx xi[ab jn[li ii[my ri[wh xi[xd wf[me
餘響入霜鍾	yu[ur xl[kp ru[pd ul[ya vs[jv
庾信平生最蕭瑟	yu[gj xb[ry pk[hb ug[pf zv[oe xn[cx se[wx
欲行不行各盡觴	yu[bd xk[rh bu[eu xk[rh ge[wk jb[ud uh[dr
雨雪紛紛連大漠	yu[hk xt[yx ff[sf ff[sf lm[iz da[hr mo[dc
欲尋芳草去	yu[bd xy[xc fh[cf cc[co qu[ts
漁陽鼙鼓動地來	yu[dy yh[eo pi[ub gu[uu ds[el di[ty ld[hm
餘亦乘舟歸鹿門	yu[re yi[wy ig[qb vz[pk gv[ux lu[gb mf[du
欲以菲薄明其衷	yu[bd yi[sr fw[cf bo[cd mk[oo qi[cb vs[wv
餘亦能高詠	yu[re yi[wy ng[sb gc[wk ys[kd
餘亦謝時去	yu[re yi[wy xp[yu ui[oc qu[ts
欲飲琵琶馬上催	yu[bd yb[ud pi[wb pa[wb ma[vv uh[bh cv[ru
御宇多年求不得	yu[rw yu[ge do[xx nm[rn qq[hu bu[eu de[ro
與餘問答既有以	yu[hv yu[re wf[mk da[vr ji[gj yz[uo yi[sr
御苑砧聲向晚多	yu[rw yr[cx vf[eb ug[um xl[pk wj[od do[xx
雨中春樹萬人家	yu[hk vs[ku iy[so uu[ay wj[hv rf[pd jx[gu
雨中黃葉樹	yu[hk vs[ku hl[gy ye[ku uu[ay
漁舟逐水愛山春	yu[dy vz[pk vu[uz uv[uu ai[au uj[uk iy[so
與諸子登峴山	yu[hv vu[yt zi[lh dg[dd xm[uj uj[uk
欲妝臨鏡慵	yu[bd vl[dn lb[uv jk[jl ys[xg
予左遷九江郡司馬	yu[sv zo[ug qm[qz jq[pv jl[dg jy[xe si[vh ma[vv
願得燕弓射大將	yr[ix de[ro yj[nk gs[kv ue[uc da[hr jl[dx
遠芳侵古道	yr[ez fh[cf qb[rx gu[uk dc[bz
元和十年	yr[ee he[hk ui[hu nm[rn
元和天子神武姿	yr[ee he[hk tm[hd zi[lh uf[uo wu[hv zi[dn
緣澗還復去	yr[sv jm[dm hd[bz fu[ro qu[ts
元結	yr[ee jp[su
願借辯口如懸河	yr[ix jp[rg bm[ly kz[uv ru[nk xr[qx he[dk
願接盧敖遊太清	yr[ix jp[fl lu[bu ao[fw yz[df td[dd qk[df
願君多采擷	yr[ix jy[xk do[xx cd[aa xp[fu
遠客思鄉皆淚垂	yr[ez ke[gw si[tx xl[sp jp[bb lw[dm iv[ph
遠路應悲春晼晚	yr[ez lu[zw yk[gx bw[fx iy[so wj[[ wj[od
遠夢歸侵曉	yr[ez mg[ax gv[ux qb[rx xn[oq
猿鳴天上哀	yr[qt mk[kn tm[hd uh[bh ai[wk
猿鳴鐘動不知曙	yr[qt mk[kn vs[jv ds[el bu[eu vi[uk uu[os
猿猱欲度愁攀援	yr[qt nc[qy yu[bd du[gn iz[hx pj[ad yr[fa
猿鳥猶疑畏簡書	yr[qt nn[nh yz[qy yi[bs ww[th jm[vm uu[vv
怨情	yr[xx qk[xf
遠山晴更多	yr[ez uj[uk qk[of gg[ho do[xx
遠樹帶行客	yr[ez uu[ay dd[cj xk[rh ke[gw
願書萬本誦萬過	yr[ix uu[vv wj[hv bf[ah ss[ys wj[hv go[cz
遠送從此別	yr[ez ss[bz cs[rr ci[vb bp[kd
願隨春風寄燕然	yr[ix sv[eu iy[so fg[ji ji[gd yj[nk rj[xd
遠隋流水香	yr[ez sv[eu lq[dw uv[uu xl[ho
猿啼洞庭樹	yr[qt ti[kl ds[dk tk[gq uu[ay
願同塵與灰	yr[ix ts[kh if[xt yu[hv hv[uh
願為持竿叟	yr[ix ww[dl ii[ft gj[vg sz[jy
遠慰風雨夕	yr[ez ww[ux fg[ji yu[hk xi[xd
鴛鴦不獨宿	yr[xn yh[kn bu[eu du[qi su[gr
鴛鴦會雙死	yr[xn yh[kn hv[re ul[yy si[hx
鴛鴦瓦冷霜華重	yr[xn yh[kn wa[hv lg[dr ul[ya hx[ru vs[ph
元稹	yr[ee vf[hu
苑中景物生顏色	yr[cx vs[ku jk[ow wu[nb ug[pf yj[ly se[db
月傍九霄多	yt[ke bh[rl jq[pv xn[yx do[xx
月出寒通雪山白	yt[ke iu[ck hj[gd ts[sz xt[yx uj[uk bd[po
月殿影開聞夜漏	yt[ke dm[uj yk[op kd[hc wf[me ye[wr lz[du
月黑雁飛高	yt[ke hw[sd yj[ir fw[vp gc[wk
月既不解飲	yt[ke ji[gj bu[eu jp[dd yb[ud
月露誰教桂葉香	yt[ke lu[yz uv[yv jn[tw gv[at ye[ku xl[ho
月落烏啼霜滿天	yt[ke lo[cd wu[bv ti[kl ul[ya mj[dc tm[hd
月明松下房櫳靜	yt[ke mk[oo ss[ab xx[hb fh[hf ls[ay jk[fd
月明欲素愁不眠	yt[ke mk[oo yu[bd su[fy iz[hx bu[eu mm[mm
越人語天姥	yt[zh rf[pd yu[yw tm[hd lc[nt
月是故鄉明	yt[ke ui[op gu[gw xl[sp mk[oo
月下獨酌	yt[ke xx[hb du[qi vo[yb
月下飛天鏡	yt[ke xx[hb fw[vp tm[hd jk[jl
月斜樓上五更鐘	yt[ke xp[rd lz[am uh[bh wu[hu gg[ho vs[jv
月夜	yt[ke ye[wr
月夜憶舍弟	yt[ke ye[wr yi[xv ue[rg di[bg
月湧大江流	yt[ke ys[ds da[hr jl[dg lq[dw
月照城頭烏半飛	yt[ke vc[od ig[tw tz[dd wu[bv bj[bf fw[vp
月照一孤舟	yt[ke vc[od yi[hh gu[zp vz[pk
雲邊雁斷胡天月	yy[es bm[lz yj[ir dr[mj hu[go tm[hd yt[ke
雲鬢半偏新睡覺	yy[es bb[ig bj[bf pm[rh xb[lj uv[mi jn[xj
雲鬢花顏金步搖	yy[es bb[ig hx[cr yj[ly jb[rw bu[vu yc[fa
雲此最吉餘難同	yy[es ci[vb zv[oe ji[uk yu[ur nj[yv ts[kh
雲峰水隔深	yy[es fg[uw uv[uu ge[eh uf[dg
雲髻罷梳還對鏡	yy[es ji[iu ba[st uu[aw hd[bz dv[yc jk[jl
雲開遠見漢陽城	yy[es kd[hc yr[ez jm[ke hj[dy yh[eo ig[tw
雲來氣接巫峽長	yy[es ld[hm qi[rh jp[fl wu[gr xx[uj ih[ph
雲裡帝城雙鳳闕	yy[es li[ot di[lj ig[tw ul[yy fg[jy qt[mn
運命惟所遇	yy[ez mk[rh ww[xv so[pj yu[oz
雲霓明滅或可睹	yy[es ni[yj mk[oo mp[hh ho[gk ke[dk du[mt
雲青青兮欲雨	yy[es qk[fo qk[fo xi[bk yu[bd yu[hk
雲山況是客中過	yy[es uj[uk kl[dk ui[op ke[gw vs[ku go[cz
雲深不知處	yy[es uf[dg bu[eu vi[uk iu[wb
雲生結海樓	yy[es ug[pf jp[su hd[dr lz[am
雲霞出海曙	yy[es xx[yk iu[ck hd[dr uu[os
雲霞生薜帷	yy[es xx[yk ug[pf bi[cu ww[jv
雲陽館與韓紳宿別	yy[es yh[eo gr[ug yu[hv hj[uw uf[so su[gr bp[kd
運移漢祚終難復	yy[ez yi[hx hj[dy zo[uv vs[sw nj[yv fu[ro
雲雨荒臺豈夢思	yy[es yu[hk hl[cw td[sk qi[uk mg[ax si[tx
雲棧縈紆登劍閣	yy[es vj[aj yk[cy yu[se dg[dd jm[rd ge[mw
雲之君兮紛紛而來下	yy[es vi[dv jy[xk xi[bk ff[sf ff[sf er[ek ld[hm xx[hb
雲中君不見	yy[es vs[ku jy[xk bu[eu jm[ke
韻資天縱	yy[lb zi[db tm[hd zs[sr
雜詩	za[ja ui[yt
在長安	zd[ut ih[ph an[gn
在地願為連理枝	zd[ut di[ty yr[ix ww[dl lm[iz li[wo vi[au
在山泉水清	zd[ut uj[uk qr[bu uv[uu qk[df
在天願作比翼鳥	zd[ut tm[hd yr[ix zo[rv bi[bb yi[xt nn[nh
在獄詠蟬並序	zd[ut yu[qy ys[kd ij[ib bk[bk xu[gy
暫伴月將影	zj[io bj[rb yt[ke jl[dx yk[op
暫時分手莫躊躇	zj[io ui[oc ff[bd uz[su mo[co iz[zf iu[zc
暫遊桃源裡	zj[io yz[df tc[av yr[di li[ot
早被嬋娟誤	zc[ou bw[yp ij[nb jr[nk wu[yk
早服還丹無世情	zc[ou fu[oe hr[bz dj[kw wu[ee ui[nv qk[xf
早寒江上有懷	zc[ou hj[gd jl[dg uh[bh yz[uo hk[xb
棗花未落桐葉長	zc[cd hx[cr ww[ha lo[cd ts[ak ye[ku ih[ph
造化鍾神秀	zc[nz hx[rq vs[jv uf[uo xq[hn
早秋	zc[ou qq[hh
遭時徽纆	zc[hz ui[oc hv[ru mo[[
鑿石作鼓隳嵯峨	zc[yb ui[ek zo[rv gu[uu hv[er co[uy ee[up
早晚下三巴	zc[ou wj[od xx[hb sj[hh ba[ku
早雁拂銀河	zc[ou yj[ir fu[ff yb[jg he[dk
早知潮有信	zc[ou vi[uk ic[du yz[uo xb[ry
則載酒於湖上	ze[bd zd[ti jq[dy yu[eu hu[dg uh[bh
賊平後送人北歸	zw[bg pk[hb hz[pk ss[bz rf[pd bw[ub gv[ux
賊退示官吏並序	zw[bg tv[gz ui[ex gr[gu li[hk bk[bk xu[gy
賊又攻永州	zw[bg yz[vd gs[gw ys[dv vz[dp
賊斫不死神扶持	zw[bg vo[ej bu[eu si[hx uf[uo fu[fe ii[ft
贈孟浩然	zg[bb mg[zm hc[dn rj[xd
贈內人	zg[bb nw[kr rf[pd
贈闕下裴舍人	zg[bb qt[mn xx[hb pw[fy ue[rg rf[pd
贈衛八處士	zg[bb ww[eh ba[pd iu[wb ui[uh
乍見翻疑夢	va[ru jm[ke fj[px yi[bs mg[ax
摘花不插發	vd[fl hx[cr bu[eu ia[fq fa[vy
宅即魯王宮	vd[gp ji[ge lu[yo wh[su gs[gk
氈包席裹可立致	vj[mb bc[bk xi[gn go[wo ke[dk li[lh vi[hw
戰場白骨纏草根	vj[bg ih[tv bd[po gu[ko ij[sg cc[co gf[ag
沾襟比散絲	vj[db jb[ya bi[bb sj[gw si[sh
戰士軍前半死生	vj[bg ui[uh jy[gi qm[bo bj[bf si[hx ug[pf
長大一相逢	vh[ph da[hr yi[hh xl[am fg[wz
張祜	vh[gi hu[ug
張籍	vh[gi ji[vl
張繼	vh[gi ji[sm
張九齡	vh[gi jq[pv lk[vr
張喬	vh[gi qn[pp
張生手持石鼓文	vh[gi ug[pf uz[su ii[ft ui[ek gu[uu wf[wi
章臺夜思	vh[lo td[sk ye[wr si[tx
張旭	vh[gi xu[jo
長在漢家營	vh[ph zd[ut hj[dy jx[gu yk[ck
長者雖有問	vh[ph ve[to sv[ki yz[uo wf[mk
朝辭白帝彩雲間	vc[uo ci[ql bd[po di[lj cd[ap yy[es jm[mo
朝如青絲暮成雪	vc[uo ru[nk qk[fo si[sh mu[co ig[wv xt[yx
趙瑟初停鳳凰柱	vc[zi se[wx iu[yd tk[rw fg[jy hl[jb vu[ad
詔書五道出將軍	vc[yd uu[vv wu[hu dc[bz iu[ck jl[dx jy[gi
昭王白骨縈蔓草	vc[od wh[su bd[po gu[ko yk[cy mj[co cc[co
詔謂將軍拂絹素	vc[yd ww[yt jl[dx jy[gi fu[ff jr[sk su[fy
朝為越溪女	vc[uo ww[dl yt[zh xi[da nv[vp
昭陽殿裡第一人	vc[od yh[eo dm[uj li[ot di[vg yi[hh rf[pd
昭陽殿裡恩愛絕	vc[od yh[eo dm[uj li[ot en[wx ai[au jt[sd
朝朝空自歸	vc[uo vc[uo ks[xg zi[pm gv[ux
朝朝馬策與刀環	vc[uo vc[uo ma[vv ce[vc yu[hv dc[vp hr[wb
朝朝誤妾期	vc[uo vc[uo wu[yk qp[ln qi[qo
折花門前劇	ve[fj hx[cr mf[du qm[bo ju[ud
折戟沈沙鐵未銷	ve[fj ji[ug uf[dg ua[dx tp[jp ww[ha xn[jx
謫居臥病潯陽城	ve[yl ju[ug wo[kb bk[bh xy[dx yh[eo ig[tw
砧杵夜千家	vf[eb iu[aw ye[wr qm[pu jx[gu
貞婦貴殉夫	vf[bb fu[nx gv[vb xy[hb fu[er
砧聲近報漢宮秋	vf[eb ug[um jb[jz bc[fe hj[dy gs[gk qq[hh
針線猶存未忍開	vf[ju xm[sj yz[qy cy[uz ww[ha rf[dx kd[hc
真源了無取	vf[uj yr[di ln[vu wu[ee qu[ey
整頓衣裳起斂容	vg[hh dy[ty yi[wy uh[xy qi[zk lm[rw rs[xr
鄭國遊人未及家	vg[be go[ww yz[df rf[pd ww[ha ji[pv jx[gu
蒸藜炊黍餉東菑	vg[cl li[ch iv[hd uu[hr xl[up ds[qx zi[[
徵人薊北空回首	vg[rh rf[pd ji[cy bw[ub ks[xg hv[wk uz[be
徵人倚戍樓	vg[rh rf[pd yi[rd uu[wd lz[am
徵人怨	vg[rh rf[pd yr[xx
崢嶸如鬼工	vg[ud rs[uc ru[nk gv[be gs[hu
正是江南好風景	vg[hv ui[op jl[dg nj[uk hc[nz fg[ji jk[ow
錚錚然有京都聲	vg[jd vg[jd rj[xd yz[uo jk[wk du[te ug[um
正直元因造化功	vg[hv vi[uj yr[ee yb[wd zc[nz hx[rq gs[gl
知波瀾莫二	vi[uk bo[dp lj[dm mo[co er[hh
直道相思了無益	vi[uj dc[bz xl[am si[tx le[vu wu[ee yi[bm
至德二載甫自京金光門出	vi[ht de[ru er[hh zd[ti fu[uo zi[pm jk[wk jb[rw gl[xe mf[du iu[ck
雉雊麥苗秀	vi[uv gz[[ md[fw mn[ct xq[hn
直掛雲帆濟滄海	vi[uj gx[ft yy[es fj[jj ji[dw ch[dr hd[dr
指揮若定失蕭曹	vi[fb hv[fg ro[cu dk[gp ui[pe xn[cx cc[ho
至今殘破膽	vi[ht jb[rd cj[hj po[ep dj[oo
至今窺牧馬	vi[ht jb[rd kv[xe mu[nw ma[vv
至今猶憶李將軍	vi[ht jb[rd yz[qy yi[xv li[az jl[dx jy[gi
置酒長安道	vi[su jq[dy ih[ph an[gn dc[bz
志決身殲軍務勞	vi[ux jt[dv uf[pu jm[hq jy[gi wu[wl lc[cl
支離東北風塵際	vi[uy li[wk ds[qx bw[ub fg[ji if[xt ji[ee
滯慮洗孤清	vi[dc lv[hx xi[dn gu[zp qk[df
之上	vi[dv uh[bh
直上三十里	vi[uj uh[bh sj[hh ui[hu li[ot
只是當時已惘然	vi[kb ui[op dh[xx ui[oc yi[kv wh[xk rj[xd
只是近黃昏	vi[kb ui[op jb[jz hl[gy hy[uo
志士幽人莫怨嗟	vi[ux ui[uh yz[yy rf[pd mo[co yr[xx jp[ky
炙手可熱勢絕倫	vi[xh uz[su ke[dk re[fd ui[fl jt[sd ly[rr
知音世所稀	vi[uk yb[lo ui[nv so[pj xi[hi
只應守寂寞	vi[kb yk[gx uz[gc ji[gu mo[gc
只在此山中	vi[kb zd[ut ci[vb uj[uk vs[ku
直至長風沙	vi[uj vi[ht ih[ph fg[ji ua[dx
之子期宿來	vi[dv zi[lh qi[qo su[gr ld[hm
至尊含笑催賜金	vi[ht zy[bc hj[rk xn[vp cv[ru ci[bo jb[rw
終罷斯結廬	vs[sw ba[st si[qj jp[su lu[gh
中朝大官老於事	vs[ku ic[uo da[hr gr[gu lc[tb yu[eu ui[hk
終古垂楊有暮鴉	vs[sw gu[uk iv[ph yh[av yz[uo mu[co ya[yn
鐘鼓饌玉不足貴	vs[jv gu[uu vr[uk yu[wd bu[eu zu[kv gv[vb
終見降王走傳車	vs[sw jm[ke jl[ew wh[su zz[tv ir[re ie[qu
中間小謝又清發	vs[ku jm[mo xn[ub xp[yu yz[vd qk[df fa[vy
中軍置酒飲歸客	vs[ku jy[gi vi[su jq[dy yb[ud gv[ux ke[gw
終南別業	vs[sw nj[uk bp[kd ye[ub
終南山	vs[sw nj[uk uj[uk
終南望餘雪	vs[sw nj[uk wh[ww yu[ur xt[yx
終南陰嶺秀	vs[sw nj[uk yb[eo lk[ur xq[hn
終日坎壈纏其身	vs[sw ri[wh kj[td lj[[ ij[sg qi[cb uf[pu
終歲不聞絲竹聲	vs[sw sv[ux bu[eu wf[me si[sh vu[rr ug[um
中歲頗好道	vs[ku sv[ux po[py hc[nz dc[bz
中天月色好誰看	vs[ku tm[hd yt[ke se[db hc[nz uv[yv kj[fm
重帷深下莫愁堂	vs[ph ww[jv uf[dg xx[hb mo[co iz[hx th[xt
中宵勞夢想	vs[ku xn[gx lc[cl mg[ax xl[ax
中有一人字太真	vs[ku yz[uo yi[hh rf[pd zi[gz td[dd vf[uj
州邊鄙而退	vz[dp bm[lz bi[ke er[ek tv[gz
周綱凌遲四海沸	vz[kt gh[sk lk[dt ii[uz si[we hd[dr fw[df
舟楫恐失墜	vz[pk ji[ak ks[gx ui[pe vv[et
州家申名使家抑	vz[dp jx[gu uf[ou mk[xk ui[rh jx[gu yi[fp
周南留滯古所惜	vz[kt nj[uk lq[pt vi[dc gu[uk so[pj xi[xg
舟人夜語覺潮生	vz[pk rf[pd ye[wr yu[yw jt[xj ic[du ug[pf
舟人指點到今疑	vz[pk rf[pd vi[fb dm[bd dc[hd jb[rd yi[bs
珠箔飄燈獨自歸	vu[wp bo[vd pn[xf dg[hd du[qi zi[pm gv[ux
珠箔銀屏迤邐開	vu[wp bo[vd yb[jg pk[ub yi[rz li[hz kd[hc
主稱會面難	vu[dw ig[hd hv[re mm[ew nj[yv
諸葛大名垂宇宙	vu[yt ge[co da[hr mk[xk iv[ph yu[ge vz[gy
諸侯劍佩鳴相磨	vu[yt hz[rv jm[rd pw[rj mk[kn xl[am mo[ge
住近湓江地低溼	vu[rd jb[jz pf[df jl[dg di[ty di[ru ui[do
逐客無消息	vu[uz ke[gw wu[ee xn[dx xi[zx
竹裡館	vu[rr li[ot gr[ug
竹憐新雨後	vu[rr lm[xr xb[lj yu[hk hz[pk
竹露滴清響	vu[rr lu[yz di[dl qk[df xl[kp
駐馬別孤墳	vu[md ma[vv bp[kd gu[zp ff[tw
駐馬望千門	vu[md ma[vv wh[ww qm[pu mf[du
駐馬銜杯問謫居	vu[md ma[vv xm[rj bw[ab wf[mk ve[yl ju[ug
渚清沙白鳥飛回	vu[dt qk[df ua[dx bd[po nn[nh fw[vp hv[wk
朱慶餘	vu[ph qk[gd yu[ur
朱雀橋邊野草花	vu[ph qt[xv qn[ap bm[lz ye[oy cc[co hx[cr
主人何為言少錢	vu[dw rf[pd he[rk ww[dl yj[we uc[xp qm[jj
主人忘歸客不發	vu[dw rf[pd wh[wx gv[ux ke[gw bu[eu fa[vy
主人下馬客在船	vu[dw rf[pd xx[hb ma[vv ke[gw zd[ut ir[vj
主人有酒歡今夕	vu[dw rf[pd yz[uo jq[dy hr[yd jb[rd xi[xd
諸生講解得切磋	vu[yt ug[pf jl[ye jp[dd de[ro qp[qd co[ey
諸史何為忍苦征斂	vu[yt ui[ki he[rk ww[dl rf[dx ku[cg vg[rh lm[rw
竹喧歸浣女	vu[rr xr[kg gv[ux hr[dg nv[vp
珠壓腰衱穩稱身	vu[wp ya[it yc[ox jp[[ wf[hd if[hd uf[pu
渚雲低暗渡	vu[dt yy[es di[ru an[ol du[dg
諸子環洞庭而坐	vu[yt zi[lh hr[wb ds[dk tk[gq er[ek zo[rr
轉教小玉報雙成	vr[ie jn[tw xn[ub yu[wd bc[fe ul[yy ig[wv
轉徙於江湖間	vr[ie xi[rv yu[fr jl[dg hu[dg jm[mo
轉於僮僕親	vr[ie yu[fr ts[rl pu[rb qb[la
轉軸撥絃三兩聲	vr[ie vz[iy bo[fv xm[gw sj[hh ll[hk ug[um
妝罷低聲問夫婿	vl[dn ba[st di[ru ug[um wf[mk fu[er xu[np
妝成每被秋娘妒	vl[dn ig[wv mw[rm bw[yp qq[hh nl[nl du[nh
妝成只是薰香坐	vl[dn ig[wv vi[kb ui[op xy[cp xl[ho zo[rr
壯其蔚跂	vl[du qi[cb ww[cu qi[zu
莊生曉夢迷蝴蝶	vl[gt ug[pf xn[oq mg[ax mi[mz hu[ig dp[in
壯志逐年衰	vl[du vi[ux vu[uz nm[rn uk[wk
濯冠沐浴告祭酒	vo[dx gr[ge mu[da yu[db gc[nk ji[xe jq[dy
酌飲四座以散愁	vo[yb yb[ud si[we zo[gr yi[sr sj[gw iz[hx
酌於君山	vo[yb yu[fr jy[xk uj[uk
濯足洞庭望八荒	vo[dx zu[kv ds[dk tk[gq wh[ww ba[pd hl[cw
自慚居處崇	zi[pm cj[xi ju[ug iu[wb is[ug
自此草書長進	zi[pm ci[vb cc[co uu[vv vh[ph jb[ez
資從豈待周	zi[db cs[rr qi[uk dd[rt vz[kt
自從棄置便衰朽	zi[pm cs[rr qi[wc vi[su bm[rh uk[wk xq[ak
自從獻寶朝河宗	zi[pm cs[rr xm[uq bc[gw ic[uo he[dk zs[ge
自爾為佳節	zi[pm er[dx ww[dl jx[rt jp[ce
紫蓋連延接天柱	zi[vy gd[bm lm[iz yj[pj jp[fl tm[hd vu[ad
自高頭宜春梨園二伎坊內人	zi[pm gc[wk tz[dd yi[gq iy[so li[ha yr[we er[hh ji[ru fh[tf nw[kr rf[pd
自顧無長策	zi[pm gu[iy wu[ee ih[ph ce[vc
自河南經亂	zi[pm he[dk nj[uk jk[ss lr[qv
自嫁黔婁百事乖	zi[pm jx[ng qm[hr lz[mn bd[eo ui[hk gk[qb
自將磨洗認前朝	zi[pm jl[dx mo[ge xi[dn rf[yr qm[bo ic[uo
自覺諫書稀	zi[pm jt[xj jm[yh uu[vv xi[hi
自覺老煙波	zi[pm jt[xj lc[tb yj[hw bo[dp
自憐碧玉親教舞	zi[pm lm[xr bi[we yu[wd qb[la jn[tw wu[rx
姊妹弟兄皆列士	zi[np mw[nh di[bg xs[ke jp[bb lp[hd ui[uh
紫泉宮殿鎖煙霞	zi[vy qr[bu gs[gk dm[uj so[jx yj[hw xx[yk
字體不類隸與蝌	zi[gz ti[ra bu[eu lw[md li[xu yu[hv ke[ih
紫駝之峰出翠釜	zi[vy to[mg vi[dv fg[uw iu[ck cv[xw fu[bw
自謂經過舊不迷	zi[pm ww[yt jk[ss go[cz jq[uo bu[eu mi[mz
自夏口至鸚洲夕望岳陽寄源中丞	zi[pm xx[ew kz[uv vi[ht yk[bn vz[dd xi[xd wh[ww yt[qu yh[eo ji[gd yr[di vs[ku ig[lh
自小闕內訓	zi[pm xn[ub qt[mn nw[kr xy[yi
子胥既棄吳江上	zi[lh xu[po ji[gj qi[wc wu[kt jl[dg uh[bh
自敘少小時歡樂事	zi[pm xu[ry uc[xp xn[ub ui[oc hr[yd le[px ui[hk
自言本是京城女	zi[pm yj[we bf[ah ui[op jk[wk ig[tw nv[vp
子夜四時歌	zi[lh ye[wr si[we ui[oc ge[kd
自有歲寒心	zi[pm yz[uo sv[ux hj[gd xb[dv
自雲良家子	zi[pm yy[es ll[dg jx[gu zi[lh
自足蕩心耳	zi[pm zu[kv dh[cd xb[dv er[hu
宗臣遺像肅清高	zs[ge if[ku yi[vz xl[rd su[xu qk[df gc[wk
總是玉關情	zs[bx ui[op yu[wd gr[bt qk[xf
縱有健婦把鋤犁	zs[sr yz[uo jm[ry fu[nx ba[fb iu[jq li[hn
走馬川行奉送封大夫出師西征	zz[tv ma[vv ir[pu xk[rh fg[sf ss[bz fg[tc dd[hr fu[er iu[ck ui[uh xi[hk vg[rh
走馬蘭臺類轉蓬	zz[tv ma[vv lj[bs td[sk lw[md vr[ie pg[cw
足繭荒山轉愁疾	zu[kv jm[ci hl[cw uj[uk vr[ie iz[hx ji[bu
租稅從何出	zu[hq uv[hb cs[rr he[rk iu[ck
祖詠	zu[uq ys[kd
醉不成歡慘將別	zv[yw bu[eu ig[wv hr[yd cj[xs jl[dx bp[kd
罪從大辟皆除死	zv[sf cs[rr da[hr pi[ul jp[bb iu[er si[hx
醉和金甲舞	zv[yw he[hk jb[rw jx[ou wu[rx
醉後各分散	zv[yw hz[pk ge[wk ff[bd sj[gw
最是楚宮俱泯滅	zv[oe ui[op iu[ap gs[gk ju[rj mb[dm mp[hh
醉臥不知白日暮	zv[yw wo[kb bu[eu vi[uk bd[po ri[wh mu[co
醉臥沙場君莫笑	zv[yw wo[kb ua[dx ih[tv jy[xk mo[co xn[vp
醉月頻中聖	zv[yw yt[ke pb[vy vs[ku ug[yt
樽酒家貧只舊醅	zy[ab jq[dy jx[gu pb[fb vi[kb jq[uo pw[yl
樽酒慰離顏	zy[ab jq[dy ww[ux li[wk yj[ly
遵事蹟猶遽	zy[bz ui[hk ji[yz yz[qy ju[hz
昨別今已春	zo[ov bp[kd jb[rd yi[kv iy[so
坐愁紅顏老	zo[rr iz[hx hs[sg yj[ly lc[tb
坐法宮中朝四夷	zo[rr fa[dt gs[gk vs[ku ic[uo si[we yi[hg
坐觀垂釣者	zo[rr gr[yj iv[ph dn[jb ve[to
坐見舉國來奔波	zo[rr jm[ke ju[xf go[ww ld[hm bf[du bo[dp
坐看紅樹不知遠	zo[rr kj[fm hs[sg uu[ay bu[eu vi[uk yr[ez
坐看雲起時	zo[rr kj[fm yy[es qi[zk ui[oc
昨日之日不可留	zo[ov ri[wh vi[dv ri[wh bu[eu ke[dk lq[pt
作燕歌行以示適	zo[rv yj[nk ge[kd xk[rh yi[sr ui[ex ui[qz
昨夜東風吹血腥	zo[ov ye[wr ds[qx fg[ji iv[kd xt[pm xk[oo
昨夜風開露井桃	zo[ov ye[wr fg[ji kd[hc lu[yz jk[ep tc[av
昨夜裙帶解	zo[ov ye[wr qy[yx dd[cj jp[dd
昨夜上皇新授籙	zo[ov ye[wr uh[bh hl[bw xb[lj uz[fa lu[vx
昨夜微霜初度河	zo[ov ye[wr ww[ru ul[ya iu[yd du[gn he[dk
昨夜星辰昨夜風	zo[ov ye[wr xk[op if[ie zo[ov ye[wr fg[ji
昨夜月同行	zo[ov ye[wr yt[ke ts[kh hh[rh
昨與故人期	zo[ov yu[hv gu[gw rf[pd qi[qo
昨者州前槌大鼓	zo[ov ve[to vz[dp qm[bo iv[ap da[hr gu[uu
座中泣下誰最多	zo[gr vs[ku qi[dl xx[hb uv[yv zv[oe do[xx
