把床榻漂起	ba[fb il[ga ta[ao pn[dx qi[zk
把褥子溼透	ba[fb ru[yi zi[lh ui[do tz[hz
必臨到他自己的頭上	bi[xp lb[uv dc[hd ta[ry zi[pm ji[kv de[bb tz[dd uh[bh
並他的受膏者	bk[bk ta[ry de[bb uz[ay gc[wk ve[to
不站罪人的道路	bu[eu vj[lb zv[sf rf[pd de[bb dc[bz lu[zw
不坐怠慢人的座位	bu[eu zo[rr dd[sx mj[xo rf[pd de[bb zo[gr ww[rl
臣宰一同商議	if[ku zd[gl yi[hh ts[kh uh[lk yi[yd
大衛逃避他兒子押沙龍的時候作的詩	da[hr ww[eh tc[vz bi[uz ta[ry er[pv zi[lh ya[fo ua[dx ls[yp de[bb ui[oc hz[ru zo[rv de[bb ui[yt
大衛指著便雅憫人古實的話	da[hr ww[eh vi[fb ve[ym bm[rh ya[yv mb[xm rf[pd gu[uk ui[gd de[bb hx[yq
但你耶和華是我四圍的盾牌	dj[ro ni[rd ye[ee he[hk hx[ru ui[op wo[pf si[we ww[ww de[bb dy[pu pd[pb
當存畏懼事奉耶和華	dh[xx cy[uz ww[th ju[xj ui[hk fg[sf ye[ee he[hk hx[ru
當以嘴親子	dh[xx yi[sr zv[kv qb[la zi[lh
抵擋我敵人的暴怒	di[fu dh[fx wo[pf di[qw rf[pd de[bb bc[og nu[nx
都靠你歡欣	dz[te kc[nf ni[rd hr[yd xb[jd
惡人必站立不住	ee[hx rf[pd bi[xp vj[lb li[lh bu[eu vu[rd
凡他所作的	fj[jd ta[ry so[pj zo[rv de[bb
歌頌耶和華至高者的名	ge[kd ss[by ye[ee he[hk hx[ru vi[ht gc[wk ve[to de[bb mk[xk
好流人血弄詭詐的	hc[nz lq[dw rf[pd xt[pm ns[wc gv[yd va[yv de[bb
將地極賜你為田產	jl[dx di[ty ji[aj ci[bo ni[rd ww[dl tm[wu ij[lp
將我的性命踏在地下	jl[dx wo[pf de[bb xk[xp mk[rh ta[zu zd[ut di[ty xx[hb
將我救拔出來	jl[dx wo[pf jq[hw ba[fu iu[ck ld[hm
竟掉在自己所挖的阱裡	jk[lo dn[fb zd[ut zi[pm ji[kv so[pj wa[fx de[bb jk[ee li[ot
救恩屬乎耶和華	jq[hw en[wx uu[up hu[pb ye[ee he[hk hx[ru
就任憑仇敵追趕我	jq[wy rf[rq pk[rj iz[rj di[qw vv[pz gj[zg wo[pf
恐怕他們像獅子撕裂我	ks[gx pa[xb ta[ry mf[rm xl[rd ui[qu zi[lh si[fq lp[hy wo[pf
狂傲人不能站在你眼前	kl[qw ao[rf rf[pd bu[eu ng[sb vj[lb zd[ut ni[rd yj[mg qm[bo
連那無故與我為敵的	lm[iz na[ve wu[ee gu[gw yu[hv wo[pf ww[dl di[qw de[bb
們要掙開他們的捆綁	mf[rm yc[xn vg[fd kd[hc ta[ry mf[rm de[bb ky[fw bh[sf
那時他要在怒中責備他們	na[ve ui[oc ta[ry yc[xn zd[ut nu[nx vs[ku ze[fb bw[wt ta[ry mf[rm
那坐在天上的必發笑	na[ve zo[rr zd[ut tm[hd uh[bh de[bb bi[xp fa[vy xn[vp
乃像糠毗被風吹散	nd[vp xl[rd kh[mg pi[tb bw[yp fg[ji iv[kd sj[gw
你必將他們如同窯匠的瓦器摔碎	ni[rd bi[xp jl[dx ta[ry mf[rm ru[nk ts[kh yc[xw jl[kj de[bb wa[hv qi[kq uk[fw sv[ew
你必用恩惠如同盾牌四面護衛他	ni[rd bi[xp ys[ou en[wx hv[hx ru[nk ts[kh dy[pu pd[pb si[we mm[ew hu[fh ww[eh ta[ry
你必用鐵杖打破他們	ni[rd bi[xp ys[ou tp[jp vh[ah da[fd po[ep ta[ry mf[rm
你們便在道中滅亡	ni[rd mf[rm bm[rh zd[ut dc[bz vs[ku mp[hh wh[wv
你們將我的尊榮變為羞辱	ni[rd mf[rm jl[dx wo[pf de[bb zy[bc rs[ca bm[yy ww[dl xq[yi ru[ic
你們世上的審判官該受管教	ni[rd mf[rm ui[nv uh[bh de[bb uf[go pj[bd gr[gu gd[yw uz[ay gr[vg jn[tw
你們要知道耶和華已經分別虔誠人歸他自己	ni[rd mf[rm yc[xn vi[uk dc[bz ye[ee he[hk hx[ru yi[kv jk[ss ff[bd bp[kd qm[hw ig[yw rf[pd gv[ux ta[ry zi[pm ji[kv
你們一切作孽的人	ni[rd mf[rm yi[hh qp[qd zo[rv np[cz de[bb rf[pd
你是我的兒子	ni[rd ui[op wo[pf de[bb er[pv zi[lh
你要到幾時才救我呢	ni[rd yc[xn dc[hd ji[pv ui[oc cd[hu jq[hw wo[pf ne[ku
你已經命定施行審判	ni[rd yi[kv jk[ss mk[rh dk[gp ui[fr xk[rh uf[go pj[bd
敲碎了惡人的牙齒	qn[wb sv[ew le[vu ee[hx rf[pd de[bb ya[hv ii[vr
求你不要在怒中責備我	qq[hu ni[rd bu[eu yc[xn zd[ut nu[nx vs[ku ze[fb bw[wt wo[pf
求你垂聽我呼求的聲音	qq[hu ni[rd iv[ph tk[kj wo[pf hu[kp qq[hu de[bb ug[um yb[lo
求你救我脫離一切追趕我的人	qq[hu ni[rd jq[hw wo[pf to[ob li[wk yi[hh qp[qd vv[pz gj[zg wo[pf de[bb rf[pd
求你留心聽我的言語	qq[hu ni[rd lq[pt xb[dv tk[kj wo[pf de[bb yj[we yu[yw
求你在怒中起來	qq[hu ni[rd zd[ut nu[nx vs[ku qi[zk ld[hm
若有罪孽在我手裡	ro[cu yz[uo zv[sf np[cz zd[ut wo[pf uz[su li[ot
神是公義的審判者	uf[uo ui[op gs[bs yi[di de[bb uf[go pj[bd ve[to
神是我的盾牌	uf[uo ui[op wo[pf de[bb dy[pu pd[pb
勝過那豐收五穀新酒的人	ug[op go[cz na[ve fg[su uz[vw wu[hu gu[bk xb[lj jq[dy de[bb rf[pd
試看惡人因奸惡而劬勞	ui[yq kj[fm ee[hx rf[pd yb[wd jm[ng ee[hx er[ek qu[bl lc[cl
使你的道路在我面前正直	ui[rh ni[rd de[bb dc[bz lu[zw zd[ut wo[pf mm[ew qm[bo vg[hv vi[uj
世上的君王一齊起來	ui[nv uh[bh de[bb jy[xk wh[su yi[hh qi[wp qi[zk ld[hm
使我的榮耀歸於灰塵	ui[rh wo[pf de[bb rs[ca yc[xx gv[ux yu[eu hv[uh if[xt
誰能指示我們什麼好處	uv[yv ng[sb vi[fb ui[ex wo[pf mf[rm uf[ru me[ps hc[nz iu[wb
雖有成萬的百姓來周圍攻擊我	sv[ki yz[uo ig[wv wj[hv de[bb bd[eo xk[np ld[hm vz[kt ww[ww gs[gw ji[fk wo[pf
所懷的是毒害	so[pj hk[xb de[bb ui[op du[fm hd[gf
所生的是虛假	so[pj ug[pf de[bb ui[op xu[hy jx[rk
他得不著神的幫助	ta[ry de[ro bu[eu vc[ym uf[uo de[bb bh[fj vu[ql
他的強暴必落到他自己的腦袋上	ta[ry de[bb ql[gk bc[og bi[xp lo[cd dc[hd ta[ry zi[pm ji[kv de[bb nc[ow dd[ry uh[bh
他就從他的聖山上應允我	ta[ry jq[wy cs[rr ta[ry de[bb ug[yt uj[uk uh[bh yk[gx yy[se wo[pf
他所射的是火箭	ta[ry so[pj ue[uc de[bb ui[op ho[dp jm[vb
他要像一棵樹栽在溪水旁	ta[ry yc[xn xl[rd yi[hh ke[ao uu[ay zd[ta zd[ut xi[da uv[uu ph[lf
他也預備了殺人的器械	ta[ry ye[vu yu[yy bw[wt le[vu ua[ia rf[pd de[bb qi[kq xp[ag
他拯救心裡正直的人	ta[ry vg[fl jq[hw xb[dv li[ot vg[hv vi[uj de[bb rf[pd
脫去他們的繩索	to[ob qu[ts ta[ry mf[rm de[bb ug[sk so[uy
外邦為什麼爭鬧	wd[xb bh[fe ww[dl uf[ru me[ps vg[dx nc[mw
萬民為什麼謀算虛妄的事	wj[hv mb[kv ww[dl uf[ru me[ps mz[yg sr[vm xu[hy wh[wn de[bb ui[hk
唯喜愛耶和華的律法	ww[kv xi[uk ai[au ye[ee he[hk hx[ru de[bb lv[ry fa[dt
我必安然躺下睡覺	wo[pf bi[xp an[gn rj[xd th[ux xx[hb uv[mi jn[xj
我必存敬畏你的心向你的聖殿下拜	wo[pf bi[xp cy[uz jk[cw ww[th ni[rd de[bb xb[dv xl[pk ni[rd de[bb ug[yt dm[uj xx[hb bd[fh
我必憑你豐盛的慈愛進入你的居所	wo[pf bi[xp pk[rj ni[rd fg[su ug[wm de[bb ci[bx ai[au jb[ez ru[pd ni[rd de[bb ju[ug so[pj
我的敵人何其加增	wo[pf de[bb di[qw rf[pd he[rk qi[cb jx[lk zg[tb
我的一切仇敵都必羞愧	wo[pf de[bb yi[hh qp[qd iz[rj di[qw dz[te bi[xp xq[yi kv[xg
我就將列國賜你為基業	wo[pf jq[wy jl[dx lp[hd go[ww ci[bo ni[rd ww[dl ji[qt ye[ub
我若以惡報那與我交好的人	wo[pf ro[cu yi[sr ee[hx bc[fe na[ve yu[hv wo[pf jn[li hc[nz de[bb rf[pd
我心也大大地驚惶	wo[pf xb[dv ye[vu da[hr da[hr de[ty jk[xw hl[xb
我要照著耶和華的公義稱謝他	wo[pf yc[xn vc[od ve[ym ye[ee he[hk hx[ru de[bb gs[bs yi[di ig[hd xp[yu ta[ry
我已經立我的君在錫安我的聖山上了	wo[pf yi[kv jk[ss li[lh wo[pf de[bb jy[xk zd[ut xi[jo an[gn wo[pf de[bb ug[yt uj[uk uh[bh le[vu
我因唉哼而睏乏	wo[pf yb[wd ai[ks hg[kw er[ek ky[wa fa[pv
我因憂愁眼睛乾癟	wo[pf yb[wd yz[xy iz[hx yj[mg jk[mf gj[hu bp[bz
我用我的聲音求告耶和華	wo[pf ys[ou wo[pf de[bb ug[um yb[lo qq[hu gc[nk ye[ee he[hk hx[ru
現在你們君王應當省悟	xm[wj zd[ut ni[rd mf[rm jy[xk wh[su yk[gx dh[xx xk[xm wu[xw
向耶和華唱的流離歌	xl[pk ye[ee he[hk hx[ru ih[ko de[bb lq[dw li[wk ge[kd
要敵擋耶和華	yc[xn di[qw dh[fx ye[ee he[hk hx[ru
也不要在烈怒中懲罰我	ye[vu bu[eu yc[xn zd[ut lp[hd nu[nx vs[ku ig[rx fa[sy wo[pf
耶和華必收納我的禱告	ye[ee he[hk hx[ru bi[xp uz[vw na[sk wo[pf de[bb dc[uf gc[nk
耶和華曾對我說	ye[ee he[hk hx[ru cg[bo dv[yc wo[pf uo[yb
耶和華聽了我的懇求	ye[ee he[hk hx[ru tk[kj le[vu wo[pf de[bb kf[gx qq[hu
耶和華向眾民施行審判	ye[ee he[hk hx[ru xl[pk vs[rr mb[kv ui[fr xk[rh uf[go pj[bd
葉子也不枯乾	ye[ku zi[lh ye[vu bu[eu ku[ag gj[hu
因為獨有你耶和華使我安然居住	yb[wd ww[dl du[qi yz[uo ni[rd ye[ee he[hk hx[ru ui[rh wo[pf an[gn rj[xd ju[ug vu[rd
因為公義的神察驗人的心腸肺腑	yb[wd ww[dl gs[bs yi[di de[bb uf[uo ia[gx yj[mr rf[pd de[bb xb[dv ih[ov fw[oh fu[og
因為你必賜福與義人	yb[wd ww[dl ni[rd bi[xp ci[bo fu[uh yu[hv yi[di rf[pd
因為你不是喜悅惡事的神	yb[wd ww[dl ni[rd bu[eu ui[op xi[uk yt[xb ee[hx ui[hk de[bb uf[uo
因為你打了我一切仇敵的腮骨	yb[wd ww[dl ni[rd da[fd le[vu wo[pf yi[hh qp[qd iz[rj di[qw de[bb sd[ot gu[ko
因為他的怒氣快要發作	yb[wd ww[dl ta[ry de[bb nu[nx qi[rh kk[xv yc[xn fa[vy zo[rv
因為他們的口中沒有誠實	yb[wd ww[dl ta[ry mf[rm de[bb kz[uv vs[ku mw[dj yz[uo ig[yw ui[gd
因為耶和華聽了我哀哭的聲音	yb[wd ww[dl ye[ee he[hk hx[ru tk[kj le[vu wo[pf ai[wk ku[kq de[bb ug[um yb[lo
因為耶和華知道義人的道路	yb[wd ww[dl ye[ee he[hk hx[ru vi[uk dc[bz yi[di rf[pd de[bb dc[bz lu[zw
因為在死地無人記念你	yb[wd ww[dl zd[ut si[hx di[ty wu[ee rf[pd ji[yk nm[rx ni[rd
又當存戰兢而快樂	yz[vd dh[xx cy[uz vj[bg jk[gg er[ek kk[xv le[px
又是叫我抬起頭來的	yz[vd ui[op jn[kv wo[pf td[fs qi[zk tz[dd ld[hm de[bb
又是天天向惡人發怒的神	yz[vd ui[op tm[hd tm[hd xl[pk ee[hx rf[pd fa[vy nu[nx de[bb uf[uo
有許多人起來攻擊我	yz[uo xu[yw do[xx rf[pd qi[zk ld[hm gs[gw ji[fk wo[pf
有許多人議論我說	yz[uo xu[yw do[xx rf[pd yi[yd ly[yr wo[pf uo[yb
又因我一切的敵人眼睛昏花	yz[vd yb[wd wo[pf yi[hh qp[qd de[bb di[qw rf[pd yj[mg jk[mf hy[uo hx[cr
又願那愛你名的人	yz[vd yr[ix na[ve ai[au ni[rd mk[xk de[bb rf[pd
願惡人的惡斷絕	yr[ix ee[hx rf[pd de[bb ee[hx dr[mj jt[sd
願你賜福給你的百姓	yr[ix ni[rd ci[bo fu[uh gw[sr ni[rd de[bb bd[eo xk[np
願你從其上歸於高位	yr[ix ni[rd cs[rr qi[cb uh[bh gv[ux yu[eu gc[wk ww[rl
願你堅立義人	yr[ix ni[rd jm[ut li[lh yi[di rf[pd
願你在他們許多的過犯中	yr[ix ni[rd zd[ut ta[ry mf[rm xu[yw do[xx de[bb go[cz fj[qe vs[ku
願他們因自己的計謀跌倒	yr[ix ta[ry mf[rm yb[wd zi[pm ji[kv de[bb ji[yu mz[yg dp[zp dc[rh
願眾民的會環繞你	yr[ix vs[rr mb[kv de[bb hv[re hr[wb rc[sq ni[rd
在烈怒中驚嚇他們	zd[ut lp[hd nu[nx vs[ku jk[xw xx[kx ta[ry mf[rm
在陰間有誰稱謝你	zd[ut yb[eo jm[mo yz[uo uv[yv ig[hd xp[yu ni[rd
早晨你必聽我的聲音	zc[ou if[oi ni[rd bi[xp tk[kj wo[pf de[bb ug[um yb[lo
早晨我必向你陳明我的心意	zc[ou if[oi wo[pf bi[xp xl[pk ni[rd if[eq mk[oo wo[pf de[bb xb[dv yi[lx
這人便為有福	ve[wz rf[pd bm[rh ww[dl yz[uo fu[uh
主必嗤笑他們	vu[dw bi[xp ii[kc xn[vp ta[ry mf[rm
罪人在義人的會中	zv[sf rf[pd zd[ut yi[di rf[pd de[bb hv[re vs[ku
阿摩斯	aa[ek mo[gf si[qj
阿尼色弗	aa[ek ni[ub se[db fu[gp
阿尼西母	aa[ek ni[ub xi[hk mu[vv
阿撒茲勒	aa[ek sa[fg zi[by le[gl
安得烈	an[gn de[ro lp[hd
暗利	an[ol li[hd
巴底買	ba[ku di[gu md[vd
巴多羅買	ba[ku do[xx lo[sx md[vd
巴爾	ba[ku er[dx
巴拉巴巴拉	ba[ku la[fl ba[ku ba[ku la[fl
巴蘭	ba[ku lj[bs
巴拿巴	ba[ku na[rf ba[ku
巴沙	ba[ku ua[dx
拔示巴	ba[fu ui[ex ba[ku
巴耶穌	ba[ku ye[ee su[yh
巴約拿	ba[ku yt[sb na[rf
百基拉	bd[eo ji[qt la[fl
百尼基	bd[eo ni[ub ji[qt
半尼齊	bj[bf ni[ub qi[wp
保羅	bc[rk lo[sx
貝利爾	bw[kr li[hd er[dx
本丟彼拉多	bf[ah dq[pt bi[rp la[fl do[xx
彼得	bi[rp de[ro
比加	bi[bb jx[lk
比加轄	bi[bb jx[lk xx[ig
彼拉多	bi[rp la[fl do[xx
彼息氏	bi[rp xi[zx ui[pq
便哈達	bm[rh ha[kr da[dz
便雅憫	bm[rh ya[yv mb[xm
別西卜	bp[kd xi[hk bu[ud
波阿斯	bo[dp aa[ek si[qj
波求非斯都	bo[dp qq[hu fw[su si[qj dz[te
伯沙撒	bo[rb ua[dx sa[fg
部百流	bu[le bd[eo lq[dw
布田	bu[uj tm[wu
參巴拉	cj[sd ba[ku la[fl
參孫	cj[sd sy[zx
熾天使	ii[hk tm[hd ui[rh
大利烏	da[hr li[hd wu[bv
大天使	da[hr tm[hd ui[rh
大衛	da[hr ww[eh
但以理	dj[ro yi[sr li[wo
德丟	de[ru dq[pt
底波拉	di[gu bo[dp la[fl
底馬	di[gu ma[vv
底米丟	di[gu mi[ba dq[pt
丟大	dq[pt da[hr
丟尼修	dq[pt ni[ub xq[ru
多加	do[xx jx[lk
多馬	do[xx ma[vv
俄巴底亞	ee[rp ba[ku di[gu ya[hy
俄備德	ee[rp bw[wt de[ru
非比	fw[su bi[bb
腓吉路	fw[of ji[uk lu[zw
腓力	fw[of li[vp
腓利門	fw[of li[hd mf[du
腓力斯	fw[of li[vp si[qj
腓理徒	fw[of li[wo tu[rz
非斯都	fw[su si[qj dz[te
該亞法	gd[yw ya[hy fa[dt
該隱	gd[yw yb[ed
該猶	gd[yw yz[qy
歌革	ge[kd ge[nk
革老底亞	ge[nk lc[tb di[gu ya[hy
革老丟	ge[nk lc[tb dq[pt
革老丟呂西亞	ge[nk lc[tb dq[pt lv[kk xi[hk ya[hy
哥尼流	ge[kk ni[ub lq[dw
古列	gu[uk lp[hd
哈巴谷	ha[kr ba[ku gu[bk
哈該	ha[kr gd[yw
哈拿尼	ha[kr na[rf ni[ub
何巴	he[rk ba[ku
何西阿何細亞	he[rk xi[hk aa[ek he[rk xi[st ya[hy
黑摩其尼	hw[sd mo[gf qi[cb ni[ub
基甸	ji[qt dm[bt
磯法	ji[ej fa[dt
基哈西	ji[qt ha[kr xi[hk
基利斯布	ji[qt li[hd si[qj bu[uj
加百列	jx[lk bd[eo lp[hd
加布	jx[lk bu[uj
迦得	jx[lz de[ro
迦勒	jx[lz le[gl
迦流	jx[lz lq[dw
加略人	jx[lk lt[tw rf[pd
迦瑪列	jx[lz ma[wm lp[hd
居里扭	ju[ug li[ot nq[fi
可拉	ke[dk la[fl
苦撒	ku[cg sa[fg
拉班	la[fl bj[wd
拉斐爾	la[fl fw[fw er[dx
拉貴爾	la[fl gv[vb er[dx
拉哈伯	la[fl ha[kr bo[rb
喇合	la[kh he[rh
拉結	la[fl jp[su
拉撒路	la[fl sa[fg lu[zw
雷米爾	lw[yt mi[ba er[dx
利百加	li[hd bd[eo jx[lk
利甲	li[hd jx[ou
利奴	li[hd nu[ny
利斯巴	li[hd si[qj ba[ku
力天使	li[vp tm[hd ui[rh
利未	li[hd ww[ha
利汛	li[hd xy[dv
利亞	li[hd ya[hy
流便	lq[dw bm[rh
流珥	lq[dw er[we
路得	lu[zw de[ro
魯孚	lu[yo fu[az
路加	lu[zw jx[lk
路求	lu[zw qq[hu
路西法	lu[zw xi[hk fa[dt
羅波安	lo[sx bo[dp an[gn
羅大	lo[sx da[hr
羅得	lo[sx de[ro
羅馬人	lo[sx ma[vv rf[pd
羅陀聶	lo[sx to[eg np[ey
羅以	lo[sx yi[sr
呂底亞	lv[kk di[gu ya[hy
呂西亞	lv[kk xi[hk ya[hy
馬大	ma[vv da[hr
瑪各	ma[wm ge[wk
馬可	ma[vv ke[dk
瑪拉基	ma[wm la[fl ji[qt
馬勒古	ma[vv le[gl gu[uk
馬里亞	ma[vv li[ot ya[hy
瑪拿西	ma[wm na[rf xi[hk
馬念	ma[vv nm[rx
馬太	ma[vv td[dd
瑪土撒拉	ma[wm tu[uh sa[fg la[fl
麥基洗德	md[fw ji[qt xi[dn de[ru
米達倫梅丹佐	mi[ba da[dz ly[rr mw[ar dj[kw zo[ru
米非波設	mi[ba fw[su bo[dp ue[yj
米該雅	mi[ba gd[yw ya[yv
彌迦	mi[gd jx[lz
米迦勒	mi[ba jx[lz le[gl
米利暗	mi[ba li[hd an[ol
米拿現	mi[ba na[rf xm[wj
米煞	mi[ba ua[dd
末底改	mo[ha di[gu gd[kw
莫斯提馬	mo[co si[qj ti[fo ma[vv
摩西	mo[gf xi[hk
拿伯	na[rf bo[rb
拿答	na[rf da[vr
拿單	na[rf dj[bo
拿但業	na[rf dj[ro ye[ub
拿弗他利	na[rf fu[gp ta[ry li[hd
拿鶴	na[rf he[gn
拿鴻	na[rf hs[dn
拿孫	na[rf sy[zx
乃縵	nd[vp mj[so
能天使	ng[sb tm[hd ui[rh
尼布甲尼撒	ni[ub bu[uj jx[ou ni[ub sa[fg
尼各底母	ni[ub ge[wk di[gu mu[vv
尼古拉斯	ni[ub gu[uk la[fl si[qj
尼希米	ni[ub xi[iu mi[ba
寧法	nk[gd fa[dt
挪亞	no[fv ya[hy
毘努伊勒	pi[[ nu[nl yi[rx le[gl
權天使	qr[ay tm[hd ui[rh
撒但	sa[fg dj[ro
撒非喇	sa[fg fw[su la[kh
撒拉	sa[fg la[fl
撒拉弗	sa[fg la[fl fu[gp
撒羅米	sa[fg lo[sx mi[ba
撒瑪利亞人	sa[fg ma[wm li[hd ya[hy rf[pd
薩麥爾	sa[ce md[fw er[dx
撒母耳	sa[fg mu[vv er[hu
塞特	sd[gt te[nt
掃羅	sc[fx lo[sx
沙得拉	ua[dx de[ro la[fl
沙利葉	ua[dx li[hd ye[ku
沙龍	ua[dx ls[yp
珊迦	uj[wk jx[lz
上三級神聖的階級	uh[bh sj[hh ji[sj uf[uo ug[yt de[bb jp[er ji[sj
示巴女王	ui[ex ba[ku nv[vp wh[su
示瑪雅	ui[ex ma[wm ya[yv
示每	ui[ex mw[rm
士求保羅	ui[uh qq[hu bc[rk lo[sx
書亞	uu[vv ya[hy
書雅	uu[vv ya[yv
司提反	si[vh ti[fo fj[py
所羅門	so[pj lo[sx mf[du
所提尼	so[pj ti[fo ni[ub
特羅非摩	te[nt lo[sx fw[su mo[gf
提阿非羅	ti[fo aa[ek fw[su lo[sx
提庇留	ti[fo bi[gb lq[pt
提多	ti[fo do[xx
提摩太	ti[fo mo[gf td[dd
天使	tm[hd ui[rh
帖土羅	tp[jb tu[uh lo[sx
土西拉	tu[uh xi[hk la[fl
推基古	tv[fv ji[qt gu[uk
推喇奴	tv[fv la[kh nu[ny
陀拉	to[eg la[fl
烏利爾	wu[bv li[hd er[dx
烏西雅	wu[bv xi[hk ya[yv
希伯來	xi[iu bo[rb ld[hm
西拉	xi[hk la[fl
希羅底	xi[iu lo[sx di[gu
希律	xi[iu lv[ry
西門	xi[hk mf[du
西緬	xi[hk mm[se
西面	xi[hk mm[ew
西拿基立	xi[hk na[rf ji[qt li[lh
希西家	xi[iu xi[hk jx[gu
夏甲	xx[ew jx[ou
下三級聖靈的階級	xx[hb sj[hh ji[sj ug[yt lk[xh de[bb jp[er ji[sj
夏娃	xx[ew wa[nt
許米乃	xu[yw mi[ba nd[vp
循都基	xy[rp dz[te ji[qt
亞巴頓	ya[hy ba[ku dy[ty
亞比米勒	ya[hy bi[bb mi[ba le[gl
亞比篩	ya[hy bi[bb ud[vu
雅比斯	ya[yv bi[bb si[qj
亞比亞他	ya[hy bi[bb ya[hy ta[ry
亞比央	ya[hy bi[bb yh[kd
亞伯	ya[hy bo[rb
亞伯拉罕	ya[hy bo[rb la[fl hj[gg
亞波羅	ya[hy bo[dp lo[sx
亞伯尼歌	ya[hy bo[rb ni[ub ge[kd
亞達薛西	ya[hy da[dz xt[cp xi[hk
亞當	ya[hy dh[xx
押頓	ya[fo dy[ty
亞多尼洗德	ya[hy do[xx ni[ub xi[dn de[ru
亞多尼雅	ya[hy do[xx ni[ub ya[yv
睚珥	ya[mi er[we
亞幹	ya[hy gj[hu
雅各	ya[yv ge[wk
亞古士都	ya[hy gu[uk ui[uh dz[te
亞哈	ya[hy ha[kr
亞哈斯	ya[hy ha[kr si[qj
亞哈隨魯	ya[hy ha[kr sv[eu lu[yo
亞哈謝	ya[hy ha[kr xp[yu
亞吉	ya[hy ji[uk
亞基布	ya[hy ji[qt bu[uj
亞基老	ya[hy ji[qt lc[tb
亞基帕	ya[hy ji[qt pa[jb
亞迦布	ya[hy jx[lz bu[uj
亞居拉	ya[hy ju[ug la[fl
亞里達古	ya[hy li[ot da[dz gu[uk
亞力山大	ya[hy li[vp uj[uk da[hr
睚魯	ya[mi lu[yo
亞倫	ya[hy ly[rr
亞瑪力人	ya[hy ma[wm li[vp rf[pd
亞瑪撒	ya[hy ma[wm sa[fg
亞瑪謝	ya[hy ma[wm xp[yu
亞們	ya[hy mf[rm
亞拿	ya[hy na[rf
亞那	ya[hy na[ve
亞拿尼亞	ya[hy na[rf ni[ub ya[hy
雅尼	ya[yv ni[ub
押尼珥	ya[fo ni[ub er[we
亞撒	ya[hy sa[fg
亞薩	ya[hy sa[ce
亞撒利雅	ya[hy sa[fg li[hd ya[yv
押沙龍	ya[fo ua[dx ls[yp
亞設	ya[hy ue[yj
亞他利雅	ya[hy ta[ry li[hd ya[yv
亞希多弗	ya[hy xi[iu do[xx fu[gp
亞希米勒	ya[hy xi[iu mi[ba le[gl
亞希雅	ya[hy xi[iu ya[yv
佯庇	yh[ry bi[gb
耶弗他	ye[ee fu[gp ta[ry
耶戶	ye[ee hu[du
耶利米	ye[ee li[hd mi[ba
耶羅波安	ye[ee lo[sx bo[dp an[gn
耶孫	ye[ee sy[zx
葉忒羅	ye[ku tw[qx lo[sx
耶西	ye[ee xi[hk
耶洗別	ye[ee xi[dn bp[kd
以巴弗	yi[sr ba[ku fu[gp
以巴弗提	yi[sr ba[ku fu[gp ti[fo
以拜尼土	yi[sr bd[fh ni[ub tu[uh
以比贊	yi[sr bi[bb zj[nb
以東	yi[sr ds[qx
易多	yi[ob do[xx
以法蓮	yi[sr fa[dt lm[ci
以笏	yi[sr hu[vb
以拉	yi[sr la[fl
以拉都	yi[sr la[fl dz[te
以利	yi[sr li[hd
以利法	yi[sr li[hd fa[dt
以利戶	yi[sr li[hd hu[du
以利沙	yi[sr li[hd ua[dx
以利沙伯	yi[sr li[hd ua[dx bo[rb
以利亞	yi[sr li[hd ya[hy
以倫	yi[sr ly[rr
以呂馬	yi[sr lv[kk ma[vv
以尼雅	yi[sr ni[ub ya[yv
以諾	yi[sr no[yc
以撒	yi[sr sa[fg
以撒哈頓	yi[sr sa[fg ha[kr dy[ty
以薩迦	yi[sr sa[ce jx[lz
以賽亞	yi[sr sd[gb ya[hy
以掃	yi[sr sc[fx
以色列	yi[sr se[db lp[hd
伊施波設	yi[rx ui[fr bo[dp ue[yj
以實瑪利	yi[sr ui[gd ma[wm li[hd
以斯拉	yi[sr si[qj la[fl
以斯帖	yi[sr si[qj tp[jb
以西結	yi[sr xi[hk jp[su
友布羅	yz[uy bu[uj lo[sx
猶大	yz[qy da[hr
友尼基	yz[uy ni[ub ji[qt
猶尼亞	yz[qy ni[ub ya[hy
猶士都	yz[qy ui[uh dz[te
猶太人	yz[qy td[dd rf[pd
猶推古	yz[qy tv[fv gu[uk
約阿施	yt[sb aa[ek ui[fr
約伯	yt[sb bo[rb
約珥	yt[sb er[we
約哈斯	yt[sb ha[kr si[qj
約翰	yt[sb hj[ur
約基別	yt[sb ji[qt bp[kd
約蘭	yt[sb lj[bs
約拿	yt[sb na[rf
約瑟	yt[sb se[wx
約沙法	yt[sb ua[dx fa[dt
約書亞	yt[sb uu[vv ya[hy
約坦	yt[sb tj[to
約西亞	yt[sb xi[hk ya[hy
約押	yt[sb ya[fo
約雅斤	yt[sb ya[yv jb[ph
約雅敬	yt[sb ya[yv jk[cw
約亞拿	yt[sb ya[hy na[rf
智天使	vi[uo tm[hd ui[rh
中三級子的階級	vs[ku sj[hh ji[sj zi[lh de[bb jp[er ji[sj
主天使	vu[dw tm[hd ui[rh