阿斗當皇帝	aa[ek dz[du dh[xx hl[bw di[lj
阿斗的江山	aa[ek dz[du de[bb jl[dg uj[uk
阿公吃黃連	aa[ek gs[bs ii[kr hl[gy lm[iz
阿拉伯數字八字分家	aa[ek la[fl bo[rb uu[mw zi[gz ba[pd zi[gz ff[bd jx[gu
挨鞭子不挨棍子	ai[fs bm[gr zi[lh bu[eu ai[fs gy[ao zi[lh
挨鞭子的日子到了	ai[fs bm[gr zi[lh de[bb ri[wh zi[lh dc[hd le[vu
挨刀的貨	ai[fs dc[vp de[bb ho[rb
捱了棒的狗	ai[fs le[vu bh[as de[bb gz[qb
愛上鉤	ai[au uh[bh gz[jb
矮子放屁	ai[uh zi[lh fh[fw pi[ub
矮子爬坡	ai[uh zi[lh pa[pb po[tp
矮子騎大馬	ai[uh zi[lh qi[md da[hr ma[vv
矮子上樓梯	ai[uh zi[lh uh[bh lz[am ti[ab
矮子推掌	ai[uh zi[lh tv[fv vh[xf
矮子坐高凳	ai[uh zi[lh zo[rr gc[wk dg[dj
矮子坐高登	ai[uh zi[lh zo[rr gc[wk dg[dd
案板底下放風第	an[ga bj[ap di[gu xx[hb fh[fw fg[ji di[vg
案板上砍骨頭	an[ga bj[ap uh[bh kj[ed gu[ko tz[dd
岸邊的青蛙	an[ui bm[lz de[bb qk[fo wa[it
按綵球的乞丐	an[fg cd[ap qq[wh de[bb qi[rv gd[xv
暗地裡耍拳	an[ol di[ty li[ot ux[en qr[bf
按雞頭啄米	an[fg ji[yn tz[dd vo[ku mi[ba
按老方子吃藥	an[fg lc[tb fh[dw zi[lh ii[kr yc[cs
安祿山起兵	an[gn lu[ux uj[uk qi[zk bk[qb
庵廟裡的尼姑	an[gd mn[gy li[ot de[bb ni[ub gu[ng
暗室裡穿針	an[ol ui[gh li[ot ir[xy vf[ju
暗喜歡	an[ol xi[uk hr[yd
安營紮寨	an[gn yk[ck va[fv vd[ga
按著葫蘆挖籽	an[fg ve[ym hu[cg lu[ch wa[fx zi[mz
按著腦袋往火炕裡鑽	an[fg ve[ym nc[ow dd[ry wh[rd ho[dp kh[hw li[ot zr[jb
按著牛頭喝水	an[fg ve[ym nq[pf tz[dd he[ko uv[uu
暗中活動	an[ol vs[ku ho[dq ds[el
八百年前立的旗杆	ba[pd bd[eo nm[rn qm[bo li[lh de[bb qi[fr gj[ag
巴不得	ba[ku bu[eu de[ro
拔草引蛇	ba[fu cc[co yb[gu ue[ig
八個老漢划拳	ba[pd ge[ru lc[tb hj[dy hx[gd qr[bf
八個歪脖坐一桌	ba[pd ge[ru wd[bh bo[ou zo[rr yi[hh vo[ba
拔尖	ba[fu jm[xd
芭蕉開花	ba[cb jn[cv kd[hc hx[cr
芭蕉葉上壘鳥窩	ba[cb jn[cv ye[ku uh[bh lw[st nn[nh wo[xk
疤瘌眼長瘡	ba[bb la[bh yj[mg vh[ph il[br
拔了毛的鳳凰	ba[fu le[vu mc[sv de[bb fg[jy hl[jb
把臉裝進褲襠裡	ba[fb lm[or vl[dy jb[ez ku[yg dh[yx li[ot
把你往苦裡引	ba[fb ni[rd wh[rd ku[cg li[ot yb[gu
把人跌閃得好苦	ba[fb rf[pd dp[zp uj[mr de[ro hc[nz ku[cg
八十老人吹燈	ba[pd ui[hu lc[tb rf[pd iv[kd dg[hd
霸王別姬	ba[yg wh[su bp[kd ji[nk
八仙過海	ba[pd xm[ru go[cz hd[dr
八賢王進宮	ba[pd xm[ub wh[su jb[ez gs[gk
八月十五吃元宵	ba[pd yt[ke ui[hu wu[hu ii[kr yr[ee xn[gx
八月十五的月亮	ba[pd yt[ke ui[hu wu[hu de[bb yt[ke ll[wj
巴掌穿鞋	ba[ku vh[xf ir[xy xp[gt
擺佈不開	bd[fs bu[uj bu[eu kd[hc
擺不平	bd[fs bu[eu pk[hb
白搭工	bd[po da[fc gs[hu
白費神	bd[po fw[fb uf[uo
白費心機	bd[po fw[fb xb[dv ji[aj
白骨精化美女	bd[po gu[ko jk[mf hx[rq mw[bw nv[vp
白骨精說人話	bd[po gu[ko jk[mf uo[yb rf[pd hx[yq
百貨大樓賣西裝	bd[eo ho[rb da[hr lz[am md[ud xi[hk vl[dy
百斤重擔能上肩一兩筆桿提不動	bd[eo jb[ph vs[ph dj[fo ng[sb uh[bh jm[ho yi[hh ll[hk bi[vm gj[ag ti[fo bu[eu ds[el
白蠟材結桂花	bd[po la[ig cd[ac jp[su gv[at hx[cr
白了尾巴尖的狐狸	bd[po le[vu ww[um ba[ku jm[xd de[bb hu[qp li[qo
柏馬屁拍到蹄子上	bd[ab ma[vv pi[ub pd[fb dc[hd ti[zl zi[lh uh[bh
白娘子遇許仙	bd[po nl[nl zi[lh yu[oz xu[yw xm[ru
白跑	bd[po pc[zb
白日做夢	bd[po ri[wh zo[rg mg[ax
白送	bd[po ss[bz
白疼了一場	bd[po tg[bw ln[vu yi[hh ih[tv
白天盼月亮	bd[po tm[hd pj[mf yt[ke ll[wj
百萬雄師下江南	bd[eo wj[hv xs[uv ui[uh xx[hb jl[dg nj[uk
白鑽空子	bd[po zr[jb ks[xg zi[lh
半道上撿個喇叭	bj[bf dc[bz uh[bh jm[fr ge[ru la[kh ba[kb
半斤對八兩	bj[bf jb[ph dv[yc ba[pd ll[hk
半空中騎馬	bj[bf ks[xg vs[ku qi[md ma[vv
斑馬的腦袋	bj[ww ma[vv de[bb nc[ow dd[ry
搬菩薩洗澡	bj[fv pu[cl sa[ce xi[dn zc[dk
半夜做夢娶新娘	bj[bf ye[wr zo[rg mg[ax qu[en xb[lj nl[nl
斑鴆打架	bj[ww vf[gn da[fd jx[la
扮豬吃老虎	bj[ff vu[qt ii[kr lc[tb hu[hj
包輸	bc[bk uu[ir
輩輩苦	bw[fi bw[fi ku[cg
背後整人	bw[bo hz[pk vg[hh rf[pd
悲喜交加	bw[fx xi[uk jn[li jx[lk
本領高	bf[ah lk[ry gc[wk
本末顛倒	bf[ah mo[ha dm[uy dc[rh
本質太差	bf[ah vi[pu td[dd ia[yg
蹦老高	bg[zu lc[tb gc[wk
甭想	bg[bo xl[ax
彼此彼此	bi[rp ci[vb bi[rp ci[vb
彼此一樣醜	bi[rp ci[vb yi[hh yh[ay iz[vu
必定有緣故	bi[xp dk[gp yz[uo yr[sv gu[gw
畢恭畢敬	bi[bu gs[gx bi[bu jk[cw
比馬大	bi[bb ma[vv da[hr
比上不足比下不餘	bi[bb uh[bh bu[eu zu[kv bi[bb xx[hb bu[eu yu[re
變得真快	bm[yy de[ro vf[uj kk[xv
變壞了	bm[yy hk[tb le[vu
變他本色	bm[yy ta[ry bf[ah ud[db
憋出個猴來	bp[bx iu[ck ge[ru hz[qr ld[hm
別看他小	bp[kd kj[fm ta[ry xn[ub
癟了	bp[bz le[vu
憋氣窩火	bp[bx qi[rh wo[xk ho[dp
別人不親自己親	bp[kd rf[pd bu[eu qb[la zi[pm ji[kv qb[la
不安好心眼	bu[eu an[gn hc[nz xb[dv yj[mg
不必多言	bu[eu bi[xp do[xx yj[we
不變色	bu[eu bm[yy se[db
步步登高	bu[vu bu[vu dg[dd gc[wk
步步高昇	bu[vu bu[vu gc[wk ug[pc
不成	bu[eu ig[wv
不出所料	bu[eu iu[ck so[pj ln[md
不得不低頭	bu[eu de[ro bu[eu di[ru tz[dd
不得不老實	bu[eu de[ro bu[eu lc[tb ui[gd
不得己	bu[eu de[ro ji[kv
不點不亮	bu[eu dm[bd bu[eu ll[wj
不懂	bu[eu ds[xc
不對路數	bu[eu dv[yc lu[zw uu[mw
不對頭	bu[eu dv[yc tz[dd
不分老嫩	bu[eu ff[bd lc[tb nf[nh
不分上下	bu[eu ff[bd uh[bh xx[hb
不分主次	bu[eu ff[bd vu[dw ci[dd
不乾脆	bu[eu gj[hu cv[od
不敢想	bu[eu gj[vw xl[ax
不敢坐上席	bu[eu gj[vw zo[rr uh[bh xi[gn
不顧根本	bu[eu gu[iy gf[ag bf[ah
不管驢事	bu[eu gr[vg lv[mh ui[hk
不過癮	bu[eu go[cz yb[be
不好提	bu[eu hc[nz ti[fo
不合算	bu[eu he[rh sr[vm
不合轍	bu[eu he[rh ve[iw
不懷好意	bu[eu hk[xb hc[nz yi[lx
不會套	bu[eu hv[re tc[di
不計其數	bu[eu ji[yu qi[cb uu[mw
不記前仇俏媳婦戴鳳冠	bu[eu ji[yk qm[bo iz[rj qn[rx xi[nz fu[nx dd[tt fg[jy gr[ge
不簡單	bu[eu jm[vm dj[bo
不進則退	bu[eu jb[ez ze[bd tv[gz
不可靠	bu[eu ke[dk kc[nf
不可能不受沾染	bu[eu ke[dk ng[sb bu[eu uz[ay vj[db rj[da
不爛搞到爛	bu[eu lj[hb gc[fw dc[hd lj[hb
不領情	bu[eu lk[ry qk[xf
不露頭	bu[eu lu[yz tz[dd
不能不求人	bu[eu ng[sb bu[eu qq[hu rf[pd
不能容忍	bu[eu ng[sb rs[xr rf[dx
不怕沒人要	bu[eu pa[xb mw[dj rf[pd yc[xn
不怕壓力大	bu[eu pa[xb ya[it li[vp da[hr
不怕影兒斜	bu[eu pa[xb yk[op er[pv xp[rd
不如雞	bu[eu ru[nk ji[yn
不上算	bu[eu uh[bh sr[vm
不是好東西	bu[eu ui[op hc[nz ds[qx xi[hk
不是好苗頭	bu[eu ui[op hc[nz mn[ct tz[dd
不是好人	bu[eu ui[op hc[nz rf[pd
不是好種	bu[eu ui[op hc[nz vs[hv
不是路	bu[eu ui[op lu[zw
不是門	bu[eu ui[op mf[du
不是哪塊香料	bu[eu ui[op na[kv kk[tv xl[ho ln[md
不是鬧著玩的	bu[eu ui[op nc[mw ve[ym wj[we de[bb
不是時候	bu[eu ui[op ui[oc hz[ru
不識時務	bu[eu ui[yk ui[oc wu[wl
不識抬舉	bu[eu ui[yk td[fs ju[xf
不是偷也是偷	bu[eu ui[op tz[rr ye[vu ui[op tz[rr
不識相	bu[eu ui[yk xl[am
不是這塊料	bu[eu ui[op ve[wz kk[tv ln[md
不是正經材料	bu[eu ui[op vg[hv jk[ss cd[ac ln[md
不死也要脫層皮	bu[eu si[hx ye[vu yc[xn to[ob cg[ue pi[vp
不算數	bu[eu sr[vm uu[mw
不惜代價	bu[eu xi[xg dd[rq jx[rr
不響	bu[eu xl[kp
不想給你吵	bu[eu xl[ax gw[sr ni[rd ic[kx
不相上下	bu[eu xl[am uh[bh xx[hb
不象樣	bu[eu xl[dk yh[ay
不曉得軟硬	bu[eu xn[oq de[ro rr[id yk[eh
不行了	bu[eu xk[rh le[vu
不要臉	bu[eu yc[xn lm[or
不腰痛	bu[eu yc[ox ts[bs
不著邊際	bu[eu vc[ym bm[lz ji[ee
不知吃力	bu[eu vi[uk ii[kr li[vp
不知底細	bu[eu vi[uk di[gu xi[st
不知幾品	bu[eu vi[uk ji[pv pb[kk
不知輕重	bu[eu vi[uk qk[is vs[ph
不值摔打	bu[eu vi[ru uk[fw da[fd
不知死活	bu[eu vi[uk si[hx ho[dq
不知眼有多高	bu[eu vi[uk yj[mg yz[uo do[xx gc[wk
不阻力	bu[eu zu[eq li[vp
彩虹和白雲談情	cd[ap hs[ig he[hk bd[po yy[es tj[yh qk[xf
財迷轉向	cd[bc mi[mz vr[ie xl[pk
採取主動	cd[aa qu[ey vu[dw ds[el
財神爺戴烏紗帽	cd[bc uf[uo ye[be dd[tt wu[bv ua[sx mc[jo
踩著肩頭往頭上拉屎	cd[za ve[ym jm[ho tz[dd wh[rd tz[dd uh[bh la[fl ui[um
藏頭露尾	ch[cw tz[dd lu[yz ww[um
蒼蠅叮菩薩	ch[cr yk[ik dk[kd pu[cl sa[ce
蒼蠅嘴巴狗鼻子	ch[cr yk[ik zv[kv ba[ku gz[qb bi[zt zi[lh
草包	cc[co bc[bk
曹操敗走華客道	cc[ho cc[fk bd[bw zz[tv hx[ru ke[gw dc[bz
曹操敗走華容道	cc[ho cc[fk bd[bw zz[tv hx[ru rs[xr dc[bz
曹操吃雞肋	cc[ho cc[fk ii[kr ji[yn lw[ol
曹操遇蔣幹	cc[ho cc[fk yu[oz jl[cd gj[hu
曹操諸葛亮	cc[ho cc[fk vu[yt ge[co ll[wj
廁所裡照鏡子	ce[ib so[pj li[ot vc[od jk[jl zi[lh
茶壺有嘴難說話	ia[cr hu[uy yz[uo zv[kv nj[yv uo[yb hx[yq
茶鋪裡不要的夥計	ia[cr pu[jf li[ot bu[eu yc[xn de[bb ho[rh ji[yu
長城上的磚	ih[ph ig[tw uh[bh de[bb vr[ee
嫦娥跳舞	ih[nx ee[np tn[zv wu[rx
唱高調	ih[ko gc[wk dn[yk
長頸鹿進馬群	ih[ph jk[sy lu[gb jb[ez ma[vv qy[xy
長絲瓜當扁擔	ih[ph si[sh gx[ps dh[xx bm[hk dj[fo
唱戲的穿龍袍	ih[ko xi[yg de[bb ir[xy ls[yp pc[yb
唱戲的鬍子	ih[ko xi[yg de[bb hu[go zi[lh
扯得長	ie[fv de[ro ih[ph
徹底垮臺	ie[rq di[gu kx[td td[sk
扯褲子補補丁	ie[fv ku[yg zi[lh bu[yb bu[yb dk[hu
扯著老虎尾巴喊救命	ie[fv ve[ym lc[tb hu[hj ww[um ba[ku hj[kw jq[hw mk[rh
趁機磨刀	if[zr ji[aj mo[ge dc[vp
成不了皇帝	ig[wv bu[eu ln[vu hl[bw di[lj
城隍廟裡著了火	ig[tw hl[eb mn[gy li[ot ve[ym le[vu ho[dp
城隍娘娘有喜	ig[tw hl[eb nl[nl nl[nl yz[uo xi[uk
城樓上亮相	ig[tw lz[am uh[bh ll[wj xl[am
成全好事	ig[wv qr[rw hc[nz ui[hk
成群結隊	ig[wv qy[xy jp[su dv[er
逞什麼	ig[kz uf[ru me[ps
成雙成對	ig[wv ul[yy ig[wv dv[yc
誠心實意	ig[yw xb[dv ui[gd yi[lx
吃虧的是自己	ii[kr kv[hk de[bb ui[op zi[pm ji[kv
吃了對門謝隔壁	ii[kr le[vu dv[yc mf[du xp[yu ge[eh bi[ut
痴人說夢	ii[bu rf[pd uo[yb mg[ax
吃軟不吃硬	ii[kr rr[id bu[eu ii[kr yk[eh
痴心妄想	ii[bu xb[dv wh[wn xl[ax
吃魚不吐骨頭	ii[kr yu[dt bu[eu tu[kt gu[ko tz[dd
遲早要飛	ii[uz zc[ou yc[xn fw[vp
充人來了	is[we rf[pd ld[hm le[vu
臭不要臉	iz[zq bu[eu yc[xn lm[or
醜對醜	iz[vu dv[yc iz[vu
臭美	iz[zq mw[bw
抽你的筋剝你的皮	iz[fy ni[rd de[bb jb[vo bo[xd ni[rd de[bb pi[vp
楚霸王自刎烏江	iu[ap ba[yg wh[su zi[pm wf[bd wu[bv jl[dg
出不了格	iu[ck bu[eu ln[vu ge[aw
出不了好主意	iu[ck bu[eu ln[vu hc[nz vu[dw yi[lx
出師不利	iu[ck ui[uh bu[eu li[hd
出手不高	iu[ck uz[su bu[eu gc[wk
喘不上氣	ir[ku bu[eu uh[bh qi[rh
吹不得	iv[kd bu[eu de[ro
吹不響	iv[kd bu[eu xl[kp
吹的	iv[kd de[bb
吹了	iv[kd le[vu
垂頭喪氣	iv[ph tz[dd sh[ty qi[rh
此路不通	ci[vb lu[zw bu[eu ts[sz
蔥頭不開花	cs[cb tz[dd bu[eu kd[hc hx[cr
從頭甜到腳	cs[rr tz[dd tm[qg dc[hd jn[ot
粗中有細	cu[mq vs[ku yz[uo xi[st
催命鬼	cv[ru mk[rh gv[be
存心害人	cy[uz xb[dv hd[gf rf[pd
錯了	co[jg le[vu
錯路一條	co[jg lu[zw yi[hh tn[wa
大擺布	da[hr bd[fs bu[uj
大不了	da[hr bu[eu ln[vu
搭不上手	da[fc bu[eu uh[bh uz[su
大材小用	da[hr cd[ac xn[ub ys[ou
大車初一打拼夥	da[hr ie[qu iu[yd yi[hh da[fd pb[fb ho[rh
大處不算小處算	da[hr iu[wb bu[eu sr[vm xn[ub iu[wb sr[vm
大吹大擂	da[hr iv[kd da[hr lw[fy
打燈籠走親戚一明去明來	da[fd dg[hd ls[vy zz[tv qb[la qi[wu yi[hh mk[oo qu[ts mk[oo ld[hm
大公雞吃米	da[hr gs[bs ji[yn ii[kr mi[ba
大姑娘嫁太監	da[hr gu[ng nl[nl jx[ng td[dd jm[um
大姑娘瞧嫁妝	da[hr gu[ng nl[nl qn[mv jx[ng vl[dn
大姑娘腫臉	da[hr gu[ng nl[nl vs[ov lm[or
大海里的一滴水	da[hr hd[dr li[ot de[bb yi[hh di[dl uv[uu
大街上的行人	da[hr jp[rt uh[bh de[bb xk[rh rf[pd
打開棺材喊捉賊	da[fd kd[hc gr[ag cd[ac hj[kw vo[fz zw[bg
打開天窗	da[fd kd[hc tm[hd il[xp
大老粗	da[hr lc[tb cu[mq
大流子的弟弟	da[hr lq[dw zi[lh de[bb di[bg di[bg
打鑼賣糖	da[fd lo[js md[ud th[mg
大門日的石獅子	da[hr mf[du ri[wh de[bb ui[ek ui[qu zi[lh
大年三十看黃曆	da[hr nm[rn sj[hh ui[hu kj[fm hl[gy li[il
打鳥姿態	da[fd nn[nh zi[dn td[dx
打破腦袋叫扇子扇	da[fd po[ep nc[ow dd[ry jn[kv uj[hx zi[lh uj[hx
大起大落	da[hr qi[zk da[hr lo[cd
搭起戲臺賣豆腐	da[fc qi[zk xi[yg td[sk md[ud dz[hk fu[gk
搭起戲臺賣螃蟹	da[fc qi[zk xi[yg td[sk md[ud ph[il xp[di
大熱天穿皮襖	da[hr re[fd tm[hd ir[xy pi[vp ao[yp
打上黑臉照鏡	da[fd uh[bh hw[sd lm[or vc[od jk[jl
大聖吃毫毛	da[hr ug[yt ii[kr hc[wm mc[sv
大聲叫喊	da[hr ug[um jn[kv hj[kw
大水衝了龍王廟	da[hr uv[uu is[dv le[vu ls[yp wh[su mn[gy
打死老鼠喂貓	da[fd si[hx lc[tb uu[jv ww[kt mc[qc
打烏米的眼睛	da[fd wu[bv mi[ba de[bb yj[mg jk[mf
大蝦炒雞爪兒	da[hr xx[ix ic[hx ji[yn vx[pu er[pv
大顯神威	da[hr xm[oy uf[uo ww[wh
大象喝水	da[hr xl[dk he[ko uv[uu
大小各有用場	da[hr xn[ub ge[wk yz[uo ys[ou ih[tv
大雁飛行	da[hr yj[ir fw[vp xk[rh
大智若愚	da[hr vi[uo ro[cu yu[ox
打腫臉充胖子	da[fd vs[ov lm[or is[we ph[ob zi[lh
打足了氣的皮球	da[fd zu[kv le[vu qi[rh de[bb pi[vp qq[wh
打足氣的氣球	da[fd zu[kv qi[rh de[bb qi[rh qq[wh
帶刺	dd[cj ci[cd
待著不動	dd[ka ve[ym bu[eu ds[el
戴著面具進棺材	dd[tt ve[ym mm[ew ju[jb jb[ez gr[ag cd[ac
戴著面具親嘴	dd[tt ve[ym mm[ew ju[jb qb[la zv[kv
呆子	dd[ka zi[lh
擔當不起	dj[fo dh[xx bu[eu qi[zk
淡而無味	dj[dh er[ek wu[ee ww[kh
膽小如鼠	dj[oo xn[ub ru[nk uu[jv
擋鳳板做鍋蓋	dh[fx fg[jy bj[ap zo[rg go[jk gd[bm
倒捱了一錐子	dc[rh ai[fs le[vu yi[hh vv[jv zi[lh
倒挨一腳	dc[rh ai[fs yi[hh jn[ot
稻草人救火	dc[ha cc[co rf[pd jq[hw ho[dp
道道多	dc[bz dc[bz do[xx
搗鼓不開	dc[fn gu[uu bu[eu kd[hc
倒了大黴	dc[rh le[vu da[hr mw[yr
盜馬賊披袈裟	dc[dm ma[vv zw[bg pi[fp jx[ly ua[dy
倒貼	dc[rh tp[bb
道聽途說	dc[bz tk[kj tu[rz uo[yb
倒著走	dc[rh ve[ym zz[tv
得不償失	de[ro bu[eu ih[rx ui[pe
得心應手	de[ro xb[dv yk[gx uz[su
等不到老	dg[vt bu[eu dc[hd lc[tb
等著挨刀	dg[vt ve[ym ai[fs dc[vp
登著耗子當成牛	dg[dd ve[ym hc[lm zi[lh dh[xx ig[wv nq[pf
低聲下氣	di[ru ug[um xx[hb qi[rh
點不起火	dm[bd bu[eu qi[zk ho[dp
點燃的蠟燭一長命不了	dm[bd rj[hx de[bb la[ig vu[hi yi[hh vh[ph mk[rh bu[eu ln[vu
點著火的雙響	dm[bd ve[ym ho[dp de[bb ul[yy xl[kp
吊兒郎當	dn[kj er[pv lh[le dh[xx
動不得	ds[el bu[eu de[ro
東倒西歪	ds[qx dc[rh xi[hk wd[bh
抖起來了	dz[fd qi[zk ld[hm le[vu
抖什麼威風	dz[fd uf[ru me[ps ww[wh fg[ji
都閒著	dz[te xm[ma ve[ym
堵不完的窟窿	du[tt bu[eu wj[ge de[bb ku[xu ls[xe
獨具隻眼	du[qi ju[jb vi[kb yj[mg
肚裡有貨倒不出	du[ot li[ot yz[uo ho[rb dc[rh bu[eu iu[ck
獨吞	du[qi ty[tk
斷了柄鋤頭安了把	dr[mj le[vu bk[ah iu[jq tz[dd an[gn le[vu ba[fb
斷了線的梭子	dr[mj le[vu xm[sj de[bb so[as zi[lh
短命的貨	dr[ud mk[rh de[bb ho[rb
對不上號	dv[yc bu[eu uh[bh hc[kk
對天講話	dv[yc tm[hd jl[ye hx[yq
多此一舉	do[xx ci[vb yi[hh ju[xf
多一層比少一層好	do[xx yi[hh cg[ue bi[bb uc[xp yi[hh cg[ue hc[nz
多一股子氣	do[xx yi[hh gu[oj zi[lh qi[rh
多餘	do[xx yu[re
躲雨躲到城隍廟	do[uj yu[hk do[uj dc[hd ig[tw hl[eb mn[gy
多嘴多舌	do[xx zv[kv do[xx ue[qk
鵝蛋石跌進刺蓬裡	ee[pn dj[pi ui[ek dp[zp jb[ez ci[cd pg[cw li[ot
惡鬼見鍾旭	ee[hx gv[be jm[ke vs[jv xu[jo
餓虎進宅	ee[up hu[hj jb[ez vd[gp
餓狼竄進羊廄	ee[up lh[ql cr[xk jb[ez yh[bs jq[ig
惡狼對羊笑	ee[hx lh[ql dv[yc yh[bs xn[vp
惡狼和瘋狗作伴	ee[hx lh[ql he[hk fg[bf gz[qb zo[rv bj[rb
餓狼日裡奪脆骨	ee[up lh[ql ri[wh li[ot do[dc cv[od gu[ko
惡狼生個賊狐狸	ee[hx lh[ql ug[pf ge[ru zw[bg hu[qp li[qo
鵝盆裡不準鴨插嘴	ee[pn pf[fm li[ot bu[eu vy[dv ya[on ia[fq zv[kv
惡人登門	ee[hx rf[pd dg[dd mf[du
惡人雕戴皮帽	ee[hx rf[pd dn[kv dd[tt pi[vp mc[jo
惡人先告狀	ee[hx rf[pd xm[ne gc[nk vl[dq
鵝伸脖子	ee[pn uf[ro bo[ou zi[lh
額頭角上擱扁擔	ee[gy tz[dd jn[do uh[bh ge[fm bm[hk dj[fo
額頭上插牡丹	ee[gy tz[dd uh[bh ia[fq mu[nt dj[kw
額外負擔	ee[gy wd[xb fu[db dj[fo
鵝在水中尋食	ee[pn zd[ut uv[uu vs[ku xy[xc ui[rl
餓著肚子做夢	ee[up ve[ym du[ot zi[lh zo[rg mg[ax
餓豬佔木槽	ee[up vu[qt vj[bk mu[ub cc[ah
二百加五十	er[hh bd[eo jx[lk wu[hu ui[hu
二百五	er[hh bd[eo wu[hu
二不愣當家	er[hh bu[eu lg[xs dh[xx jx[gu
二尺長的吹火筒	er[hh ii[ud vh[ph de[bb iv[kd ho[dp ts[vk
耳朵裡塞棉花	er[hu do[ja li[ot sd[gt mm[ab hx[cr
耳朵塞驢毛	er[hu do[ja sd[gt lv[mh mc[sv
二郎神的印堂	er[hh lh[le uf[uo de[bb yb[pe th[xt
二兩棉花	er[hh ll[hk mm[ab hx[cr
二流子	er[hh lq[dw zi[lh
二流子打鼓	er[hh lq[dw zi[lh da[fd gu[uu
二踢腳	er[hh ti[zo jn[ot
二萬五千里長徵	er[hh wj[hv wu[hu qm[pu li[ot ih[ph vg[rh
爾虞我詐	er[dx yu[hk wo[pf va[yv
兒子不養娘	er[pv zi[lh bu[eu yh[yp nl[nl
發啦	fa[vy la[kf
乏味	fa[pv ww[kh
翻不過身來	fj[px bu[eu go[cz uf[pu ld[hm
翻江倒海	fj[px jl[dg dc[rh hd[dr
犯勁	fj[qe jb[sl
反了	fj[py le[vu
飛不起來	fw[vp bu[eu qi[zk ld[hm
費功夫	fw[fb gs[gl fu[er
非輸不可	fw[su uu[ir bu[eu ke[dk
非災即禍	fw[su zd[gh ji[ge ho[uk
扶不直	fu[fe bu[eu vi[uj
父子相認	fu[bi zi[lh xl[am rf[yr
旮旯裡藏毒蛇	ga[jo la[oj li[ot ch[cw du[fm ue[ig
嘎小子買燒雞	ga[ke xn[ub zi[lh md[vd uc[hq ji[yn
改朝換代	gd[kw ic[uo hr[fd dd[rq
蓋房請來箍桶匠	gd[bm fh[hf qk[yf ld[hm gu[vf ts[as jl[kj
蓋了九床被子做美夢	gd[bm le[vu jq[pv il[ga bw[yp zi[lh zo[rg mw[bw mg[ax
該下臺了	gd[yw xx[hb td[sk le[vu
乾癟	gj[hu bp[bz
乾草點燈	gj[hu cc[co dm[bd dg[hd
趕場帶相親	gj[zg ih[tv dd[cj xl[am qb[la
趕場走進死衚衕	gj[zg ih[tv zz[tv jb[ez si[hx hu[go ts[kh
乾打雷不下雨	gj[hu da[fd lw[yt bu[eu xx[hb yu[hk
乾乾脆脆	gj[hu gj[hu cv[od cv[od
乾旱的莊稼	gj[hu hj[og de[bb vl[gt jx[hg
幹河溝的魚	gj[hu he[dk gz[db de[bb yu[dt
幹河灘裡種牡丹	gj[hu he[dk tj[dy li[ot vs[hv mu[nt dj[kw
幹活打瞌睡	gj[hu ho[dq da[fd ke[mt uv[mi
趕雞下河	gj[zg ji[yn xx[hb he[dk
趕腳的騎驢	gj[zg jn[ot de[bb qi[md lv[mh
乾淨不了	gj[hu jk[dd bu[eu ln[vu
橄欖屁股	gj[av lj[au pi[ub gu[oj
趕龍王下海	gj[zg ls[yp wh[su xx[hb hd[dr
幹蘿蔔纓熬湯	gj[hu lo[cs bo[ud yk[sb ao[fd th[dv
擀麵杖吹火	gj[fu mm[ew vh[ah iv[kd ho[dp
擀麵杖分長短	gj[fu mm[ew vh[ah ff[bd ih[ph dr[ud
擀麵杖鑽石頭	gj[fu mm[ew vh[ah zr[jb ui[ek tz[dd
幹輕巧活	gj[hu qk[is qn[gk ho[dq
甘蔗拔節	gj[nh ve[cg ba[fu jp[ce
甘蔗林裡種香瓜	gj[nh ve[cg lb[aa li[ot vs[hv xl[ho gx[ps
甘蔗皮編席子	gj[nh ve[cg pi[vp bm[sh xi[gn zi[lh
趕著王母娘娘叫大姑	gj[zg ve[ym wh[su mu[vv nl[nl nl[nl jn[kv da[hr gu[ng
剛扯帆就遇頂頭風	gh[kd ie[fv fj[jj jq[wy yu[oz dk[dy tz[dd fg[ji
剛出爐的純鋼	gh[kd iu[ck lu[hh de[bb iy[st gh[jk
剛出山的太陽	gh[kd iu[ck uj[uk de[bb td[dd yh[eo
剛出水的蝦子	gh[kd iu[ck uv[uu de[bb xx[ix zi[lh
剛出土的黃連	gh[kd iu[ck tu[uh de[bb hl[gy lm[iz
剛逮住的鯉魚	gh[kd dd[xz vu[rd de[bb li[yo yu[dt
高出了頭	gc[wk iu[ck le[vu tz[dd
高飛的鳥兒遇老鷹	gc[wk fw[vp de[bb nn[nh er[pv yu[oz lc[tb yk[gn
高級合金鋼	gc[wk ji[sj he[rh jb[rw gh[jk
高明	gc[wk mk[oo
高攀	gc[wk pj[ad
高山頭種辣椒	gc[wk uj[uk tz[dd vs[hv la[lh jn[au
高興得發傻	gc[wk xk[xb dw[ro fa[vy ua[rp
高姿態	gc[wk zi[dn td[dx
疙瘩餅子送閨女	ge[br da[bc bk[ub zi[lh ss[bz gv[mt nv[vp
隔黃河送秋波	ge[eh hl[gy he[dk ss[bz qq[hh bo[dp
隔年的臭蟲	ge[eh nm[rn de[bb iz[zq is[ks
隔年的春聯	ge[eh nm[rn de[bb iy[so lm[eb
各人享各人福	ge[wk rf[pd xl[wz ge[wk rf[pd fu[uh
隔山打鳥	ge[eh uj[uk da[fd nn[nh
割下鼻子換面吃	ge[gd xx[hb bi[zt zi[lh hr[fd mm[ew ii[kr
各顯神通	ge[wk xm[oy uf[uo ts[sz
各有各的打法	ge[wk yz[uo ge[wk de[bb da[fd fa[dt
各有一技之長	ge[wk yz[uo yi[hh ji[fu vi[dv ih[ph
各於一行	ge[wk yu[eu yi[hh hh[rh
胳肢窩裡夾耗子	ge[ow vi[ou wo[xk li[ot jx[hb hc[lm zi[lh
各走各的道	ge[wk zz[tv ge[wk de[bb dc[bz
各走一端	ge[wk zz[tv yi[hh dr[lu
根底淺	gf[ag di[gu qm[dj
根深時茂	gf[ag uf[dg ui[oc mc[cw
根子不正	gf[ag zi[lh bu[eu vg[hv
夠不著	gz[bx bu[eu vc[ym
夠喘的了	gz[bx ir[ku de[bb le[vu
勾勾搭搭	gz[bs gz[bs da[fc da[fc
狗眼看人	gz[qb yj[mg kj[fm rf[pd
夠硬	gz[bx yk[eh
顧前不顧後	gu[iy qm[bo bu[eu gu[iy hz[pk
鼓足了勁	gu[uu zu[kv le[vu jb[sl
掛個空名	gx[ft ge[ru ks[xg mk[xk
怪事一樁	gk[xy ui[hk yi[hh vl[ag
怪物	gk[xy wu[nb
管不了廟裡事	gr[vg bu[eu ln[vu mn[gy li[ot ui[hk
管得寬	gr[vg de[ro kr[gc
管的寬	gr[vg de[bb kr[gc
觀點模糊	gr[yj dm[bd mo[ac hu[mg
光打光	gl[xe da[fd gl[xe
光剩嘴了	gl[xe ug[qd zv[kv le[vu
光耍嘴	gl[xe ux[en zv[kv
鬼把戲	gv[be ba[fb xi[yg
鬼點子多	gv[be dm[bd zi[lh do[xx
鬼相	gv[be xl[am
鬼樣子	gv[be yh[ay zi[lh
過得硬	go[cz de[ro yk[eh
過一天算一天	go[cz yi[hh tm[hd sr[vm yi[hh tm[hd
還不了	hd[bz bu[eu le[vu
還是老一套	hd[bz ui[op lc[tb yi[hh tc[di
旱該倒了	hj[og gd[yw dc[rh le[vu
罕見	hj[gg jm[ke
寒酸	hj[gd sr[ys
好大的膽	hc[nz da[hr de[bb dj[oo
好大的口氣	hc[nz da[hr de[bb kz[uv qi[rh
好大的氣	hc[nz da[hr de[bb qi[rh
好大的胃口	hc[nz da[hr de[bb ww[to kz[uv
好景不長	hc[nz jk[ow bu[eu ih[ph
好看有限	hc[nz kj[fm yz[uo xm[eg
好厲害	hc[nz li[iw hd[gf
好難請	hc[nz nj[yv qk[yf
好捏	hc[nz np[fo
好色之徒	hc[nz se[db vi[dv tu[rz
好上加好	hc[nz uh[bh jx[lk hc[nz
好偉大	hc[nz ww[rw da[hr
合在一起幹	he[rh zd[ut yi[hh qi[zk gj[hu
黑吃黑	hw[sd ii[kr hw[sd
黑老鴉下了個白雞蛋	hw[sd lc[tb ya[yn xx[hb le[vu ge[ru bd[po ji[yn dj[pi
黑李這碰見猛張飛	hw[sd li[az ve[wz pg[eb jm[ke mg[qz vh[gi fw[vp
黑下髒來	hw[sd xx[hb zh[og ld[hm
黑瞎子吃石榴	hw[sd xx[mg zi[lh ii[kr ui[ek lq[ap
黑瞎子上轎	hw[sd xx[mg zi[lh uh[bh jn[ip
黑瞎子耍門扛	hw[sd xx[mg zi[lh ux[en mf[du kh[fg
黑旋風的本名	hw[sd xr[fr fg[ji de[bb bf[ah mk[xk
狠對狠	hf[qg dv[yc hf[qg
恨人不死	hf[xg rf[pd bu[eu si[hx
橫衝直撞	hg[ag is[dv vi[uj vl[fl
橫闖一個點兒	hg[ag il[mm yi[hh ge[ru dm[bd er[pv
橫槓竹子	hg[ag gh[ag vu[rr zi[lh
哼哈二將鬥法	hg[kw ha[kr er[hh jl[dx dz[du fa[dt
橫說豎說都有理	hg[ag uo[yb uu[ul uo[yb dz[te yz[uo li[wo
橫行霸道	hg[ag xk[rh ba[yg dc[bz
橫行不了	hg[ag xk[rh bu[eu ln[vu
紅不過一會兒了	hs[sg bu[eu go[cz yi[hh hv[re er[pv le[vu
紅不久	hs[sg bu[eu jq[xd
紅到頂了	hs[sg dc[hd dk[dy le[vu
紅光滿面	hs[sg gl[xe mj[dc mm[ew
紅花女做媒	hs[sg hx[cr nv[vp zo[rg mw[ng
烘爐裡的王八	hs[hg lu[hh li[ot de[bb wh[su ba[pd
紅娘捱打	hs[sg nl[nl ai[fs da[fd
紅人	hs[sg rf[pd
紅運將至	hs[sg yy[ez jl[dx vi[ht
洪澤湖的魚鷹	hs[dg ze[dy hu[dg de[bb yu[dt yk[gn
後半截	hz[pk bj[bf jp[tv
後患無窮	hz[pk hr[kx wu[ee qs[xl
後悔已晚	hz[pk hv[xr yi[kv wj[od
後勁大	hz[pk jb[sl da[hr
後來居上	hz[pk ld[hm ju[ug uh[bh
喉嚨長刺口生瘡	hz[kr ls[ky vh[ph ci[cd kz[uv ug[pf il[br
猴學樣	hz[qr xt[xz yh[ay
猴子戴涼帽	hz[qr zi[lh dd[tt ll[dw mc[jo
猴子的屁股	hz[qr zi[lh de[bb pi[ub gu[oj
猴子扇扇子	hz[qr zi[lh uj[hx uj[hx zi[lh
互不相干	hu[hv bu[eu xl[am gj[hu
護城河的王八	hu[fh ig[tw he[dk de[bb wh[su ba[pd
糊糊塗塗	hu[mg hu[mg tu[dr tu[dr
胡砍	hu[go kj[ed
胡拉亂扯	hu[go la[fl lr[qv ie[fv
狐狸吃不到的葡萄	hu[qp li[qo ii[kr bu[eu dc[hd de[bb pu[cb tc[cb
狐狸吃刺蝟	hu[qp li[qo ii[kr ci[cd ww[qt
狐狸鑽罐子	hu[qp li[qo zr[jb gr[wc zi[lh
葫蘆掉井裡	hu[cg lu[ch dn[fb jk[ep li[ot
葫蘆蜂的窩	hu[cg lu[ch fg[iw de[bb wo[xk
葫蘆裡賣藥	hu[cg lu[ch li[ot md[ud yc[cs
葫蘆裡裝水	hu[cg lu[ch li[ot vl[dy uv[uu
胡蘿蔔就燒酒	hu[go lo[cs bo[ud jq[wy uc[hq jq[dy
胡蘿蔔刻的小孩兒	hu[go lo[cs bo[ud ke[wd de[bb xn[ub hd[zw er[pv
胡撲打	hu[go pu[fb da[fd
猢猻穿衣裳	hu[qg sy[qz ir[xy yi[wy uh[xy
胡屠戶的女婿	hu[go tu[ut hu[du de[bb nv[vp xu[np
互相照應	hu[hv xl[am vc[od yk[gx
畫筆敲敲	hx[ht bi[vm qn[wb qn[wb
華而不實	hx[ru er[ek bu[eu ui[gd
花崗岩下油鍋	hx[cr gh[uk yj[ue xx[hb yz[dy go[jk
花骨朵碰在屠刀上	hx[cr gu[ko do[ja pg[eb zd[ut tu[ut dc[vp uh[bh
花果山上沒外姓	hx[cr go[oa uj[uk uh[bh mw[dj wd[xb xk[np
花架下養雞鴨	hx[cr jx[la xx[hb yh[yp ji[yn ya[on
畫匠不給神作揖	hx[ht jl[kj bu[eu gw[sr uf[uo zo[rv yi[fk
花轎前的樂隊	hx[cr jn[ip qm[bo de[bb yt[px dv[er
畫面上的酒菜	hx[ht mm[ew uh[bh de[bb jq[dy cd[ca
花瓶裡種樹	hx[cr pk[bw li[ot vs[hv uu[ay
話中帶刺	hx[yq vs[ku dd[cj ci[cd
壞到一塊了	hk[tb dc[hd yi[hh kk[tv le[vu
懷的鬼胎	hk[xb de[bb gv[be td[os
懷兒婆的口糧	hk[xb er[pv po[dn de[bb kz[uv ll[ml
皇帝補皮鞋	hl[bw di[lj bu[yb pi[vp xp[gt
黃豆煮豆腐	hl[gy dz[hk vu[td dz[hk fu[gk
黃連樹上結糖梨	hl[gy lm[iz uu[ay uh[bh jp[su th[mg li[ha
黃連樹下種苦瓜	hl[gy lm[iz uu[ay xx[hb vs[hv ku[cg gx[ps
荒涼	hl[cw ll[dw
黃牛拉磨	hl[gy nq[pf la[fl mo[ge
黃鼠狼抽了筋	hl[gy uu[jv lh[ql iz[fy le[vu jb[vo
黃鼠狼的脾氣	hl[gy uu[jv lh[ql de[bb pi[ob qi[rh
黃鼠狼見了雞	hl[gy uu[jv lh[ql jm[ke le[vu ji[yn
黃鼠狼下息	hl[gy uu[jv lh[ql xx[hb xi[zx
會唱會跳	hv[re ih[ko hv[re tn[zv
回頭見高低	hv[wk tz[dd jm[ke gc[wk di[ru
回頭難	hv[wk tz[dd nj[yv
悔之莫及	hv[xr vi[dv mo[co ji[pv
會走不會飛	hv[re zz[tv bu[eu hv[re fw[vp
渾蛋	hy[dg dj[pi
混蛋到底	hy[do dj[pi dc[hd di[gu
混飯吃	hy[do fj[up ii[kr
混年號	hy[do nm[rn hc[kk
渾身打哆哆	hy[dg uf[pu da[fd do[kx do[kx
渾身都軟了	hy[dg uf[pu dz[te rr[id le[vu
渾身是氣	hy[dg uf[pu ui[op qi[rh
活蹦亂跳	ho[dq bg[zu lr[qv tn[zv
豁出來了	ho[gb iu[ck ld[hm le[vu
豁出去了	ho[gb iu[ck qu[ts le[vu
火氣太大	ho[dp qi[rh td[dd da[hr
貨色不多架勢不大	ho[rb se[db bu[eu do[xx jx[la ui[fl bu[eu da[hr
禍在眼前	ho[uk zd[ut yj[mg qm[bo
豁子吵嘴	ho[gb zi[lh ic[kx zv[kv
豁子喝米湯	ho[gb zi[lh he[ko mi[ba th[dv
雞腸舌刮油	ji[yn ih[ov ue[qk gx[qd yz[dy
記吃不記打	ji[yk ii[kr bu[eu ji[yk da[fd
機關槍瞄大炮	ji[aj gr[bt ql[ar mn[mc da[hr pc[hb
唧唧喳喳	ji[kg ji[kg va[ka va[ka
脊樑骨上長茄子	ji[uo ll[da gu[ko uh[bh ih[ph qp[cl zi[lh
積木搭牆	ji[hk mu[ub da[fc ql[tt
急人之所急	ji[dx rf[pd vi[dv so[pj ji[dx
藉絲炒黃豆芽	ji[cl si[sh ic[hx hl[gy dz[hk ya[cy
畸形人做衣服	ji[td xk[kp rf[pd zo[rg yi[wy fu[oe
賈寶玉出家	jx[xb bc[gw yu[wd iu[ck jx[gu
賈寶玉的通靈玉	jx[xb bc[gw yu[wd de[bb ts[sz lk[xh yu[wd
賈寶玉看西廂記	jx[xb bc[gw yu[wd kj[fm xi[hk xl[ia ji[yk
假充鷹	jx[rk is[we yk[gn
假的	jx[rk de[bb
賈府門前的獅子	jx[xb fu[gr mf[du qm[bo de[bb ui[qu zi[lh
嫁禍於人	jx[ng ho[uk yu[eu rf[pd
賈家姑娘嫁賈家	jx[xb jx[gu gu[ng nl[nl jx[ng jx[xb jx[gu
假門假事	jx[rk mf[du jx[rk ui[hk
家人不認識一家人	jx[gu rf[pd bu[eu rf[yr ui[yk yi[hh jx[gu rf[pd
見不得人	jm[ke bu[eu de[ro rf[pd
奸臣當道	jm[ng if[ku dh[xx dc[bz
煎過三遍的藥渣	jm[bd go[cz sj[hh bm[hz de[bb yc[cs va[da
賤貨	jm[bj ho[rb
見窟窿就鑽	jm[ke ku[xu ls[xe jq[wy zr[jb
見面就崩	jm[ke mm[ew jq[wy bg[uo
見死不救	jm[ke si[hx bu[eu jq[hw
肩頭上放花炮	jm[ho tz[dd uh[bh fh[fw hx[cr pc[hb
見異思遷	jm[ke yi[kc si[tx qm[qz
見者有份	jm[ke ve[to yz[uo ff[rf
講風涼話	jl[ye fg[ji ll[dw hx[yq
蔣幹盜書	jl[cd gj[hu dc[dm uu[vv
醬缸醃時子	jl[dy gh[wg yj[od ui[oc zi[lh
醬壇裡裝個鱉	jl[dy tj[te li[ot vl[dy ge[ru bp[by
腳踩兩隻船	jn[ot cd[za ll[hk vi[kb ir[vj
腳踩西瓜皮手裡抓把泥	jn[ot cd[za xi[hk gx[ps pi[vp uz[su li[ot vx[fp ba[fb ni[du
腳蹬鼻子	jn[ot dg[zd bi[zt zi[lh
腳底下踩棒槌	jn[ot di[gu xx[hb cd[za bh[as iv[ap
跤龍頭上搔癢	jn[zl ls[yp tz[dd uh[bh sc[fy yh[by
腳盆裡撐船	jn[ot pf[fm li[ot ig[fx ir[vj
教菩薩認字	jn[tw pu[cl sa[ce rf[yr zi[gz
叫人眼飽肚飢	jn[kv rf[pd yj[mg bc[ub du[ot ji[uj
腳踏實地	jn[ot ta[zu ui[gd di[ty
狡兔撞鷹	jn[ql tu[dk vl[fl yk[gn
結果不好	jp[su go[oa bu[eu hc[nz
街上賣笛	jp[rt uh[bh md[ud di[vy
借題發揮	jp[rg ti[oy fa[vy hv[fg
街頭的狗	jp[rt tz[dd de[bb gz[qb
街頭上耍把戲	jp[rt tz[dd uh[bh ux[en ba[fb xi[yg
進不得城	jb[ez bu[eu de[ro ig[tw
金不換	jb[rw bu[eu hr[fd
盡見鬼	jb[ud jm[ke gv[be
盡講風涼話	jb[ud jl[ye fg[ji ll[dw hx[yq
斤斤計較	jb[ph jb[ph ji[yu jn[il
進來容易出去難	jb[ez ld[hm rs[xr yi[ob iu[ck qu[ts nj[yv
浸溼的木頭	jb[dx ui[do de[bb mu[ub tz[dd
盡是老調	jb[ud ui[op lc[tb dn[yk
進退兩難	jb[ez tv[gz ll[hk nj[yv
盡往上看	jb[ud wh[rd uh[bh kj[fm
緊往上爬	jb[uy wh[rd uh[bh pa[pb
儘想好事	jb[ud xl[ax hc[nz ui[hk
緊相連	jb[uy xl[am lm[iz
緊著褲子數日月	jb[uy ve[ym ku[yg zi[lh uu[mw ri[wh yt[ke
盡捉弄人	jb[ud vo[fz ns[wc rf[pd
經不起風雨	jk[ss bu[eu qi[zk fg[ji yu[hk
經不起推敲	jk[ss bu[eu qi[zk tv[fv qn[wb
經得起打擊	jk[ss de[ro qi[zk da[fd ji[fk
驚弓之鳥	jk[xw gs[kv vi[dv nn[nh
京戲走臺步	jk[wk xi[yg zz[tv td[sk bu[vu
驚蟄後的蜈蚣	jk[xw ve[fi hz[pk de[bb wu[ik gs[ib
鏡子裡親嘴	jk[jl zi[lh li[ot qb[la zv[kv
就當自己長得白	jq[wy dh[xx zi[pm ji[kv vh[ph de[ro bd[po
酒鬼掉進酒池裡	jq[dy gv[be dn[fb jb[ez jq[dy ii[dy li[ot
酒鬼喝汽水	jq[dy gv[be he[ko qi[dq uv[uu
揪著馬尾巴賽跑	jq[fh ve[ym ma[vv ww[um ba[ku sd[gb pc[zb
就著豬肉吃油條	jq[wy ve[ym vu[qt rz[kr ii[kr yz[dy tn[wa
酒盅裡拌黃瓜	jq[dy vs[vm li[ot bj[fb hl[gy gx[ps
決不回頭	jt[dv bu[eu hv[wk tz[dd
絕戶頭得個改家子	jt[sd hu[du tz[dd de[ro ge[ru gd[kw jx[gu zi[lh
決了堤的水	jt[dv le[vu di[to de[bb uv[uu
撅著屁股看天	jt[fi ve[ym pi[ub gu[oj kj[fm tm[hd
開弓的箭	kd[hc gs[kv de[bb jm[vb
開卦府的包公	kd[hc gx[tb fu[gr de[bb bc[bk gs[bs
開棺驗屍	kd[hc gr[ag yj[mr ui[kp
開花的白菜	kd[hc hx[cr de[bb bd[po cd[ca
開花期遇暴雨	kd[hc hx[cr qi[qo yu[oz bc[og yu[hk
開會差半點	kd[hc hv[re ia[yg bj[bf dm[bd
開會請了假	kd[hc hv[re qk[yf le[vu jx[rk
開局擺開攔河車	kd[hc ju[uv bd[fs kd[hc lj[fb he[dk ie[qu
開局的兵卒	kd[hc ju[uv de[bb bk[qb zu[wr
開了閘的河水	kd[hc le[vu va[mo de[bb he[dk uv[uu
開溜	kd[hc lq[dp
開水裡撈肥皂	kd[hc uv[uu li[ot lc[fc fw[ob zc[bq
開水泡黃豆	kd[hc uv[uu pc[db hl[gy dz[hk
開水潑老鼠	kd[hc uv[uu po[dv lc[tb uu[jv
開水碗上的蔥花	kd[hc uv[uu wj[eg uh[bh de[bb cs[cb hx[cr
開水洗臉	kd[hc uv[uu xi[dn lm[or
開水煮白玉	kd[hc uv[uu vu[td bd[po yu[wd
開洋葷	kd[hc yh[dy hy[ci
開著電扇聊天	kd[hc ve[ym dm[ov uj[hx ln[ep tm[hd
開著收音機聽戲	kd[hc ve[ym uz[vw yb[lo ji[aj tk[kj xi[yg
開著拖拉機攆兔子	kd[hc ve[ym to[fr la[fl ji[aj nm[fe tu[dk zi[lh
砍不倒大樹	kj[ed bu[eu dc[rh da[hr uu[ay
看不上眼	kj[fm bu[eu uh[bh yj[mg
看錯人了	kj[fm co[jg rf[pd le[vu
砍倒大樹捉鳥	kj[ed dc[rh da[hr uu[ay vo[fz nn[nh
砍倒的柳樹	kj[ed dc[rh de[bb lq[ap uu[ay
看多少算多少	kj[fm do[xx uc[xp sr[vm do[xx uc[xp
看家拳頭	kj[fm jx[gu qr[bf tz[dd
看見和尚喊姨夫	kj[fm jm[ke he[hk uh[xk hj[kw yi[nh fu[er
看見尼姑喊嫂子	kj[fm jm[ke ni[ub gu[ng hj[kw sc[nj zi[lh
看見外公叫爺爺	kj[fm jm[ke wd[xb gs[bs jn[kv ye[be ye[be
看門的神仙	kj[fm mf[du de[bb uf[uo xm[ru
看你咋吹	kj[fm ni[rd za[kv iv[kd
看破戲塵	kj[fm po[ep xi[yg if[xt
看人挑擔	kj[fm rf[pd tn[fv dj[fo
砍樹吃桔子	kj[ed uu[ay ii[kr ju[au zi[lh
看戲挑媳婦	kj[fm xi[yg tn[fv xi[nz fu[nx
看羊的狗	kj[fm yh[bs de[bb gz[qb
看衣裳行事	kj[fm yi[wy uh[xy xk[rh ui[hk
看著天說話	kj[fm ve[ym tm[hd uo[yb hx[yq
靠不住	kc[nf bu[eu vu[rd
刻薄	ke[wd bo[cd
嗑瓜子吃核桃	ke[kt gx[ps zi[lh ii[kr he[aw tc[av
嗑瓜子瞌出個臭蟲	ke[kt gx[ps zi[lh ke[mt iu[ck ge[ru iz[zq is[ks
嗑瓜子嗑出蝦米來	ke[kt gx[ps zi[lh ke[kt iu[ck xx[ix mi[ba ld[hm
客氣碰著老實	ke[gw qi[rh pg[eb ve[ym lc[tb ui[gd
瞌睡送個枕頭	ke[mt uv[mi ss[bz ge[ru vf[ag tz[dd
磕完頭撒供	ke[et wj[ge tz[dd sa[fg gs[rg
肯定	kf[vo dk[gp
肯定了	kf[vo dk[gp le[vu
啃著魚骨聊天	kf[kv ve[ym yu[dt gu[ko ln[ep tm[hd
坑到家了	kg[tw dc[hd jx[gu le[vu
坑人不淺	kg[tw rf[pd bu[eu qm[dj
空袋了	ks[xg dd[ry le[vu
空肚子打飽隔	ks[xg du[ot zi[lh da[fd bc[ub ge[eh
空費芯	ks[xg fw[fb xb[cx
空架子	ks[xg jx[la zi[lh
空勞神	ks[xg lc[cl uf[uo
空手進衙門	ks[xg uz[su jb[ez ya[rw mf[du
空手跑進中藥店	ks[xg uz[su pc[zb jb[ez vs[ku yc[cs dm[gb
空手抓白魚	ks[xg uz[su vx[fp bd[po yu[dt
空想	ks[xg xl[ax
空心羅漢	ks[xg xb[dv lo[sx hj[dy
口蜜腹劍	kz[uv mi[gi fu[or jm[rd
窟窿套窟窿	ku[xu ls[xe tc[di ku[xu ls[xe
苦苗苗	ku[cg mn[ct mn[ct
苦生苦長	ku[cg ug[pf ku[cg ih[ph
苦水裡泡大的	ku[cg uv[uu li[ot pc[db da[hr de[bb
苦也	ku[cg ye[vu
苦竹子根頭出苦筍	ku[cg vu[rr zi[lh gf[ag tz[dd iu[ck ku[cg sy[vx
筷子搭橋	kk[vx zi[lh da[fc qn[ap
筷子頂豆腐	kk[vx zi[lh dk[dy dz[hk fu[gk
筷子裡拔旗杆	kk[vx zi[lh li[ot ba[fu qi[fr gj[ag
筐裡選瓜	kl[vk li[ot xr[nz gx[ps
葵花籽裡拌鹽水	kv[cd hx[cr zi[mz li[ot bj[fb yj[tm uv[uu
拉肚子吃瀉藥	la[fl du[ot zi[lh ii[kr xp[dg yc[cs
垃圾堆裡的破鞋	la[tl ji[tj dv[tv li[ot de[bb po[ep xp[gt
辣椒炒豆腐	la[lh jn[au ic[hx dz[hk fu[gk
蠟臺上無油	la[ig td[sk uh[bh wu[ee yz[dy
臘鴨子煮到鍋裡頭	la[og ya[on zi[lh vu[td dc[hd go[jk li[ot tz[dd
臘月裡扇扇子	la[og yt[ke li[ot uj[hx uj[hx zi[lh
拉著手走路	la[fl ve[ym uz[su zz[tv lu[zw
蠟燭的脾氣	la[ig vu[hi de[bb pi[ob qi[rh
癩蛤蟆穿大紅袍	ld[bh ha[ir ma[ic ir[xy da[hr hs[sg pc[yb
癩蛤蟆打吹欠	ld[bh ha[ir ma[ic da[fd iv[kd qm[dr
賴泥下窯	ld[hd ni[du xx[hb yc[xw
來頭不小	ld[hm tz[dd bu[eu xn[ub
癩子的腦袋	ld[bh zi[lh de[bb nc[ow dd[ry
爛板橋上的龍王	lj[hb bj[ap qn[ap uh[bh de[bb ls[yp wh[su
懶廚子做席	lj[xh iu[id zi[lh zo[rg xi[gn
濫竿充數	lj[du gj[vg is[we uu[mw
爛膏藥貼在好肉上	lj[hb gc[wk yc[cs tp[bb zd[ut hc[nz rz[kr uh[bh
懶驢上磨	lj[xh lv[mh uh[bh mo[ge
爛泥裡打樁子	lj[hb ni[du li[ot da[fd vl[ag zi[lh
爛泥菩薩	lj[hb ni[du pu[cl sa[ce
爛泥菩薩洗臉	lj[hb ni[du pu[cl sa[ce xi[dn lm[or
爛泥土下窯	lj[hb ni[du tu[uh xx[hb yc[xw
懶婆娘的裹腳布	lj[xh po[dn nl[nl de[bb go[wo jn[ot bu[uj
爛魚開了膛	lj[hb yu[dt kd[hc le[vu th[ox
狼吃狼	lh[ql ii[kr lh[ql
榔頭對錘子	lh[al tz[dd dv[yc iv[ji zi[lh
狼惜豬娃	lh[ql xi[xg vu[qt wa[nt
浪中行船	lh[dl vs[ku hh[rh ir[vj
浪子回頭	lh[dl zi[lh hv[wk tz[dd
老等	lc[tb dg[vt
老調子	lc[tb dn[yk zi[lh
勞而無功	lc[cl er[ek wu[ee gs[gl
牢房裡賭博	lc[gn fh[hf li[ot du[bt bo[uf
老肥豬上屠場	lc[tb fw[ob vu[qt uh[bh tu[ut ih[tv
老墳頭裡的屍骨	lc[tb ff[tw tz[dd li[ot de[bb ui[kp gu[ko
老鴰叮蚌殼	lc[tb gx[qn dk[kd bh[if ke[ug
老光棍	lc[tb gl[xe gy[ao
老海瑞上金殿	lc[tb hd[dr rv[wu uh[bh jb[rw dm[uj
老猴爬旗杆	lc[tb hz[qr pa[pb qi[fr gj[ag
老虎的兒子	lc[tb hu[hj de[bb er[pv zi[lh
老虎和豬生的	lc[tb hu[hj he[hk vu[qt ug[pf de[bb
老虎皮兔子膽	lc[tb hu[hj pi[vp tu[dk zi[lh dj[oo
老糊塗	lc[tb hu[mg tu[dr
老奸巨猾	lc[tb jm[ng ju[kk hx[qg
老來俏	lc[tb ld[hm qn[rx
老驢打滾	lc[tb lv[mh da[fd gy[dl
老母豬爬樓梯	lc[tb mu[vv vu[qt pa[pb lz[am ti[ab
老母豬上山	lc[tb mu[vv vu[qt uh[bh uj[uk
老牛拉破車	lc[tb nq[pf la[fl po[ep ie[qu
老牛鑽狗洞	lc[tb nq[pf zr[jb gz[qb ds[dk
老實人	lc[tb ui[gd rf[pd
老鼠扒屎盆	lc[tb uu[jv ba[fb ui[um pf[fm
老鼠管倉	lc[tb uu[jv gr[vg ch[re
老鼠爬香爐	lc[tb uu[jv pa[pb xl[ho lu[hh
老鼠碰見貓	lc[tb uu[jv pg[eb jm[ke mc[qc
老鼠睡貓窩	lc[tb uu[jv uv[mi mc[qc wo[xk
老鼠偷秤砣	lc[tb uu[jv tz[rr ig[hp to[eg
老鼠咬屁股	lc[tb uu[jv yc[kl pi[ub gu[oj
老水牛拉馬車	lc[tb uv[uu nq[pf la[fl ma[vv ie[qu
老太婆過年	lc[tb td[dd po[dn go[cz nm[rn
老太婆啃雞筋	lc[tb td[dd po[dn kf[kv ji[yn jb[vo
老太太扎鞋底	lc[tb td[dd td[dd va[fv xp[gt di[gu
老太爺看告示	lc[tb td[dd ye[be kj[fm gc[nk ui[ex
老鷹吃雞毛	lc[tb yk[gn ii[kr ji[yn mc[sv
老主意	lc[tb vu[dw yi[lx
老子納妾兒姘居	lc[tb zi[lh na[sk qp[ln er[pv pb[nb ju[ug
老子偷豬兒偷牛	lc[tb zi[lh tz[rr vu[qt er[pv tz[rr nq[pf
老子坐班房	lc[tb zi[lh zo[rr bj[wd fh[hf
樂顛了餡兒	le[px dm[uy le[vu xm[ud er[pv
冷不防	lg[dr bu[eu fh[ef
冷落	lg[dr lo[cd
立不起來	li[lh bu[eu qi[zk ld[hm
立場不穩	li[lh ih[tv bu[eu wf[hd
理虧	li[wo kv[hk
裡外發燒	li[ot wd[xb fa[vy uc[hq
戀戀不捨	lm[yx lm[yx bu[eu ue[rg
臉上無光	lm[or uh[bh wu[ee gl[xe
兩人一份	ll[hk rf[pd yi[hh ff[rf
兩想	ll[hk xl[ax
兩袖清風	ll[hk xq[yy qk[df fg[ji
兩眼墨黑	ll[hk yj[mg mo[ht hw[sd
亮月下耍大刀	ll[wj yt[ke xx[hb ux[en da[hr dc[vp
料不到	ln[md bu[eu dc[hd
零比零	lk[yr bi[bb lk[yr
靈丹妙藥	lk[xh dj[kw mn[nx yc[cs
另搞一套	lk[kl gc[fw yi[hh tc[di
另有所圖	lk[kl yz[uo so[pj tu[ww
溜了	lq[dp le[vu
留神	lq[pt uf[uo
溜鬚不要命	lq[dp xu[py bu[eu yc[xn mk[rh
溜鬚拍馬	lq[dp xu[py pd[fb ma[vv
留一手	lq[pt yi[hh uz[su
露底	lz[yz di[gu
路不寬	lu[zw bu[eu kr[gc
露骨	lu[yz gu[ko
露了蹄半山崖的觀音	lu[yz le[vu ti[zl bj[bf uj[uk ya[ui de[bb gr[yj yb[lo
露頭角	lu[yz tz[dd jn[do
滷煮寒鴨子	lu[bw vu[td hj[gd ya[on zi[lh
亂蹦亂跳	lr[qv bg[zu lr[qv tn[zv
亂聯繫	lr[qv lm[eb xi[py
亂牽扯	lr[qv qm[dg ie[fv
亂認親	lr[qv rf[yr qb[la
略使小技	lt[tw ui[rh xn[ub ji[fu
略顯其能	lt[tw xm[oy qi[cb ng[sb
馬鞭打牛	ma[vv bm[gr da[fd nq[pf
馬槽邊上的蒼蠅	ma[vv cc[ah bm[lz uh[bh de[bb ch[cr yk[ik
馬車過沼澤地	ma[vv ie[qu go[cz vc[dd ze[dy di[ty
麻袋裡裝麥秸	ma[ga dd[ry li[ot vl[dy md[fw jp[hu
麻袋做龍袍	ma[ga dd[ry zo[rg ls[yp pc[yb
麻稈搭橋	ma[ga gj[hg da[fc qn[ap
麻稈做術腿	ma[ga gj[hg zo[rg uu[ad tv[og
麻姑娘搽雪花膏	ma[ga gu[ng nl[nl ia[fc xt[yx hx[cr gc[wk
螞蟥叭在牛尾上	ma[im hl[ig ba[kb zd[ut nq[pf ww[um uh[bh
麻秸抵門	ma[ga jp[hu di[fu mf[du
馬臉比母豬頭	ma[vv lm[or bi[bb mu[vv vu[qt tz[dd
麻臉姑娘掉井裡	ma[ga lm[or gu[ng nl[nl dn[fb jk[ep li[ot
麻臉媳婦拜見上嘴婆	ma[ga lm[or xi[nz fu[nx bd[fh jm[ke uh[bh zv[kv po[dn
螞蛉長毛	ma[im lk[ir ih[ph mc[sv
麻柳樹解板子	ma[ga lq[ap uu[ay jp[dd bj[ap zi[lh
馬路上跑火車	ma[vv lu[zw uh[bh pc[zb ho[dp ie[qu
馬路新聞	ma[vv lu[zw xb[lj wf[me
麻婆打扮	ma[ga po[dn da[fd bj[ff
麻婆照鏡子	ma[ga po[dn vc[od jk[jl zi[lh
麻雀搬家	ma[ga qt[xv bj[fv jx[gu
麻雀吃桑葚	ma[ga qt[xv ii[kr sh[ya uf[cq
麻雀的肚腹	ma[ga qt[xv de[bb du[ot fu[or
麻雀掉到洞庭湖裡	ma[ga qt[xv dn[fb dc[hd ds[dk tk[gq hu[dg li[ot
麻雀鬥雞	ma[ga qt[xv dz[du ji[yn
麻雀嫁女	ma[ga qt[xv jx[ng nv[vp
馬群裡的駱駝	ma[vv qy[xy li[ot de[bb lo[mw to[mg
馬勺當鑼打	ma[vv uc[bd dh[xx lo[js da[fd
麻蛇鑽刺棵	ma[ga ue[ig zr[jb ci[cd ke[ao
麻繩穿針	ma[ga ug[sk ir[xy vf[ju
麻繩打毛衣	ma[ga ug[sk da[fd mc[sv yi[wy
馬食槽不許驢插嘴	ma[vv ui[rl cc[ah bu[eu xu[yw lv[mh ia[fq zv[kv
馬桶裡倒香水	ma[vv ts[as li[ot dc[rh xl[ho uv[uu
馬桶上插花	ma[vv ts[as uh[bh ia[fq hx[cr
碼頭工人扛麻包	ma[em tz[dd gs[hu rf[pd kh[fg ma[ga bc[bk
馬王爺	ma[vv wh[su ye[be
馬尾穿蘿蔔	ma[vv ww[um ir[xy lo[cs bo[ud
馬尾拴雞蛋	ma[vv ww[um ur[fr ji[yn dj[pi
麻線搓繩	ma[ga xm[sj co[fy ug[sk
螞蟻打食	ma[im yi[id da[fd ui[rl
麻油炒豆腐	ma[ga yz[dy ic[hx dz[hk fu[gk
螞蚱配蝗蟲	ma[im va[iv pw[yk hl[ib is[ks
碼子前面添零	ma[em zi[lh qm[bo mm[ew tm[dt lk[yr
麻子敲門	ma[ga zi[lh qn[wb mf[du
麻子跳傘	ma[ga zi[lh tn[zv sj[rb
買車不要騾子	md[vd ie[qu bu[eu yc[xn lo[mt zi[lh
賣棺材的聞人重病	md[ud gr[ag cd[ac de[bb wf[me rf[pd vs[ph bk[bh
賣棺材的咬牙	md[ud gr[ag cd[ac de[bb yc[kl ya[hv
買回彩電帶回發票	md[vd hv[wk cd[ap dm[ov dd[cj hv[wk fa[vy pn[xe
麥秸燒火	md[fw jp[hu uc[hq ho[dp
買賣不大架子大	md[vd md[ud bu[eu da[hr jx[la zi[lh da[hr
麥芒戮到眼睛裡	md[fw mh[cw lu[xg dc[hd yj[mg jk[mf li[ot
買帽子當鞋穿	md[vd mc[jo zi[lh dh[xx xp[gt ir[xy
賣弄風流	md[ud ns[wc fg[ji lq[dw
麥田裡的韭菜	md[fw tm[wu li[ot de[bb jq[fh cd[ca
麥田裡撒豌豆	md[fw tm[wu li[ot sa[fg wj[dg dz[hk
買眼藥進了石灰店	md[vd yj[mg yc[cs jb[ez le[vu ui[ek hv[uh dm[gb
蠻不講理	mj[yi bu[eu jl[ye li[wo
滿肚子熊點子	mj[dc du[ot zi[lh xs[sd dm[bd zi[lh
慢工出細活	mj[xo gs[hu iu[ck xi[st ho[dq
慢慢挪	mj[xo mj[xo no[fv
慢慢騰騰	mj[xo mj[xo tg[ob tg[ob
滿嘴噴糞	mj[dc zv[kv pf[ku ff[mg
忙上加忙	mh[xw uh[bh jx[lk mh[xw
冒充打獵人	mc[om is[we da[fd lp[qg rf[pd
冒充富態	mc[om is[we fu[gh td[dx
冒貨	mc[om ho[rb
沒安好心	mw[dj an[gn hc[nz xb[dv
沒出息	mw[dj iu[ck xi[zx
沒得用	mw[dj de[ro ys[ou
沒肚量	mw[dj du[ot ll[oh
沒多大勁	mw[dj do[xx da[hr jb[sl
沒方子	mw[dj fh[dw zi[lh
沒福	mw[dj fu[uh
沒高的	mw[dj gc[wk de[bb
沒骨氣	mw[dj gu[ko qi[rh
沒幾步跑頭	mw[dj ji[pv bu[vu pc[zb tz[dd
沒見過大場面	mw[dj jm[ke go[cz da[hr ih[tv mm[ew
沒進步	mw[dj jb[ez bu[vu
沒臉回江東	mw[dj lm[or hv[wk jl[dg ds[qx
沒人領情	mw[dj rf[pd lk[ry qk[xf
沒人要的貨	mw[dj rf[pd yc[xn de[bb ho[rb
美上天了	mw[bw uh[bh tm[hd le[vu
沒什麼兩樣	mw[dj uf[ru me[ps ll[hk yh[ay
沒水吃渴死人	mw[dj uv[uu ii[kr ke[do si[hx rf[pd
沒一點情味	mw[dj yi[hh dm[bd qk[xf ww[kh
沒影子	mw[dj yk[op zi[lh
沒用處	mw[dj ys[ou iu[wb
沒有出路	mw[dj yz[uo iu[ck lu[zw
沒有迴音	mw[dj yz[uo hv[wk yb[lo
沒有幾句	mw[dj yz[uo ji[pv ju[bk
沒有看出你來	mw[dj yz[uo kj[fm iu[ck ni[rd ld[hm
沒有熱乎勁	mw[dj yz[uo re[fd hu[pb jb[sl
沒有日子了	mw[dj yz[uo ri[wh zi[lh le[vu
沒有一塊好的	mw[dj yz[uo yi[hh kk[tv hc[nz de[bb
沒有用	mw[dj yz[uo ys[ou
沒緣	mw[dj yr[sv
沒長勁	mw[dj vh[ph jb[sl
沒指望	mw[dj vi[fb wh[ww
沒咒念	mw[dj vz[kj nm[rx
沒準兒	mw[dj vy[dv er[pv
門當戶對	mf[du dh[xx hu[du dv[yc
悶起來了	mf[mx qi[zk ld[hm le[vu
懵門了	mg[xc mf[du le[vu
迷迷糊糊	mi[mz mi[mz hu[mg hu[mg
彌天大謊	mi[gd tm[hd da[hr hl[yc
面面有用	mm[ew mm[ew yz[uo ys[ou
勉強不得	mm[dl ql[gk bu[eu de[ro
面生	mm[ew ug[pf
明打明	mk[oo da[fd mk[oo
命根子	mk[rh gf[ag zi[lh
明砍	mk[oo kj[ed
明看不成器丟又捨不得	mk[oo kj[fm bu[eu ig[wv qi[kq dq[pt yz[vd ue[rg bu[eu de[ro
摸不著底	mo[fc bu[eu vc[ym di[gu
摸出來的	mo[fc iu[ck ld[hm de[bb
莫名其妙	mo[co mk[xk qi[cb mn[nx
莫想	mo[co xl[ax
莫須有	mo[co xu[py yz[uo
木匠鋪里拉大鋸	mu[ub jl[kj pu[jf li[ot la[fl da[hr ju[ju
目空一切	mu[we ks[xg yi[hh qp[qd
木偶流眼淚	mu[ub ou[ro lq[dw yj[mg lw[dm
牧人不刮鬍子	mu[nw rf[pd bu[eu gx[qd hu[go zi[lh
木頭人過河	mu[ub tz[dd rf[pd go[cz he[dk
拿菜刀哄孩子	na[rf cd[ca dc[vp hs[kg hd[zw zi[lh
拿根麵條去上吊	na[rf gf[ag mm[ew tn[wa qu[ts uh[bh dn[kj
哪還用言	na[kv hd[bz ys[ou yj[we
拿腦袋撞牆	na[rf nc[ow dd[ry vl[fl ql[tt
拿烏龜當鍋蓋	na[rf wu[bv gv[do dh[xx go[jk gd[bm
哪一壺不開單提哪一壺	na[kv yi[hh hu[uy bu[eu kd[hc dj[bo ti[fo na[kv yi[hh hu[uy
拿著車票進戲館子	na[rf ve[ym ie[qu pn[xe jb[ez xi[yg gr[ug zi[lh
拿著碾盆打月亮	na[rf ve[ym nm[eu pf[fm da[fd yt[ke ll[wj
拿著鐵鍬當鍋使	na[rf ve[ym tp[jp qn[jh dh[xx go[jk ui[rh
奈何不得	nd[de he[rk bu[eu de[ro
耐滑頭	nd[ec hx[dg tz[dd
難產	nj[yv ij[lp
難纏	nj[yv ij[sg
難撐	nj[yv ig[fx
難得	nj[yv de[ro
難得一回	nj[yv de[ro yi[hh hv[wk
難分色	nj[yv ff[bd se[db
難逢	nj[yv fg[wz
難過	nj[yv go[cz
難回頭	nj[yv hv[wk tz[dd
難交	nj[yv jn[li
難嚼難嚥	nj[yv jn[ka nj[yv yj[kw
難看	nj[yv kj[fm
難劈	nj[yv pi[ud
難通過	nj[yv ts[sz go[cz
難脫身	nj[yv to[ob uf[pu
難下手	nj[yv xx[hb uz[su
難養活	nj[yv yh[yp ho[dq
鬧個不停	nc[mw ge[ru bu[eu tk[rw
鬧了個大窩脖	nc[mw le[vu ge[ru da[hr wo[xk bo[ou
腦門上開口	nc[ow mf[du uh[bh kd[hc kz[uv
腦門上長瘤	nc[ow mf[du uh[bh vh[ph lq[bp
惱一個好一個	nc[xw yi[hh ge[ru hc[nz yi[hh ge[ru
鬧鐘打哈哈	nc[mw vs[jv da[fd ha[kr ha[kr
哪吒戰小龍	ne[kv va[kp vj[bg xn[ub ls[yp
內行	nw[kr hh[rh
內外勾結	nw[kr wd[xb gz[bs jp[su
泥巴捏的小人	ni[du ba[ku np[fo de[bb xn[ub rf[pd
你吃雞鴨肉我啃窩窩頭	ni[rd ii[kr ji[yn ya[on rz[kr wo[pf kf[kv wo[xk wo[xk tz[dd
你東我西	ni[rd ds[qx wo[pf xi[hk
逆風點火	ni[nz fg[ji dm[bd ho[dp
泥佛爺的眼珠兒	ni[du fo[rf ye[be de[bb yj[mg vu[wp er[pv
尼姑生孩子	ni[ub gu[ng ug[pf hd[zw zi[lh
你來我去	ni[rd ld[hm wo[pf qu[ts
你賣門神我賣鬼	ni[rd md[ud mf[du uf[uo wo[pf md[ud gv[be
泥菩薩洗臉	ni[du pu[cl sa[ce xi[dn lm[or
你去南極我去北極	ni[rd qu[ts nj[uk ji[aj wo[pf qu[ts bw[ub ji[aj
泥人經不起雨打	ni[du rf[pd jk[ss bu[eu qi[zk yu[hk da[fd
泥神笑菩薩	ni[du uf[uo xn[vp pu[cl sa[ce
逆水行船	ni[nz uv[uu xk[rh ir[vj
逆水行舟	ni[nz uv[uu xk[rh vz[pk
你算哪一路	ni[rd sr[vm na[kv yi[hh lu[zw
膩透了	ni[oq tz[hz le[vu
你行我也行	ni[rd xk[rh wo[pf ye[vu xk[rh
你也好不了多少	ni[rd ye[vu hc[nz bu[eu ln[vu do[xx uc[xp
你有秤桿我有砣	ni[rd yz[uo ig[hp gj[ag wo[pf yz[uo to[eg
泥蒸的饅頭	ni[du vg[cl de[bb mj[uo tz[dd
你做生意我教書	ni[rd zo[rg ug[pf yi[lx wo[pf jn[tw uu[vv
年年都一樣	nm[rn nm[rn dz[te yi[hh yh[ay
碾盤對碾盤	nm[eu pj[vm dv[yc nm[eu pj[vm
拈輕怕重	nm[fb qk[is pa[xb vs[ph
唸完了經打和尚	nm[rx wj[ge le[vu jk[ss da[fd he[hk uh[xk
攆走孤狸住上狼	nm[fe zz[tv gu[zp li[qo vu[rd uh[bh lh[ql
鳥兒搬家	nn[nh er[pv bj[fv jx[gu
鳥槍換炮	nn[nh ql[ar hr[fd pc[hb
捏死手中鳥	np[fo si[hx uz[su vs[ku nn[nh
捏著鼻尖兒做夢	np[fo ve[ym bi[zt jm[xd er[pv zo[rg mg[ax
寧折不彎	nk[gd ve[fj bu[eu wj[yg
牛背上翻踉頭	nq[pf bw[bo uh[bh fj[px ll[zl tz[dd
牛犢子叫街	nq[pf du[nu zi[lh jn[kv jp[rt
牛犢子上套	nq[pf du[nu zi[lh uh[bh tc[di
牛皮鼓溼水	nq[pf pi[vp gu[uu ui[do uv[uu
牛牽鼻子馬抓鬃	nq[pf qm[dg bi[zt zi[lh ma[vv vx[fp zs[ig
牛頭不對馬嘴	nq[pf tz[dd bu[eu dv[yc ma[vv zv[kv
牛羊的肚腹	nq[pf yh[bs de[bb du[ot fu[or
弄不多柴禾	ns[wc bu[eu do[xx id[va he[pa
暖水瓶爆烈	nr[oa uv[uu pk[bw bc[ho lp[hd
女孩子打架	nv[vp hd[zw zi[lh da[fd jx[la
女人的手腕	nv[vp rf[pd de[bb uz[su wj[og
女婿認不得丈人	nv[vp xu[np rf[yr bu[eu de[ro vh[hi rf[pd
藕炒豆芽	ou[cl ic[hx dz[hk ya[cy
漚爛的花生	ou[dk lj[hb de[bb hx[cr ug[pf
偶像面前磕頭	ou[ro xl[rd mm[ew qm[bo ke[et tz[dd
怕是真的	pa[xb ui[op vf[uj de[bb
怕死碰見鬼子兵	pa[xb si[hx pg[eb jm[ke gv[be zi[lh bk[qb
趴在磨子上睡覺	pa[zb zd[ut mo[ge zi[lh uh[bh uv[mi jn[xj
拍照片不上卷	pd[fb vc[od pm[pu bu[eu uh[bh jr[be
判官拍照	pj[bd gr[gu pd[fb vc[od
判官敲門	pj[bd gr[gu qn[wb mf[du
判官玩魔術	pj[bd gr[gu wj[we mo[gg uu[ad
潘仁美掛帥	pj[dp rf[re mw[bw gx[ft uk[uj
盼月亮從西出	pj[mf yt[ke ll[wj cs[rr xi[hk iu[ck
盤子裡生豆芽	pj[vm zi[lh li[ot ug[pf dz[hk ya[cy
胖大海掉進黃連水	ph[ob da[hr hd[dr dn[fb jb[ez hl[gy lm[iz uv[uu
螃蟹過門檻	ph[il xp[di go[cz mf[du kj[au
螃蟹爬到路上	ph[il xp[di pa[pb dc[hd lu[zw uh[bh
螃蟹上樹	ph[il xp[di uh[bh uu[ay
胖子排橫隊	ph[ob zi[lh pd[ff hg[ag dv[er
跑不了	pc[zb bu[eu ln[vu
炮打林中鳥	pc[hb da[fd lb[aa vs[ku nn[nh
跑得快	pc[zb de[ro kk[xv
跑馬吃烤鴨	pc[zb ma[vv ii[kr kc[ht ya[on
跑馬使絆子	pc[zb ma[vv ui[rh bj[sb zi[lh
配得起你	pw[yk de[ro qi[zk ni[rd
噴雲吐霧	pf[ku yy[es tu[kt wu[yw
碰了一鼻灰	pg[eb le[vu yi[hh bi[zt hv[uh
捧著泥鰍玩	pg[fs ve[ym ni[du qq[yh wj[we
碰著啥咬啥	pg[eb ve[ym ua[kr yc[kl ua[kr
屁股上掃帚	pi[ub gu[oj uh[bh sc[fx vz[xj
屁股上捅一刀	pi[ub gu[oj uh[bh ts[fs yi[hh dc[vp
披虎皮上山	pi[fp hu[hj pi[vp uh[bh uj[uk
皮匠不帶錐子	pi[vp jl[kj bu[eu dd[cj vv[jv zi[lh
皮褲套棉褲	pi[vp ku[yg tc[di mm[ab ku[yg
皮老心不老	pi[vp lc[tb xb[dv bu[eu lc[tb
琵琶斷了弦	pi[wb pa[wb dr[mj le[vu xm[gw
脾氣不一樣	pi[ob qi[rh bu[eu yi[hh yh[ay
脾氣相投	pi[ob qi[rh xl[am tz[fj
皮球上戳眼眼	pi[vp qq[wh uh[bh io[xg yj[mg yj[mg
皮球上磨刀	pi[vp qq[wh uh[bh mo[ge dc[vp
砒霜拌大蔥	pi[eb ul[ya bj[fb da[hr cs[cb
皮鞋打蠟	pi[vp xp[gt da[fd la[ig
便宜買回的處理品	pm[rh yi[gq md[vd hv[wk de[bb iu[wb li[wo pb[kk
騙子碰到騙子	pm[mh zi[lh pg[eb dc[hd pm[mh zi[lh
貧血病人	pb[fb xt[pm bk[bh rf[pd
平地搭梯子	pk[hb di[ty da[fc ti[ab zi[lh
瓶子裡的蒼蠅	pk[bw zi[lh li[ot de[bb ch[cr yk[ik
破罐子破摔	po[ep gr[wc zi[lh po[ep uk[fw
破棉襖套綢衫	po[ep mm[ab ao[yp tc[di iz[sk uj[yp
破廟裡的菩薩	po[ep mn[gy li[ot de[bb pu[cl sa[ce
破土的春筍	po[ep tu[uh de[bb iy[so sy[vx
破襪子補帽沿	po[ep wa[yh zi[lh bu[yb mc[jo yj[dj
破網打魚	po[ep wh[ki da[fd yu[dt
婆媳吵架兒子勸	po[dn xi[nz ic[kx jx[la er[pv zi[lh qr[yl
破鞋幫	po[ep xp[gt bh[fj
破蒸籠蒸饅頭	po[ep vg[cl ls[vy vg[cl mj[uo tz[dd
剖腹獻肝膽	pz[ld fu[or xm[uq gj[og dj[oo
剖魚得珠	pz[ld yu[dt de[ro vu[wp
葡萄汁充花露水	pu[cb tc[cb vi[du is[we hx[cr lu[yz uv[uu
撲騰不開	pu[fb tg[ob bu[eu kd[hc
七八月的南瓜	qi[hv ba[pd yt[ke de[bb nj[uk gx[ps
氣不打一處來	qi[rh bu[eu da[fd yi[hh iu[wb ld[hm
七尺漢子六尺門	qi[hv ii[ud hj[dy zi[lh lq[wb ii[ud mf[du
氣得嘣八丈高	qi[rh de[ro bg[ku ba[pd vh[hi gc[wk
七顛八倒	qi[hv dm[uy ba[pd dc[rh
乞丐過日子	qi[rv gd[xv go[cz ri[wh zi[lh
乞丐跳舞	qi[rv gd[xv tn[zv wu[rx
漆黑一團	qi[da hw[sd yi[hh tr[wc
齊桓公用管仲	qi[wp hr[ah gs[bs ys[ou gr[vg vs[rv
氣急敗壞	qi[rh ji[dx bd[bw hk[tb
起了心	qi[zk le[vu xb[dv
騎驢看唱本	qi[md lv[mh kj[fm ih[ko bf[ah
騎驢望著坐轎的	qi[md lv[mh wh[ww ve[ym zo[rr jn[ip de[bb
騎馬上天山	qi[md ma[vv uh[bh tm[hd uj[uk
騎馬時間少擦鐙時間多	qi[md ma[vv ui[oc jm[mo uc[xp ca[fg dg[jd ui[oc jm[mo do[xx
騎牛找牛	qi[md nq[pf vc[fg nq[pf
棋盤裡的老將	qi[aq pj[vm li[ot de[bb lc[tb jl[dx
砌牆的磚頭	qi[eq ql[tt de[bb vr[ee tz[dd
七石缸裡撈芝麻	qi[hv ui[ek gh[wg li[ot lc[fc vi[cv ma[ga
七手八腳	qi[hv uz[su ba[pd jn[ot
齊頭並迸	qi[wp tz[dd bk[bk bg[bz
七仙女嫁董永	qi[hv xm[ru nv[vp jx[ng ds[cp ys[dv
騎著駱駝吃包子	qi[md ve[ym lo[mw to[mg ii[kr bc[bk zi[lh
起重機吊雞毛	qi[zk vs[ph ji[aj dn[kj ji[yn mc[sv
錢串子腦袋	qm[jj ir[kk zi[lh nc[ow dd[ry
千斤頂幹活	qm[pu jb[ph dk[dy gj[hu ho[dq
千里送客	qm[pu li[ot ss[bz ke[gw
千里姻緣一線牽	qm[pu li[ot yb[nw yr[sv yi[hh xm[sj qm[dg
千年的大樹	qm[pu nm[rn de[bb da[hr uu[ay
千年的銅鐘	qm[pu nm[rn de[bb ts[jk vs[jv
淺灘上放木排	qm[dj tj[dy uh[bh fh[fw mu[ub pd[ff
錢塘江漲潮	qm[jj th[tg jl[dg vh[dg ic[du
前途光明	qm[bo tu[rz gl[xe mk[oo
謙虛	qm[yb xu[hy
錢也有權也有	qm[jj ye[vu yz[uo qr[ay ye[vu yz[uo
前有強敵後有追兵	qm[bo yz[uo ql[gk di[qw hz[pk yz[uo vv[pz bk[qb
千真萬真	qm[pu vf[uj wj[hv vf[uj
強盜發善心	ql[gk dc[dm fa[vy uj[yk xb[dv
強盜碰著賊爺爺	ql[gk dc[dm pg[eb ve[ym zw[bg ye[be ye[be
強盜照鏡子	ql[gk dc[dm vc[od jk[jl zi[lh
強拉媳婦成親	ql[gk la[fl xi[nz fu[nx ig[wv qb[la
強人所難	ql[gk rf[pd so[pj nj[yv
牆頭上的種白菜	ql[tt tz[dd uh[bh de[bb vs[hv bd[po cd[ca
牆頭上種菜	ql[tt tz[dd uh[bh vs[hv cd[ca
強裝有本事	ql[gk vl[dy yz[uo bf[ah ui[hk
巧媳婦	qn[gk xi[nz fu[nx
巧言哄人	qn[gk yj[we hs[kg rf[pd
秦檜殺岳飛的罪名	qb[sh hv[ar ua[ia yt[qu fw[vp de[bb zv[sf mk[xk
親肉一塊	qb[la rz[kr yi[hh kk[tv
秦叔寶的黃騾馬	qb[sh uu[uy bc[gw de[bb hl[gy lo[mt ma[vv
親員	qb[la yr[kb
輕而易舉	qk[is er[ek yi[ob ju[xf
清高	qk[df gc[wk
清了吧	qk[df le[vu ba[kb
青石板上的青苔	qk[fo ui[ek bj[ap uh[bh de[bb qk[fo td[cs
青石板上摔鳥龜	qk[fo ui[ek bj[ap uh[bh uk[fw nn[nh gv[do
青蛙吃黃蜂	qk[fo wa[it ii[kr hl[gy fg[iw
青蛙過冬	qk[fo wa[it go[cz ds[wd
青蛙求偶	qk[fo wa[it qq[hu ou[ro
青蛙拴生鞭梢上	qk[fo wa[it ur[fr ug[pf bm[gr uc[ax uh[bh
青娃望玉兔	qk[fo wa[nt wh[ww yu[wd tu[dk
青娃笑蝌蚪	qk[fo wa[nt xn[vp ke[ih dz[id
請小姨子作伴	qk[yf xn[ub yi[nh zi[lh zo[rv bj[rb
蜻蜒點水魚打花	qk[if yj[ip dm[bd uv[uu yu[dt da[fd hx[cr
青竹竿掏茅坑	qk[fo vu[rr gj[vg tc[fb mc[cy kg[tw
窮得叮噹響	qs[xl de[ro dk[kd dh[xx xl[kp
窮鬼們聚到一塊了	qs[xl gv[be mf[rm ju[ep dc[hd yi[hh kk[tv le[vu
窮橫	qs[xl hg[ag
窮極了	qs[xl ji[aj le[vu
窮快活	qs[xl kk[xv ho[dq
窮相畢露	qs[xl xl[am bi[bu lu[yz
窮壯膽	qs[xl vl[du dj[oo
求之不得	qq[hu vi[dv bu[eu de[ro
全靠別人施捨	qr[rw kc[nf bp[kd rf[pd ui[fr ue[rg
全落空	qr[rw lo[cd ks[xg
全憑手快	qr[rw pk[rj uz[su kk[xv
全憑一張嘴	qr[rw pk[rj yi[hh vh[gi zv[kv
全是酸的	qr[rw ui[op sr[ys de[bb
拳頭打跳蚤	qr[bf tz[dd da[fd tn[zv zc[yi
蜷腿帶拱腰	qr[ib tv[og dd[cj gs[fg yc[ox
全仗嘴	qr[rw vh[rh zv[kv
缺牙啃西瓜	qt[pv ya[hv kf[kv xi[hk gx[ps
瘸子騎瞎驢	qt[bk zi[lh qi[md xx[mg lv[mh
瘸子走山路	qt[bk zi[lh zz[tv uj[uk lu[zw
染布不勻	rj[da bu[uj bu[eu yy[bd
染坊的常客	rj[da fh[tf de[bb ih[xk ke[gw
染坊的大缸	rj[da fh[tf de[bb da[hr gh[wg
染房裡吹笛子	rj[da fh[hf li[ot iv[kd di[vy zi[lh
染坊裡的衣料	rj[da fh[tf li[ot de[bb yi[wy ln[md
染缸裡的衣服	rj[da gh[wg li[ot de[bb yi[wy fu[oe
染缸裡落白布	rj[da gh[wg li[ot lo[cd bd[po bu[uj
染匠的衣服	rj[da jl[kj de[bb yi[wy fu[oe
染匠下河	rj[da jl[kj xx[hb he[dk
讓結巴念繞回令	rh[yu jp[su ba[ku nm[rx rc[sq hv[wk lk[rd
讓了香瓜尋苦瓜	rh[yu le[vu xl[ho gx[ps xy[xc ku[cg gx[ps
饒舌的鳥鴉	rc[uq ue[qk de[bb nn[nh ya[yn
饒舌的烏鴉	rc[uq ue[qk de[bb wu[bv ya[yn
熱鍋爆米花	re[fd go[jk bc[ho mi[ba hx[cr
熱鍋裡的鴨子	re[fd go[jk li[ot de[bb ya[on zi[lh
熱鍋上的螞蟻	re[fd go[jk uh[bh de[bb ma[im yi[id
熱鍋上的蒸籠	re[fd go[jk uh[bh de[bb vg[cl ls[vy
熱火盆裡抽火炭	re[fd ho[dp pf[fm li[ot iz[fy ho[dp tj[uu
熱炕頭上的白麵	re[fd kh[hw tz[dd uh[bh de[bb bd[po mm[ew
熱面孔碰到冷毛巾	re[fd mm[ew ks[zv pg[eb dc[hd lg[dr mc[sv jb[ku
熱情在裡頭	re[fd qk[xf zd[ut li[ot tz[dd
熱水瓶	re[fd uv[uu pk[bw
熱水瓶脾氣	re[fd uv[uu pk[bw pi[ob qi[rh
熱水瓶上系索子	re[fd uv[uu pk[bw uh[bh xi[py so[uy zi[lh
熱蹄子馬	re[fd ti[zl zi[lh ma[vv
熱窩炒豆子	re[fd wo[xk ic[hx dz[hk zi[lh
熱中送扇雪中送炭	re[fd vs[ku ss[bz uj[hx xt[yx vs[ku ss[bz tj[uu
人把狗咬死了	rf[pd ba[fb gz[qb yc[kl si[hx le[vu
人才市場填個表	rf[pd cd[hu ui[wj ih[tv tm[tu ge[ru bn[fy
人到矮簷下	rf[pd dc[hd ai[uh yj[ad xx[hb
人到古稀穿花衣	rf[pd dc[hd gu[uk xi[hi ir[xy hx[cr yi[wy
人各有志	rf[pd ge[wk yz[uo vi[ux
人急跳窗戶	rf[pd ji[dx tn[zv il[xp hu[du
人老心不老	rf[pd lc[tb xb[dv bu[eu lc[tb
人面鬼心	rf[pd mm[ew gv[be xb[dv
任人擺佈	rf[rq rf[pd bd[fs bu[uj
任人解剖	rf[rq rf[pd jp[dd pz[ld
忍痛圖好看	rf[dx ts[bs tu[ww hc[nz kj[fm
人熊傢伙笨	rf[pd xs[sd jx[gu ho[rh bf[va
人在屋簷下	rf[pd zd[ut wu[uh yj[ad xx[hb
人在心不在	rf[pd zd[ut xb[dv bu[eu zd[ut
人造牛黃	rf[pd zc[nz nq[pf hl[gy
任重道遠	rf[rq vs[ph dc[bz yr[ez
人走家散	rf[pd zz[tv jx[gu sj[gw
扔下討飯籃打乞丐	rg[fn xx[hb tc[yc fj[up lj[vu da[fd qi[rv gd[xv
扔下鐵錘拿燈草	rg[fn xx[hb tp[jp iv[ji na[rf dg[hd cc[co
日出西山水倒流	ri[wh iu[ck xi[hk uj[uk uv[uu dc[rh lq[dw
日落西山	ri[wh lo[cd xi[hk uj[uk
日子難過	ri[wh zi[lh nj[yv go[cz
容不得半點火墾	rs[xr bu[eu de[ro bj[bf dm[bd ho[dp kf[gt
絨毛鴨子剛下水	rs[sg mc[sv ya[on zi[lh gh[kd xx[hb uv[uu
絨球打臉	rs[sg qq[wh da[fd lm[or
絨球打鑼	rs[sg qq[wh da[fd lo[js
肉案上的買賣	rz[kr an[ga uh[bh de[bb md[vd md[ud
肉包子打狗	rz[kr bc[bk zi[lh da[fd gz[qb
肉骨頭擂大鼓	rz[kr gu[ko tz[dd lw[fy da[hr gu[uu
肉骨頭落了鍋	rz[kr gu[ko tz[dd lo[cd le[vu go[jk
肉鍋裡煮元宵	rz[kr go[jk li[ot vu[td yr[ee xn[gx
肉爛在湯裡	rz[kr lj[hb zd[ut th[dv li[ot
肉爛嘴不爛	rz[kr lj[hb zv[kv bu[eu lj[hb
肉丸子掉迸煤堆裡	rz[kr wj[jd zi[lh dn[fb bg[bz mw[hg dv[tv li[ot
柔中有剛	rz[ya vs[ku yz[uo gh[kd
入伏的高梁	ru[pd fu[rq de[bb gc[wk ll[da
如來佛的手心	ru[nk ld[hm fo[rf de[bb uz[su xb[dv
軟麵包餃子	rr[id mm[ew bc[bk jn[ul zi[lh
軟弱無能	rr[id ro[gg wu[ee ng[sb
軟中有硬	rr[id vs[ku yz[uo yk[eh
撒了穀子拾稻草	sa[fg le[vu gu[bk zi[lh ui[fr dc[ha cc[co
仨錢買匹馬	sa[rs qm[jj md[vd pi[ke ma[vv
賽馬場上的冠軍	sd[gb ma[vv ih[tv uh[bh de[bb gr[ge jy[gi
三百斤的野豬	sj[hh bd[eo jb[ph de[bb ye[oy vu[qt
三本經書掉了兩本	sj[hh bf[ah jk[ss uu[vv dn[fb le[vu ll[hk bf[ah
三岔口的地保	sj[hh ia[fu kz[uv de[bb di[ty bc[rk
三寸舌頭是軟的	sj[hh cy[hu ue[qk tz[dd ui[op rr[id de[bb
三分錢買個臭豬蹄	sj[hh ff[bd qm[jj md[vd ge[ru iz[zq vu[qt ti[zl
三伏天的狗	sj[hh fu[rq tm[hd de[bb gz[qb
三伏天的餿豆腐	sj[hh fu[rq tm[hd de[bb sz[uj dz[hk fu[gk
三個鼻孔眼兒	sj[hh ge[ru bi[zt ks[zv yj[mg er[pv
三個醉漢撒酒瘋	sj[hh ge[ru zv[yw hj[dy sa[fg jq[dy fg[bf
三根纜繩拴兩邊	sj[hh gf[ag lj[su ug[sk ur[fr ll[hk bm[lz
三顧茅廬	sj[hh gu[iy mc[cy lu[gh
三合板上雕花	sj[hh he[rh bj[ap uh[bh dn[kv hx[cr
三間瓦房不開門	sj[hh jm[mo wa[hv fh[hf bu[eu kd[hc mf[du
三角挫刀	sj[hh jn[do co[fr dc[vp
三角磚頭	sj[hh jn[do vr[ee tz[dd
三斤半鴨子二斤半嘴	sj[hh jb[ph bj[bf ya[on zi[lh er[hh jb[ph bj[bf zv[kv
三九天吃梅子	sj[hh jq[pv tm[hd ii[kr mw[ar zi[lh
三句話不離本行	sj[hh ju[bk hx[yq bu[eu li[wk bf[ah hh[rh
三令五申	sj[hh lk[rd wu[hu uf[ou
三五成群	sj[hh wu[hu ig[wv qy[xy
三心二意	sj[hh xb[dv er[hh yi[lx
喪膽	sh[ty dj[oo
色厲內荏	se[db li[iw nw[kr rf[cr
煞風景	ua[dd fg[ji jk[ow
砂鍋裡的火藥	ua[ex go[jk li[ot de[bb ho[dp yc[cs
扇陰風	uj[hx yb[eo fg[ji
上不著天下不著地	uh[bh bu[eu vc[ym tm[hd xx[hb bu[eu vc[ym di[ty
上帝保佑	uh[bh di[lj bc[rk yz[ru
上晃下搖	uh[bh hl[ox xx[hb yc[fa
上了大當	uh[bh le[vu da[hr dh[xx
上臉	uh[bh lm[or
上樑不正下樑歪	uh[bh ll[da bu[eu vg[hv xx[hb ll[da wd[bh
上氣不接下氣	uh[bh qi[rh bu[eu jp[fl xx[hb qi[rh
上下兩難	uh[bh xx[hb ll[hk nj[yv
燒不成個東西	uc[hq bu[eu ig[wv ge[ru ds[qx xi[hk
少不了挨一刀	uc[xp bu[eu ln[vu ai[fs yi[hh dc[vp
少見	uc[xp jm[ke
少有	uc[xp yz[uo
設底兒	ue[yj di[gu er[pv
神氣來了	uf[uo qi[rh ld[hm le[vu
身子爛了踴頭還硬	uf[pu zi[lh lj[hb le[vu ys[zs tz[dd hd[bz yk[eh
生了外心	ug[pf le[vu wd[xb xb[dv
士兵搭帳篷	ui[uh bk[qb da[fc vh[ji pg[vw
實打實	ui[gd da[fd ui[gd
時高時低	ui[oc gc[wk ui[oc di[ru
屎殼郎打噴嚏	ui[um ke[ug lh[le da[fd pf[ku ti[ku
屎殼郎戴面具	ui[um ke[ug lh[le dd[tt mm[ew ju[jb
失面子	ui[pe mm[ew zi[lh
十拿九穩	ui[hu na[rf jq[pv wf[hd
屎尿多	ui[um nn[uu do[xx
使偏勁	ui[rh pm[rh jb[sl
十五隻小船出海	ui[hu wu[hu vi[kb xn[ub ir[vj iu[ck hd[dr
實心實意	ui[gd xb[dv ui[gd yi[lx
實心竹竿做笛子	ui[gd xb[dv vu[rr gj[vg zo[rg di[vy zi[lh
實心竹子做笛子	ui[gd xb[dv vu[rr zi[lh zo[rg di[vy zi[lh
十有九空	ui[hu yz[uo jq[pv ks[xg
施展不開	ui[fr vj[ug bu[eu kd[hc
食之無味棄之可惜	ui[rl vi[dv wu[ee ww[kh qi[wc vi[dv ke[dk xi[xg
受潮的麻花	uz[ay ic[du de[bb ma[ga hx[cr
手電筒沒燈泡	uz[su dm[ov ts[vk mw[dj dg[hd pc[db
受了冷氣受熱氣	uz[ay le[vu lg[dr qi[rh uz[ay re[fd qi[rh
瘦驢拉硬屎	uz[bj lv[mh la[fl yk[eh ui[um
手捧雞蛋過河	uz[su pg[fs ji[yn dj[pi go[cz he[dk
受人牽連	uz[ay rf[pd qm[dg lm[iz
瘦死的駱駝	uz[bj si[hx de[bb lo[mw to[mg
壽星出點子	uz[fc xk[op iu[ck dm[bd zi[lh
壽星娶小	uz[fc xk[op qu[en xn[ub
瘦子光膀幾	uz[bj zi[lh gl[xe bh[ol ji[pv
樹不起來	uu[ay bu[eu qi[zk ld[hm
屬大腸的	uu[up da[hr ih[ov de[bb
熟得早	uu[wd de[ro zc[ou
屬地瓜的	uu[up di[ty gx[ps de[bb
屬狗尾巴的	uu[up gz[qb ww[um ba[ku de[bb
熟螃蟹	uu[wd ph[il xp[di
樹梢上吹喇叭	uu[ay uc[ax uh[bh iv[kd la[kh ba[kb
暑天下大雪	uu[ot tm[hd xx[hb da[hr xt[yx
樹葉子掉到河裡	uu[ay ye[ku zi[lh dn[fb dc[hd he[dk li[ot
熟一個蹦一個	uu[wd yi[hh ge[ru bg[zu yi[hh ge[ru
樹樁上的鳥兒	uu[ay vl[ag uh[bh de[bb nn[nh er[pv
耍滑頭	ux[en hx[dg tz[dd
耍皮影子的	ux[en pi[vp yk[op zi[lh de[bb
甩不掉	uk[ov bu[eu dn[fb
甩不脫	uk[ov bu[eu to[ob
雙胞胎比長相	ul[yy bc[ob td[os bi[bb ih[ph xl[am
霜打的黃瓜	ul[ya da[fd di[bb hl[gy gx[ps
霜打的麻葉	ul[ya da[fd di[bb ma[ga ye[ku
雙喜臨門	ul[yy xi[uk lb[uv mf[du
水壺裡盛湯圓	uv[uu hu[uy li[ot ig[wm th[dv yr[wk
水浸菩薩	uv[uu jb[dx pu[cl sa[ce
水裡的蛤蟆	uv[uu li[ot de[bb ha[ir ma[ic
水面打一棒	uv[uu mm[ew da[fd yi[hh bh[as
水牛吃活蟹	uv[uu nq[pf ii[kr ho[dq xp[di
水牛過河	uv[uu nq[pf go[cz he[dk
水泡豆子	uv[uu pc[db dz[hk zi[lh
水平太低	uv[uu pk[hb td[dd di[ru
水平有限	uv[uu pk[hb yz[uo xm[eg
水獺找泥鰍	uv[uu ta[qh vc[fg ni[du qq[yh
誰抬你啊	uv[yv td[fs ni[rd aa[ke
誰也甭想逃出去	uv[yv ye[vu bg[bo xl[ax tc[vz iu[ck qu[ts
誰也別說誰	uv[yv ye[vu bp[kd uo[yb uv[yv
誰也不吃虧	uv[yv ye[vu bu[eu ii[kr kv[hk
誰也不正眼看誰	uv[yv ye[vu bu[eu vg[hv yj[mg kj[fm uv[yv
誰有吃就跟誰走	uv[yv yz[uo ii[kr jq[wy gf[zg uv[yv zz[tv
說不出個好處來	uo[yb bu[eu iu[ck ge[ru hc[nz iu[wb ld[hm
說不出好話來	uo[yb bu[eu iu[ck hc[nz hx[yq ld[hm
說不通	uo[yb bu[eu ts[sz
說得多	uo[yb de[ro do[xx
說黑話	uo[yb hw[sd hx[yq
說亮話	uo[yb ll[wj hx[yq
死不放	si[hx bu[eu fh[fw
死不甘心	si[hx bu[eu gj[nh xb[dv
死不了人	si[hx bu[eu ln[vu rf[pd
死不要臉	si[hx bu[eu yc[xn lm[or
死盡忠心	si[hx jb[ud vs[vx xb[dv
死心眼兒	si[hx xb[dv yj[mg er[pv
送福	ss[bz fu[uh
送來一口肉	ss[bz ld[hm yi[hh kz[uv rz[kr
素不相識	su[fy bu[eu xl[am ui[yk
隨波逐流	sv[eu bo[dp vu[uz lq[dw
塌鼻子嫁個斜眼	ta[to bi[zt zi[lh jx[ng ge[ru xp[rd yj[mg
塔頂散步	ta[tc dk[dy sj[gw bu[vu
塌鍋乾飯	ta[to go[jk gj[hu fj[up
踏死蛤蟆肚子脹	ta[zu si[hx ha[ir ma[ic du[ot zi[lh vh[oi
太把自己看大了	td[dd ba[fb zi[pm ji[kv kj[fm da[hr le[vu
抬棺材的掉褲子	td[fs gr[ag cd[ac de[bb dn[fb ku[yg zi[lh
太極拳的功夫	td[dd ji[aj qr[bf de[bb gs[gl fu[er
太監出家	td[dd jm[um iu[ck jx[gu
太平洋搬家	td[dd pk[hb yh[dy bj[fv jx[gu
太平洋上的警察	td[dd pk[hb yh[dy uh[bh de[bb jk[cy ia[gx
泰山頂上唱大戲	td[su uj[uk dk[dy uh[bh ih[ko da[hr xi[yg
臺上唱戲臺下打鼾	td[sk uh[bh ih[ko xi[yg td[sk xx[hb da[fd hj[zg
太上老君開處方	td[dd uh[bh lc[tb jy[xk kd[hc iu[wb fh[dw
太歲鄉頭坐	td[dd sv[ux xl[sp tz[dd zo[rr
抬腿上樓梯	td[fs tv[og uh[bh lz[am ti[ab
太陽地裡望星星	td[dd yh[eo di[ty li[ot wh[ww xk[op xk[op
太陽底下點燈	td[dd yh[eo di[gu xx[hb dm[bd dg[hd
談崩了	tj[yh bg[uo le[vu
談不上	tj[yh bu[eu uh[bh
貪吃不留種	tj[rb ii[kr bu[eu lq[pt vs[hv
彈棉花胎的進官	tj[gb mm[ab hx[cr td[os de[bb jb[ez gr[gu
貪便宜	tj[rb pm[rh yi[gq
炭篩子篩芝麻	tj[uu ud[vu zi[lh ud[vu vi[cv ma[ga
檀香木蓋茅坑	tj[aw xl[ho mu[ub gd[bm mc[cy kg[tw
談心不點燈	tj[yh xb[dv bu[eu dm[bd dg[hd
貪心鬼	tj[rb xb[dv gv[be
癱子靠跛子	tj[by zi[lh kc[nf bo[zp zi[lh
罈子裡的鹹菜	tj[te zi[lh li[ot de[bb xm[wh cd[ca
罈子裡和麵	tj[te zi[lh li[ot ho[hk mm[ew
癱子請客	tj[by zi[lh qk[yf ke[gw
貪嘴的魚兒	tj[rb zv[kv de[bb yu[dt er[pv
躺在功勞簿上睡大覺	th[ux zd[ut gs[gl lc[cl bu[vd uh[bh uv[mi da[hr jn[xj
躺在棺材裡想金條	th[ux zd[ut gr[ag cd[ac li[ot xl[ax jb[rw tn[wa
躺著說話	th[ux ve[ym uo[yb hx[yq
討吃的喂猴	tc[yc ii[kr de[bb ww[kt hz[qr
討飯找馬騎	tc[yc fj[up vc[fg ma[vv qi[md
陶工手裡的粘上	tc[eb gs[hu uz[su li[ot de[bb vj[mb uh[bh
討媳婦嫁女兒	tc[yc xi[nz fu[nx jx[ng nv[vp er[pv
套袖改襪子	tc[di xq[yy gd[kw wa[yh zi[lh
騰雲駕霧	tg[ob yy[es jx[lm wu[yw
替狗忙	ti[eo gz[qb mh[xw
剃頭的動手	ti[bd tz[dd de[bb ds[el uz[su
剃頭匠發火	ti[bd tz[dd jl[kj fa[vy ho[dp
提心吊膽	ti[fo xb[dv dn[kj dj[oo
提著燈籠打柴	ti[fo ve[ym dg[hd ls[vy da[fd id[va
提著口袋倒核桃	ti[fo ve[ym kz[uv dd[ry dc[rh he[aw tc[av
田埂上搭橋	tm[wu gg[th uh[bh da[fc qn[ap
甜果都從苦根來	tm[qg go[oa dz[te cs[rr ku[cg gf[ag ld[hm
天黑敬菩薩	tm[hd hw[sd jk[cw pu[cl sa[ce
天花亂墜	tm[hd hx[cr lr[qv vv[et
天降良緣	tm[hd jl[ew ll[dg yr[sv
田裡的莊稼	tm[wu li[ot de[bb vl[gt jx[hg
填滿肚子算事	tm[tu mj[dc du[ot zi[lh sr[vm ui[hk
甜蜜	tm[qg mi[gi
天上的老鷹不吃髒東西	tm[hd uh[bh de[bb lc[tb yk[gn bu[eu ii[kr zh[og ds[qx xi[hk
田鼠走親戚	tm[wu uu[jv zz[tv qb[la qi[wu
天天向上	tm[hd tm[hd xl[pk uh[bh
田頭訓子	tm[wu tz[dd xy[yi zi[lh
天下奇聞	tm[hd xx[hb qi[dk wf[me
挑燈草走路	tn[fv dg[hd cc[co zz[tv lu[zw
挑水騎單車	tn[fv uv[uu qi[md dj[bo ie[qu
鐵面無私	tp[jp mm[ew wu[ee si[hs
鐵蛇掉井裡	tp[jp ue[ig dn[fb jk[ep li[ot
聽見貓叫骨頭酥	tk[kj jm[ke mc[qc jn[kv gu[ko tz[dd su[yh
聽啞巴唱戲	tk[kj ya[kh ba[ku ih[ko xi[yg
亭子裡談心	tk[wd zi[lh li[ot tj[yh xb[dv
同行	ts[kh hh[rh
童養媳當媒人	ts[lo yh[yp xi[nz dh[xx mw[ng rf[pd
同一個馬鞍上的人	ts[kh yi[hh ge[ru ma[vv an[gg uh[bh de[bb rf[pd
偷吃的貓兒	tz[rr ii[kr de[bb mc[qc er[pv
偷吃海椒挨耳光	tz[rr ii[kr hd[dr jn[au ai[fs er[hu gl[xe
偷雞不成蝕把米	tz[rr ji[yn bu[eu ig[wv ui[ui ba[fb mi[ba
偷雞摸蛋	tz[rr ji[yn mo[fc dj[pi
偷來的喇叭	tz[rr ld[hm de[bb la[kh ba[kb
頭破血流	tz[dd po[ep xt[pm lq[dw
頭挑	tz[dd tn[fv
頭頭是道	tz[dd tz[dd ui[op dc[bz
突出	tu[xq iu[ck
屠夫說豬農夫說谷	tu[ut fu[er uo[yb vu[qt ns[gy fu[er uo[yb gu[bk
屠夫送禮	tu[ut fu[er ss[bz li[uv
圖個乾脆	tu[ww ge[ru gj[hu cv[od
土裡來泥裡去	tu[uh li[ot ld[hm ni[du li[ot qu[ts
土生土長	tu[uh ug[pf tu[uh vh[ph
土腥味	tu[uh xk[oo ww[kh
禿子腦袋當玩具	tu[hj zi[lh nc[ow dd[ry dh[xx wj[we ju[jb
禿子揍和尚	tu[hj zi[lh zz[fs he[hk uh[xk
團團轉	tr[wc tr[wc vr[ie
挖苦	wa[fx ku[cg
挖一個少一個	wa[fx yi[hh ge[ru uc[xp yi[hh ge[ru
外辣裡軟	wd[xb la[lh li[ot rr[id
外面冷裡頭熱	wd[xb mm[ew lg[dr li[ot tz[dd re[fd
外頭涼裡面熱	wd[xb tz[dd ll[dw li[ot mm[ew re[fd
玩的騙人術	wj[we de[bb pm[mh rf[pd uu[ad
晚了遲了	wj[od le[vu ii[uz le[vu
玩心不退	wj[we xb[dv bu[eu tv[gz
忘本	wh[wx bf[ah
枉費心機	wh[aw fw[fb xb[dv ji[aj
忘了自己從哪來了	wh[wx le[vu zi[pm ji[kv cs[rr na[kv ld[hm le[vu
望洋興嘆	wh[ww yh[dy xk[xb tj[ky
往最壞處想	wh[rd zv[oe hk[tb iu[wb xl[ax
尾巴翹上天	ww[um ba[ku qn[qx uh[bh tm[hd
為的是嘴	ww[dl de[bb ui[op zv[kv
威風掃地	ww[wh fg[ji sc[fx di[ty
為民請命	ww[dl mb[kv qk[yf mk[rh
未知經過多少風雨	ww[ha vi[uk jk[ss go[cz do[xx uc[xp fg[ji yu[hk
蚊龍困在沙灘上	wf[iw ls[yp ky[wa zd[ut ua[dx tj[dy uh[bh
文明人不做文明事	wf[wi mk[oo rf[pd bu[eu zo[rg wf[wi mk[oo ui[hk
聞聲不見人	wf[me ug[um bu[eu jm[ke rf[pd
紋絲不動	wf[sw si[sh bu[eu ds[el
窩脖	wo[xk bo[ou
握不住	wo[fu bu[eu vu[rd
無不識貨	wu[ee bu[eu ui[yk ho[rb
無恥下流	wu[ee ii[ev xx[hb lq[dw
無出路	wu[ee iu[ck lu[zw
無痕跡	wu[ee hf[bg ji[yz
無可奈何	wu[ee ke[dk nd[de he[rk
無奇不有	wu[ee qi[dk bu[eu yz[uo
無牽無掛	wu[ee qm[dg wu[ee gx[ft
無情	wu[ee qk[xf
無人買	wu[ee rf[pd md[vd
無傷痕	wu[ee uh[rr hf[bg
無事不來	wu[ee ui[hk bu[eu ld[hm
無事生非	wu[ee ui[hk ug[pf fw[su
武藝高	wu[hv yi[cv gc[wk
無依無靠	wu[ee yi[ry wu[ee kc[nf
無用	wu[ee ys[ou
吸飽風的帆	xi[kj bc[ub fg[ji de[bb fj[jj
喜出望外	xi[uk iu[ck wh[ww wd[xb
細吹細打	xi[st iv[kd xi[st da[fd
稀飯鍋裡扔鐵砣	xi[hi fj[up go[jk li[ot rg[fn tp[jp to[eg
膝蓋頭套襪子	xi[oa gd[bm tz[dd tc[di wa[yh zi[lh
西瓜皮打鞋掌	xi[hk gx[ps pi[vp da[fd xp[gt vh[xf
西瓜皮做帽子	xi[hk gx[ps pi[vp zo[rg mc[jo zi[lh
細嚼饅咽	xi[st jn[ka mj[uo yj[kw
洗臉盆裡游泳	xi[dn lm[or pf[fm li[ot yz[df ys[dd
喜馬拉雅山上賣牛黃	xi[uk ma[vv la[fl ya[yv uj[uk uh[bh md[ud nq[pf hl[gy
西門慶請武大郎	xi[hk mf[du qk[gd qk[yf wu[hv da[hr lh[le
惜錢不治病	xi[xg qm[jj bu[eu vi[ds bk[bh
喜鵲落頭上	xi[uk qt[gn lo[cd tz[dd uh[bh
西山猛虎不咬人	xi[hk uj[uk mg[qz hu[hj bu[eu yc[kl rf[pd
西施坐飛機	xi[hk ui[fr zo[rr fw[vp ji[aj
蟋蟀鬥公雞	xi[ip uk[iw dz[du gs[bs ji[yn
戲臺後頭的鑼鼓	xi[yg td[sk hz[pk tz[dd de[bb lo[js gu[uu
戲臺上拜天地	xi[yg td[sk uh[bh bd[fh tm[hd di[ty
戲臺上堵槍眼	xi[yg td[sk uh[bh du[tt ql[ar yj[mg
嘻嘻哈哈年過十八	xi[ku xi[ku ha[kr ha[kr nm[rn go[cz ui[hu ba[pd
西廂記作枕頭	xi[hk xl[ia ji[yk zo[rv vf[ag tz[dd
戲園子失火	xi[yg yr[we zi[lh ui[pe ho[dp
惜債買藉吃	xi[xg vd[rf md[vd ji[cl ii[kr
戲中有戲	xi[yg vs[ku yz[uo xi[yg
下不了口	xx[hb bu[eu ln[vu kz[uv
嚇不住人	xx[kx bu[eu vu[rd rf[pd
瞎逞能	xx[mg ig[kz ng[sb
下大雪找蹄印	xx[hb da[hr xt[yx vc[fg ti[zl yb[pe
瞎打一陣	xx[mg da[fd yi[hh vf[ei
下地不穿鞋	xx[hb di[ty bu[eu ir[xy xp[gt
瞎姑娘戴眼鏡	xx[mg gu[ng nl[nl dd[tt yj[mg jk[jl
嚇唬人	xx[kx hu[kh rf[pd
嚇唬人哩	xx[kx hu[kh rf[pd li[ko
下轎打轎伕	xx[hb jn[ip da[fd jn[ip fu[er
瞎了眼的癩皮狗	xx[mg le[vu yj[mg de[bb ld[bh pi[vp gz[qb
瞎妹子當媒人	xx[mg mw[nh zi[lh dh[xx mw[ng rf[pd
蝦吞礁石	xx[ix ty[tk jn[ev ui[ek
瞎張羅	xx[mg vh[gi lo[sx
瞎子背瞎子	xx[mg zi[lh bw[bo xx[mg zi[lh
瞎子吃黃瓜	xx[mg zi[lh ii[kr hl[gy gx[ps
瞎子打過獨林橋	xx[mg zi[lh da[fd go[cz du[qi lb[aa qn[ap
瞎子逛商店	xx[mg zi[lh gl[qz uh[lk dm[gb
蝦子過河	xx[ix zi[lh go[cz he[dk
瞎子夾豆腐	xx[mg zi[lh jx[hb dz[hk fu[gk
瞎子救人	xx[mg zi[lh jq[hw rf[pd
瞎子上街	xx[mg zi[lh uh[bh jp[rt
閒不住	xm[ma bu[eu vu[rd
鹹菜拌豆腐	xm[wh cd[ca bj[fb dz[hk fu[gk
鹹菜缸裡養白螺	xm[wh cd[ca gh[wg li[ot yh[yp bd[po lo[it
鹹菜煮豆腐	xm[wh cd[ca vu[td dz[hk fu[gk
險乎得很	xm[er hu[pb de[ro hf[rg
閒話不少	xm[ma hx[yq bu[eu uc[xp
鹹肉里加醬油	xm[wh rz[kr li[ot jx[lk jl[dy yz[dy
鹹魚落塘	xm[wh yu[dt lo[cd th[tg
想不透	xl[ax bu[eu tz[hz
香臭不分	xl[ho iz[zq bu[eu ff[bd
香臭難分	xl[ho iz[zq nj[yv ff[bd
想得倒美	xl[ax de[ro dc[rh mw[bw
想得寬	xl[ax de[ro kr[gc
享福又受苦	xl[wz fu[uh yz[vd uz[ay ku[cg
象個人似的	xl[dk ge[ru rf[pd ui[rs de[bb
橡皮糖	xl[ad pi[vp th[mg
想沾點仙氣	xl[ax vj[db dm[bd xm[ru qi[rh
想轉了	xl[ax vr[ie le[vu
小鬼的嘴裡都冒煙	xn[ub gv[be de[bb zv[kv li[ot dz[te mc[om yj[hw
小題大作	xn[ub ti[oy da[hr zo[rv
小心過度	xn[ub xb[dv go[cz du[gn
鞋底打掌	xp[gt di[gu da[fd vh[xf
鞋底抹油	xp[gt di[gu mo[fh yz[dy
鞋殼簍裡跑馬	xp[gt ke[ug lz[vm li[ot pc[zb ma[vv
洩氣	xp[dn qi[rh
鞋上繡金夙	xp[gt uh[bh xq[sh jb[rw su[jh
心到神知	xb[dv dc[hd uf[uo vi[uk
新郎官戴孝	xb[lj lh[le gr[gu dd[tt xn[tz
新郎官揭蓋頭	xb[lj lh[le gr[gu jp[fo gd[bm tz[dd
新女婿請接生婆	xb[lj nv[vp xu[np qk[yf jp[fl ug[pf po[dn
新上門的姑爺	xb[lj uh[bh mf[du de[bb gu[ng ye[be
新上市的黃瓜	xb[lj uh[bh ui[wj de[bb hl[gy gx[ps
心碎	xb[dv sv[ew
新媳婦吃飯	xb[lj xi[nz fu[nx ii[kr fj[up
新媳婦哭公公	xb[lj xi[nz fu[nx ku[kq gs[bs gs[bs
新學	xb[lj xt[xz
心眼多	xb[dv yj[mg do[xx
心眼狹小	xb[dv yj[mg xx[qj xn[ub
新衣服打補丁	xb[lj yi[wy fu[oe da[fd bu[yb dk[hu
行不通	xk[rh bu[eu ts[sz
行不通走不通	xk[rh bu[eu ts[sz zz[tv bu[eu ts[sz
杏花村的酒	xk[ak hx[cr cy[ac de[bb jq[dy
興師動眾	xk[xb ui[uh ds[el vs[rr
星星跟著月亮走	xk[op xk[op gf[zg ve[ym yt[ke ll[wj zz[tv
凶多吉少	xs[ik do[xx ji[uk uc[xp
胸前劃十字	xs[ob qm[bo hx[gd ui[hu zi[gz
凶神惡煞	xs[ik uf[uo ee[hx ua[dd
熊耍把戲狗叫喚	xs[sd ux[en ba[fb xi[yg gz[qb jn[kv hr[kd
秀才的手中	xq[hn cd[hu de[bb uz[su vs[ku
秀才偷筆	xq[hn cd[hu tz[rr bi[vm
秀才遇到虎	xq[hn cd[hu yu[oz dc[hd hu[hj
繡花姑娘打架	xq[sh hx[cr gu[ng nl[nl da[fd jx[la
羞死人	xq[yi si[hx rf[pd
休想	xq[ra xl[ax
許不下羊羔許駱駝	xu[yw bu[eu xx[hb yh[bs gc[bd xu[yw lo[mw to[mg
虛度年華	xu[hy du[gn nm[rn hx[ru
虛情當成真意	xu[hy qk[xf dh[xx ig[wv vf[uj yi[lx
虛情假意	xu[hy qk[xf jx[rk yi[lx
許仙碰著白娘子	xu[yw xm[ru pg[eb ve[ym bd[po nl[nl zi[lh
虛張聲勢	xu[hy vh[gi ug[um ui[fl
宣統坐江山	xr[gh ts[sw zo[rr jl[dg uj[uk
雪堆的假山	xt[yx dv[tv de[bb jx[rk uj[uk
薛仁貴的行頭	xt[cp rf[re gv[vb de[bb xk[rh tz[dd
薛仁貴徵東	xt[cp rf[re gv[vb vg[rh ds[qx
學人樣	xt[xz rf[pd yh[ay
鴨棚的老漢睡懶覺	ya[on pg[ao de[bb lc[tb hj[dy uv[mi lj[xh jn[xj
眼饞	yj[mg ij[ud
言傳身教	yj[we ir[re uf[pu jn[tw
菸袋鍋烤手	yj[hw dd[ry go[jk kc[ht uz[su
菸袋鍋裡煮飯	yj[hw dd[ry go[jk li[ot vu[td fj[up
鹽堆裡爬出來的人	yj[tm dv[tv li[ot pa[pb iu[ck ld[hm de[bb rf[pd
菸灰抹面皮	yj[hw hv[uh mo[fh mm[ew pi[vp
眼睛上出芽了	yj[mg jk[mf uh[bh iu[ck ya[cy le[vu
眼裡的灰塵	yj[mg li[ot de[bb hv[uh if[xt
醃蘿蔔拌黃瓜	yj[od lo[cs bo[ud bj[fb hl[gy gx[ps
閻王開店	yj[md wh[su kd[hc dm[gb
閻王爺的扇子	yj[md wh[su ye[be de[bb uj[hx zi[lh
閻王爺做的芝麻餅	yj[md wh[su ye[be zo[rg de[bb vi[cv ma[ga bk[ub
唁閒嗑	yj[ky xm[ma ke[kt
演員謝幕	yj[dg yr[kb xp[yu mu[cj
嚴陣以待	yj[hy vf[ei yi[sr dd[rt
楊繼業數兒子	yh[av ji[sm ye[ub uu[mw er[pv zi[lh
養麥地裡藏禿子	yh[yp md[fw di[ty li[ot ch[cw tu[hj zi[lh
養麥地裡抓王八	yh[yp md[fw di[ty li[ot vx[fp wh[su ba[pd
羊群裡跑出個駱駝	yh[bs qy[xy li[ot pc[zb iu[ck ge[ru lo[mw to[mg
養在圈裡的豬	yh[yp zd[ut qr[wb li[ot de[bb vu[qt
楊志賣刀	yh[av vi[ux md[ud dc[vp
樣子神氣	yh[ay zi[lh uf[uo qi[rh
藥店裡招手	yc[cs dm[gb li[ot vc[fd uz[su
要飯的打狗	yc[xn fj[up de[bb da[fd gz[qb
要飯的拿餅子	yc[xn fj[up de[bb na[rf bk[ub zi[lh
要飯的拿戳子	yc[xn fj[up de[bb na[rf io[xg zi[lh
腰桿子硬	yc[ox gj[ag zi[lh yk[eh
腰裡別鋼筋	yc[ox li[ot bp[kd gh[jk jb[vo
腰裡別鐮刀	yc[ox li[ot bp[kd lm[jg dc[vp
腰裡掖著個扁擔	yc[ox li[ot ye[fw ve[ym ge[ru bm[hk dj[fo
藥鋪裡賣棺材	yc[cs pu[jf li[ot md[ud gr[ag cd[ac
妖言惑眾	yc[np yj[we ho[gx vs[rr
要也不是不要也不是	yc[xn ye[vu bu[eu ui[op bu[eu yc[xn ye[vu bu[eu ui[op
咬著鐵棍還說牙齒硬	yc[kl ve[ym tp[jp gy[ao hd[bz uo[yb ya[hv ii[vr yk[eh
夜不關門	ye[wr bu[eu gr[bt mf[du
葉公好龍	ye[ku gs[bs hc[nz ls[yp
夜壺打了把	ye[wr hu[uy da[fd le[vu ba[fb
夜壺裡洗澡	ye[wr hu[uy li[ot xi[dn zc[dk
爺見孫貓見竄	ye[be jm[ke sy[zx mc[qc jm[ke cr[xk
野狸子舔虎鼻樑	ye[oy li[qo zi[lh tm[qt hu[hj bi[zt ll[da
野牛闖進火海里	ye[oy nq[pf il[mm jb[ez ho[dp hd[dr li[ot
野獸當家	ye[oy uz[bh dh[xx jx[gu
夜鶯配鸚鵡	ye[wr yk[cn pw[yk yk[bn wu[wn
掖著個孫悟空	ye[fw ve[ym ge[ru sy[zx wu[xw ks[xg
一輩子出不了頭	yi[hh bw[fi zi[lh iu[ck bu[eu ln[vu tz[dd
一本正經	yi[hh bf[ah vg[hv jk[ss
一步登天	yi[hh bu[vu dg[dd tm[hd
一觸即發	yi[hh iu[di ji[ge fa[vy
一觸即跳	yi[hh iu[di ji[ge tn[zv
一吹就散	yi[hh iv[kd jq[wy sj[gw
一錯再錯	yi[hh co[jg zd[hk co[jg
一對醜	yi[hh dv[yc iz[vu
一付壞心腸	yi[hh fu[rc hk[tb xb[dv ih[ov
一個比一個難看	yi[hh ge[ru bi[bb yi[hh ge[ru nj[yv kj[fm
一個比一個凶	yi[hh ge[ru bi[bb yi[hh ge[ru xs[ik
一個不留	yi[hh ge[ru bu[eu lq[pt
一個刁一個滑	yi[hh ge[ru dn[vh yi[hh ge[ru hx[dg
一個更比一個凶	yi[hh ge[ru gg[ho bi[bb yi[hh ge[ru xs[ik
一個師父一路拳	yi[hh ge[ru ui[uh fu[bi yi[hh lu[zw qr[bf
一個樣	yi[hh ge[ru yh[ay
一個願打一個願挨	yi[hh ge[ru yr[ix da[fd yi[hh ge[ru yr[ix ai[fs
以功為守	yi[sr gs[gl ww[dl uz[gc
一鼓作氣	yi[hh gu[uu zo[rv qi[rh
一鬨而散	yi[hh hs[kg er[ek sj[gw
一夥更比一夥凶	yi[hh ho[rh gg[ho bi[bb yi[hh ho[rh xs[ik
一節也不通	yi[hh jp[ce ye[vu bu[eu ts[sz
一進一出	yi[hh jb[ez yi[hh iu[ck
一舉兩得	yi[hh ju[xf ll[hk de[ro
一溜二抹	yi[hh lq[dp er[hh mo[fh
一馬當先	yi[hh ma[vv dh[xx xm[ne
一模一樣	yi[hh mo[ac yi[hh yh[ay
姨奶奶的枕頭鳳	yi[nh nd[nn nd[nn de[bb vf[ag tz[dd fg[jy
一年不如一年	yi[hh nm[rn bu[eu ru[nk yi[hh nm[rn
一篇大道理	yi[hh pm[vh da[hr dc[bz li[wo
一竅不通	yi[hh qn[xg bu[eu ts[sz
一去不回頭	yi[hh qu[ts bu[eu hv[wk tz[dd
一時光	yi[hh ui[oc gl[xe
一雙腳踏兩隻船	yi[hh ul[yy jn[ot ta[zu ll[hk vi[kb ir[vj
一攤泥	yi[hh tj[fy ni[du
一套一套的	yi[hh tc[di yi[hh tc[di de[bb
一條心	yi[hh tn[wa xb[dv
一頭滿意	yi[hh tz[dd mj[dc yi[lx
一推就倒	yi[hh tv[fv jq[wy dc[rh
一拖再拖	yi[hh to[fr zd[hk to[fr
一窩不如一窩	yi[hh wo[xk bu[eu ru[nk yi[hh wo[xk
一窩孫	yi[hh wo[xk sy[zx
一瀉千里	yi[hh xp[dg qm[pu li[ot
以怨報德	yi[sr yr[xx bc[fe de[ru
引火上身	yb[gu ho[dp uh[bh uf[pu
硬按公雞下蛋	yk[eh an[fg gs[bs ji[yn xx[hb dj[pi
硬棒槌彈棉花	yk[eh bh[as iv[ap tj[gb mm[ab hx[cr
硬撐市面	yk[eh ig[fx ui[wj mm[ew
鷹飛藍天走夜路	yk[gn fw[vp lj[cu tm[hd zz[tv ye[wr lu[zw
硬牛皮	yk[eh nq[pf pi[vp
硬碰硬	yk[eh pg[eb yk[eh
硬欺負人	yk[eh qi[qd fu[db rf[pd
硬往上貼	yk[eh wh[rd uh[bh tp[bb
硬往死裡逼	yk[eh wh[rd si[hx li[ot bi[hz
硬要麻雀生鵝蛋	yk[eh yc[xn ma[ga qt[xv ug[pf ee[pn dj[pi
蠅子見了血	yk[ik zi[lh jm[ke le[vu xt[pm
永不回頭	ys[dv bu[eu hv[wk tz[dd
又長又臭	yz[vd ih[ph yz[vd iz[zq
有吹的了	yz[uo iv[kd de[bb le[vu
又刺又痛	yz[vd ci[cd yz[vd ts[bs
有點五葷六素	yz[uo dm[bd wu[hu hy[ci lq[wb su[fy
有點硬功夫	yz[uo dm[bd yk[eh gs[gl fu[er
有點自大	yz[uo dm[bd zi[pm da[hr
有肚量	yz[uo du[ot ll[oh
又毒又辣	yz[vd du[fm yz[vd la[lh
又惡又蠢	yz[vd ee[hx yz[vd iy[si
又高又貴	yz[vd gc[wk yz[vd gv[vb
有根有據	yz[uo gf[ag yz[uo ju[fu
有功之臣	yz[uo gs[gl vi[dv if[ku
有貨倒不出	yz[uo ho[rb dc[rh bu[eu iu[ck
有假無真	yz[uo jx[rk wu[ee vf[uj
有勁使不上	yz[uo jb[sl ui[rh bu[eu uh[bh
有來有往	yz[uo ld[hm yz[uo wh[rd
有了把柄	yz[uo le[vu ba[fb bk[ah
有力無處使	yz[uo li[vp wu[ee iu[wb ui[rh
有命沒毛	yz[uo mk[rh mw[dj mc[sv
有你不多沒你不少	yz[uo ni[rd bu[eu do[xx mw[dj ni[rd bu[eu uc[xp
有去無回	yz[uo qu[ts wu[ee hv[wk
由人擺佈	yz[ou rf[pd bd[fs bu[uj
有日子的人了	yz[uo ri[wh zi[lh de[bb rf[pd le[vu
有聲有色	yz[uo ug[um yz[uo se[db
又屬百靈鳥又屬袋鼠	yz[vd uu[up bd[eo lk[xh nn[nh yz[vd uu[up dd[ry uu[jv
有無地之別	yz[uo wu[ee di[ty vi[dv bp[kd
有眼不識泰山	yz[uo yj[mg bu[eu ui[yk td[su uj[uk
有眼無珠	yz[uo yj[mg wu[ee vu[wp
有言在先	yz[uo yj[we zd[ut xm[ne
有也不多	yz[uo ye[vu bu[eu do[xx
有用是親無用是仇	yz[uo ys[ou ui[op qb[la wu[ee ys[ou ui[op iz[rj
玉皇大帝拜財神一有錢大三輩	yu[wd hl[bw da[hr di[lj bd[fh cd[bc uf[uo yi[hh yz[uo qm[jj da[hr sj[hh bw[fi
魚簍裡的螃蟹	yu[dt lz[vm li[ot de[bb ph[il xp[di
魚盆裡的螃蟹	yu[dt pf[fm li[ot de[bb ph[il xp[di
遇上了好人	yu[oz uh[bh le[vu hc[nz rf[pd
漁網當傘	yu[dy wh[ki dh[xx sj[rb
與我無關	yu[hv wo[pf wu[ee gr[bt
雨夜打燈籠	yu[hk ye[wr da[fd dg[hd ls[vy
與眾不同	yu[hv vs[rr bu[eu ts[kh
遠處有燈	yr[ez iu[wb yz[uo dg[hd
袁世凱當皇帝	yr[tk ui[nv kd[uj dh[xx hl[bw di[lj
冤枉死人	yr[gd wh[aw si[hx rf[pd
圓珠筆蘸墨水一多事	yr[wk vu[wp bi[vm vj[cy mo[ht uv[uu yi[hh do[xx ui[hk
圓桌會議	yr[wk vo[ba hv[re yi[yd
遠走高飛	yr[ez zz[tv gc[wk fw[vp
越吃越糟	yt[zh ii[kr yt[zh zc[mh
越打越下	yt[zh da[fd yt[zh xx[hb
越彈越亂	yt[zh dj[gb yt[zh lr[qv
越管越光	yt[zh gr[vg yt[zh gl[xe
越來越凶	yt[zh ld[hm yt[zh xs[ik
月亮當鏡子	yt[ke ll[wj dh[xx jk[jl zi[lh
月亮下看書	yt[ke ll[wj xx[hb kj[fm uu[vv
越摸越翹	yt[zh mo[fc yt[zh qn[qx
越鬧越臭	yt[zh nc[mw yt[zh iz[zq
越弄越糟	yt[zh ns[wc yt[zh zc[mh
越數越少	yt[zh uu[mw yt[zh uc[xp
越掏越臭	yt[zh tc[fb yt[zh iz[zq
越小越凶	yt[zh xn[ub yt[zh xs[ik
越選越差	yt[zh xr[nz yt[zh ia[yg
雲裡張口袋	yy[es li[ot vh[gi kz[uv dd[ry
雲南老虎蒙古駱駝	yy[es nj[uk lc[tb hu[hj mg[ch gu[uk lo[mw to[mg
砸鍋賣鐵	za[ek go[jk md[ud tp[jp
雜貨鋪卸貨	za[ja ho[rb pu[jf xp[we ho[rb
雜種	za[ja vs[hv
宰個鴿鴿也要請屠夫提刀	zd[gl ge[ru ge[rn ge[rn ye[vu yc[xn qk[yf tu[ut fu[er ti[fo dc[vp
在劫難逃	zd[ut jp[tl nj[yv tc[vz
宰相的千金皇帝的女	zd[gl xl[am de[bb qm[pu jb[rw hl[bw di[lj de[bb nv[vp
再也洗不清	zd[hk ye[vu xi[dn bu[eu qk[df
再吟詩也跑不脫	zd[hk yb[kr ui[yt ye[vu pc[zb bu[eu to[ob
髒水罐子掉到茅坑裡	zh[og uv[uu gr[wc zi[lh dn[fb dc[hd mc[cy kg[tw li[ot
早春的桃花	zc[ou iy[so de[bb tc[av hx[cr
棗核兒解板	zc[cd he[aw er[pv jp[dd bj[ap
遭驢拉重協	zc[hz lv[mh la[fl vs[ph xp[ul
灶門前拿竹筒	zc[ht mf[du qm[bo na[rf vu[rr ts[vk
棗木做燒柴	zc[cd mu[ub zo[rg uc[hq id[va
早晚要飛	zc[ou wj[od yc[xn fw[vp
早晚要炸	zc[ou wj[od yc[xn va[hv
灶王爺上尺	zc[ht wh[su ye[be uh[bh ii[ud
灶王爺貼在腿肚上	zc[ht wh[su ye[be tp[bb zd[ut tv[og du[ot uh[bh
賊過才張弓	zw[bg go[cz cd[hu vh[gi gs[kv
賊頭賊腦	zw[bg tz[dd zw[bg nc[ow
賊娃子拾東西	zw[bg wa[nt zi[lh ui[fr ds[qx xi[hk
扎不下根	va[fv bu[eu xx[hb gf[ag
蚱蜢碰上雞	va[iv mg[iz pg[eb uh[bh ji[yn
紮實	va[fv ui[gd
齋公吃羊肉	vd[we gs[bs ii[kr yh[bs rz[kr
債主找到了負債的	vd[rf vu[dw vc[fg dc[hd le[vu fu[db vd[rf de[bb
站不穩	vj[lb bu[eu wf[hd
斬草不除根	vj[ij cc[co bu[eu iu[er gf[ag
粘豆粥糊鍋	vj[mb dz[hk vz[gm hu[mg go[jk
沾光	vj[db gl[xe
粘米煮山芋	vj[mb mi[ba vu[td uj[uk yu[ce
沾你的光了	vj[db ni[rd de[bb gl[xe le[vu
粘牙的燒餅	vj[mb ya[hv de[bb uc[hq bk[ub
站在岸邊看翻船	vj[lb zd[ut an[ui bm[lz kj[fm fj[px ir[vj
站在海邊打咳聲	vj[lb zd[ut hd[dr bm[lz da[fd ke[kw ug[um
站在河岸撈月亮	vj[lb zd[ut he[dk an[ui lc[fc yt[ke ll[wj
沾沾自喜	vj[db vj[db zi[pm xi[uk
站著身子正	vj[lb ve[ym uf[pu zi[lh vg[hv
戰爭販子唱和平	vj[bg vg[dx fj[bp zi[lh ih[ko he[hk pk[hb
張飛擺屠案	vh[gi fw[vp bd[fs tu[ut an[ga
張飛的媽媽	vh[gi fw[vp de[bb ma[nm ma[nm
張果老騎驢	vh[gi go[oa lc[tb qi[md lv[mh
長了兔子腿	vh[ph le[vu tu[dk zi[lh tv[og
張驢兒上公堂	vh[gi lv[mh er[pv uh[bh gs[bs th[xt
丈母孃跺腳	vh[hi mu[vv nl[nl do[zj jn[ot
張生回頭望鶯鶯	vh[gi ug[pf hv[wk tz[dd wh[ww yk[cn yk[cn
張天師得了啞病	vh[gi tm[hd ui[uh de[ro le[vu ya[kh bk[bh
張天師畫符	vh[gi tm[hd ui[uh hx[ht fu[vr
張勳復辟	vh[gi xy[kl fu[ro bi[ul
找錯了人	vc[fg co[jg le[vu rf[pd
趙匡胤穿龍袍	vc[zi kl[kw yb[py ir[xy ls[yp pc[yb
照明彈上天	vc[od mk[oo dj[gb uh[bh tm[hd
找死	vc[fg si[hx
趙雲大戰長板坡	vc[zi yy[es da[hr vj[bg ih[ph bj[ap po[tp
照住屁股蹬一腳	vc[od vu[rd pi[ub gu[oj dg[zd yi[hh jn[ot
這把骨頭不知往哪	ve[wz ba[fb gu[ko tz[dd bu[eu vi[uk wh[rd na[kv
遮不住陽光	ve[gz bu[eu vu[rd yh[eo gl[xe
這山看著那山高	ve[wz uj[uk kj[fm ve[ym na[ve uj[uk gc[wk
砧板上的魚	vf[eb bj[ap uh[bh de[bb yu[dt
偵察員破案	vf[rb ia[gx yr[kb po[ep an[ga
針鋒相對	vf[ju fg[jw xl[am dv[yc
真好	vf[uj hc[nz
真靈	vf[uj lk[xh
針挑黃連	vf[ju tn[fv hl[gy lm[iz
真相大白	vf[uj xl[am da[hr bd[po
枕著扁擔睡覺	vf[ag ve[ym bm[hk dj[fo uv[mi jn[xj
正大光明	vg[hv da[hr gl[xe mk[oo
正合適	vg[hv he[rh ui[qz
整筐丟西瓜	vg[hh kl[vk dq[pt xi[hk gx[ps
正是時候	vg[hv ui[op ui[oc hz[ru
睜眼瞎看告示	vg[md yj[mg xx[mg kj[fm gc[nk ui[ex
睜隻眼閉隻眼	vg[md vi[kb yj[mg bi[mc vi[kb yj[mg
直尺量曲線	vi[uj ii[ud ll[oh qu[ou xm[sj
知道遲到了	vi[uk dc[bz ii[uz dc[hd le[vu
知道你是哪塊地裡有呢	vi[uk dc[bz ni[rd ui[op na[kv kk[tv di[ty li[ot yz[uo ne[ku
趾高氣揚	vi[zv gc[wk qi[rh yh[fv
紙糊的老虎	vi[su hu[mg de[bb lc[tb hu[hj
只可遠看不能近瞧	vi[kb ke[dk yr[ez kj[fm bu[eu ng[sb jb[jz qn[mv
肢皮人烤火	vi[ou pi[vp rf[pd kc[ht ho[dp
只說不練的把式	vi[kb uo[yb bu[eu lm[sq de[bb ba[fb ui[qg
只圖表面好看	vi[kb tu[ww bn[fy mm[ew hc[nz kj[fm
只圖眼前快活	vi[kb tu[ww yj[mg qm[bo kk[xv ho[dq
指望不上	vi[fb wh[ww bu[eu uh[bh
直性子對直性子	vi[uj xk[xp zi[lh dv[yc vi[uj xk[xp zi[lh
只有三年	vi[kb yz[uo sj[hh nm[rn
只有一個心眼	vi[kb yz[uo yi[hh ge[ru xb[dv yj[mg
指著禿子罵和尚	vi[fb ve[ym tu[hj zi[lh ma[km he[hk uh[xk
置之不理	vi[su vi[dv bu[eu li[wo
周瑜打黃蓋	vz[kt yu[wr da[fd hl[gy gd[bm
皺皺巴巴的	vz[dp vz[dp ba[ku ba[ku de[bb
主次不分	vu[dw ci[dd bu[eu ff[bd
諸葛亮弔孝	vu[yt ge[co ll[wj dn[kj xn[tz
諸葛亮三氣周瑜	vu[yt ge[co ll[wj sj[hh qi[rh vz[kt yu[wr
諸葛亮用空城計	vu[yt ge[co ll[wj ys[ou ks[xg ig[tw ji[yu
煮熟的鴨子飛上天	vu[td uu[wd de[bb ya[on zi[lh fw[vp uh[bh tm[hd
抓小辮子	vx[fp xn[ub bm[ls zi[lh
抓住了關鍵	vx[fp vu[rd le[vu gr[bt jm[jy
拽著樹葉打滴溜	vk[fo ve[ym uu[ay ye[ku da[fd di[dl lq[dp
裝百子	vl[dy bd[eo zi[lh
裝瘋	vl[dy fg[bf
裝滑頭	vl[dy hx[dg tz[dd
裝模作樣	vl[dy mo[ac zo[rv yh[ay
裝什麼蒜	vl[dy uf[ru me[ps sr[ce
裝相	vl[dy xl[am
裝樣	vl[dy yh[ay
追查到底	vv[pz ia[ao dc[hd di[gu
桌子縫裡舔芝麻	vo[ba zi[lh fg[sw li[ot tm[qt vi[cv ma[ga
桌子上唱大戲	vo[ba zi[lh uh[bh ih[ko da[hr xi[yg
自暴自棄	zi[pm bc[og zi[pm qi[wc
自吹	zi[pm iv[kd
自大	zi[pm da[hr
自焚	zi[pm ff[ah
自顧不暇	zi[pm gu[iy bu[eu xx[ok
自己跟自己過不去	zi[pm ji[kv gf[zg zi[pm ji[kv go[cz bu[eu qu[ts
自己嚇唬自己	zi[pm ji[kv xx[kx hu[kh zi[pm ji[kv
自來紅	zi[pm ld[hm hs[sg
自鳴得意	zi[pm mk[kn de[ro yi[lx
自騎自誇	zi[pm qi[md zi[pm kx[dh
自身難保	zi[pm uf[pu nj[yv bc[rk
自討苦吃	zi[pm tc[yc ku[cg ii[kr
自我膨脹	zi[pm wo[pf pg[ou vh[oi
自我推銷	zi[pm wo[pf tv[fv xn[jx
自找苦吃	zi[pm vc[fg ku[cg ii[kr
自找麻煩	zi[pm vc[fg ma[ga fj[hy
自找難看	zi[pm vc[fg nj[yv kj[fm
總有一別	zs[bx yz[uo yi[hh bp[kd
走不動	zz[tv bu[eu ds[el
走不通	zz[tv bu[eu ts[sz
走錯了門	zz[tv co[jg le[vu mf[du
走到哪兒於到哪兒	zz[tv dc[hd na[kv er[pv yu[eu dc[hd na[kv er[pv
走的是一個方向	zz[tv de[bb ui[op yi[hh ge[ru fh[dw xl[pk
走對了路子	zz[tv dv[yc le[vu lu[zw zi[lh
走路算賬	zz[tv lu[zw sr[vm vh[bi
走投無路	zz[tv tz[fj wu[ee lu[zw
鑽不進	zr[jb bu[eu jb[ez
鑽進鳥籠裡的貓	zr[jb jb[ez nn[nh ls[vy li[ot de[bb mc[qc
鑽子頭上加鋼針	zr[jb zi[lh tz[dd uh[bh jx[lk gh[jk vf[ju
嘴饞上了當	zv[kv ij[ud uh[bh le[vu dh[xx
醉漢過鐵索橋	zv[yw hj[dy go[cz tp[jp so[uy qn[ap
醉翁之意不在酒	zv[yw wg[bx vi[dv yi[lx bu[eu zd[ut jq[dy
坐不穩	zo[rr bu[eu wf[hd
坐不住	zo[rr bu[eu vu[rd
坐等	zo[rr dg[vt
作用不全	zo[rv ys[ou bu[eu qr[rw
左右為難	zo[ug yz[uk ww[dl nj[yv
