阿爾尼	aa[ek er[dx ni[ub
阿凡提妻	aa[ek fj[jd ti[fo qi[hn
阿濟赤	aa[ek ji[dw ii[ty
阿泉	aa[ek qr[bu
哀牢山三十六劍	ai[wk lc[gn uj[uk sj[hh ui[hu lq[wb jm[rd
矮老者	ai[uh lc[tb ve[to
安大娘	an[gn da[hr nl[nl
安奉日	an[gn fg[sf ri[wh
安健剛	an[gn jm[ry gh[kd
安劍清	an[gn jm[rd qk[df
黯然銷魂掌	an[hl rj[xd xn[jx hy[eg vh[xf
暗噬菌	an[ol ui[kv jy[cw
安提督	an[gn ti[fo du[um
安小慧	an[gn xn[ub hv[fx
敖彪	ao[fw bn[hp
獒口奪杖	ao[fq kz[uv do[dc vh[ah
八方歸元	ba[pd fh[dw gv[ux yr[ee
八卦金刀	ba[pd gx[tb jb[rw dc[vp
八卦門	ba[pd gx[tb mf[du
八卦游龍掌	ba[pd gx[tb yz[df ls[yp vh[xf
八卦遊身掌	ba[pd gx[tb yz[df uf[pu vh[xf
八極門	ba[pd ji[aj mf[du
八極拳	ba[pd ji[aj qr[bf
八口山銘	ba[pd kz[uv uj[uk mk[jx
巴郎星	ba[ku lh[le xk[op
八十一路三節棍	ba[pd ui[hu yi[hh lu[zw sj[hh jp[ce gy[ao
八十一路五虎刀	ba[pd ui[hu yi[hh lu[zw wu[hu hu[hj dc[vp
巴泰	ba[ku td[su
八仙劍法	ba[pd xm[ru jm[rd fa[dt
巴顏法師	ba[ku yj[ly fa[dt ui[uh
八陣八卦掌	ba[pd vf[ei ba[pd gx[tb vh[xf
白阿繡	bd[po aa[ek xq[sh
白二	bd[po er[hh
白龜壽	bd[po gv[do uz[fc
白寒楓	bd[po hj[gd fg[af
白寒松	bd[po hj[gd ss[ab
白虎跳澗	bd[po hu[hj tn[zv jm[dm
百花錯拳	bd[eo hx[cr co[jg qr[bf
白臉人	bd[po lm[or rf[pd
白馬嘯西風	bd[po ma[vv xn[kx xi[hk fg[ji
白蟒鞭	bd[po mh[ic bm[gr
白眉上人	bd[po mw[mm uh[bh rf[pd
百魔堂	bd[eo mo[gg th[xt
百年煉獄	bd[eo nm[rn lm[hq yu[qy
白少堂	bd[po uc[xp th[xt
百勝軟鞭	bd[eo ug[op rr[id bm[gr
白世鏡	bd[po ui[nv jk[jl
白駝雪山掌	bd[po to[mg xt[yx uj[uk vh[xf
白萬劍	bd[po wj[hv jm[rd
白玉京	bd[po yu[wd jk[wk
白玉魔丐	bd[po yu[wd mo[gg gd[xv
白雲出岫	bd[po yy[es iu[ck xq[uy
百丈飛瀑	bd[eo vh[hi fw[vp pu[do
白振	bd[po vf[fi
白自在	bd[po zi[pm zd[ut
班淑嫻	bj[wd uu[du xm[nm
棒打狗頭	bh[as da[fd gz[qb tz[dd
棒打雙犬	bh[as da[fd ul[yy qr[dd
傍花拂柳	bh[rl hx[cr fu[ff lq[ap
抱殘式	bc[fb cj[hj ui[qg
鮑承先	bc[yb ig[lu xm[ne
鮑大楚	bc[yb da[hr iu[ap
寶靈拳	bc[gw lk[xh qr[bf
鮑千靈	bc[yb qm[pu lk[xh
寶樹	bc[gw uu[ay
暴退	bc[og tv[gz
豹尾腳	bc[pb ww[um jn[ot
寶象和尚	bc[gw xl[dk he[hk uh[xk
暴戰雞	bc[og vj[bg ji[yn
暴戰野豬	bc[og vj[bg ye[oy vu[qt
北斗大陣	bw[ub dz[du da[hr vf[ei
北斗封魔陣	bw[ub dz[du fg[tc mo[gg vf[ei
貝海石	bw[kr hd[dr ui[ek
貝錦儀	bw[kr jb[jb yi[rd
貝人龍	bw[kr rf[pd ls[yp
北漁拓跋氏	bw[ub yu[dy to[fe ba[zu ui[pq
敝幫	bi[bw bh[fj
敝盟	bi[bw mg[om
敝派	bi[bw pd[dp
筆貼式	bi[vm tp[bb ui[qg
辟邪劍法	bi[ul xp[ye jm[rd fa[dt
碧血劍	bi[we xt[pm jm[rd
碧淵騰蛟	bi[we yr[dp tg[ob jn[il
碧針清掌	bi[we vf[ju qk[df vh[xf
變異角鷹	bm[yy yi[kc jn[do yk[gn
賓頭盧尊者	bb[gq tz[dd lu[bu zy[bc ve[to
冰河倒瀉	bk[du he[dk dc[rh xp[dg
冰河開凍	bk[du he[dk kd[hc ds[dq
撥狗朝天	bo[fv gz[qb ic[uo tm[hd
渤海派	bo[du hd[dr pd[dp
波羅密手	bo[dp lo[sx mi[gu uz[su
波羅星	bo[dp lo[sx xk[op
般若掌	bo[vj re[cu vh[xf
撥速臺	bo[fv su[hz td[sk
卜沉	bu[ud if[dg
捕風式	bu[ff fg[ji ui[qg
補鍋匠	bu[yb go[jk jl[kj
不空和尚	bu[eu ks[xg he[hk uh[xk
不平道人	bu[eu pk[hb dc[bz rf[pd
卜泰	bu[ud td[su
不相及	bu[eu xl[am ji[pv
卜鷹	bu[ud yk[gn
卜垣	bu[ud yr[th
蔡德忠	cd[cx de[ru vs[vx
蔡威	cd[cx ww[wh
採燕功	cd[aa yj[nk gs[gl
蔡一瀟	cd[cx yi[hh xn[dc
參合指	cj[sd he[rh vi[fb
殘血使	cj[hj xt[pm ui[rh
藏邊大丑	ch[cw bm[lz da[hr iz[vu
藏邊二醜	ch[cw bm[lz er[hh iz[vu
藏邊三醜	ch[cw bm[lz sj[hh iz[vu
藏邊四醜	ch[cw bm[lz si[we iz[vu
藏邊五醜	ch[cw bm[lz wu[hu iz[vu
藏刀式	ch[cw dc[vp ui[qg
蒼龍天君	ch[cr ls[yp tm[hd jy[xk
蒼松迎客	ch[cr ss[ab yk[pz ke[gw
曹化淳	cc[ho hx[rq iy[dw
曹令割鼻	cc[ho lk[rd ge[gd bi[zt
曹猛	cc[ho mg[qz
曹能	cc[ho ng[sb
曹司朋	cc[ho si[vh pg[oo
曹雲奇	cc[ho yy[es qi[dk
岑其斯	cf[ur qi[cb si[qj
曾柔	cg[bo rz[ya
曾鐵鷗	cg[bo tp[jp ou[kn
察爾珠	ia[gx er[dx vu[wp
察罕特穆爾	ia[gx hj[gg te[nt mu[hb er[dx
查繼左	ia[ao ji[sm zo[ug
柴刀十八路	id[va dc[vp ui[hu ba[pd lu[zw
纏絲擒拿手	ij[sg si[sh qb[fr na[rf uz[su
長安一戰	ih[ph an[gn yi[hh vj[bg
長臂羅漢	ih[ph bi[uo lo[sx hj[dy
常伯志	ih[xk bo[rb vi[ux
常長風	ih[xk ih[ph fg[ji
常赫志	ih[xk he[tt vi[ux
常金鵬	ih[xk jb[rw pg[on
常敬之	ih[xk jk[cw vi[dv
常漫天	ih[xk mj[do tm[hd
昌齊	ih[oo qi[wp
長青子	ih[ph qk[fo zi[lh
長拳十段錦	ih[ph qr[bf ui[hu dr[pj jb[jb
常山蛇勢	ih[xk uj[uk ue[ig ui[fl
常勝寶樹王	ih[xk ug[op bc[gw uu[ay wh[su
長葦渡江	ih[ph ww[cw du[dg jl[dg
長嘯雁落	ih[ph xn[kx yj[ir lo[cd
超級兲粉	ic[zd ji[sj tm[wb ff[mf
朝天一棍	ic[uo tm[hd yi[hh gy[ao
車爾庫	ie[qu er[dx ku[gi
陳沖之	if[eq is[dv vi[dv
陳大方	if[eq da[hr fh[dw
陳達海	if[eq da[dz hd[dr
陳高波	if[eq gc[wk bo[dp
陳近南	if[eq jb[jz nj[uk
陳老丐	if[eq lc[tb gd[xv
陳七	if[eq qi[hv
陳歪嘴	if[eq wd[bh zv[kv
陳玄風	if[eq xr[wy fg[ji
陳正德	if[eq vg[hv de[ru
成不憂	ig[wv bu[eu yz[xy
成高道人	ig[wv gc[wk dc[bz rf[pd
程管家	ig[hk gr[vg jx[gu
澄光	ig[dd gl[xe
成璜	ig[wv hl[wg
成昆	ig[wv ky[ob
程青竹	ig[hk qk[fo vu[rr
澄識	ig[dd ui[yk
程壇主	ig[hk tj[te vu[dw
澄通	ig[dd ts[sz
程維藩	ig[hk ww[sv fj[cd
程遙迦	ig[hk yc[az jx[lz
程瑤迦	ig[hk yc[wa jx[lz
程瑛	ig[hk yk[wc
城字十八破	ig[tw zi[gz ui[hu ba[pd po[ep
成自學	ig[wv zi[pm xt[xz
遲百誠	ii[uz bd[eo ig[yw
池邊調鶴	ii[dy bm[lz tn[yk he[gn
赤尻連拳	ii[ty kc[uj lm[iz qr[bf
遲玄	ii[uz xr[wy
熾翼千羽	ii[hk yi[xt qm[pu yu[xx
赤月血祭	ii[ty yt[ke xt[pm ji[xe
赤月血魔劍	ii[ty yt[ke xt[pm mo[gg jm[rd
沖虛道長	is[dv xu[hy dc[bz vh[ph
醜臉漢子	iz[vu lm[or hj[dy zi[lh
仇松年	iz[rj ss[ab nm[rn
初固	iu[yd gu[wg
楚江王	iu[ap jl[dg wh[su
楚留香	iu[ap lq[pt xl[ho
楚惜刀	iu[ap xi[xg dc[vp
出指	iu[ck vi[fb
川西高原	ir[pu xi[hk gc[wk yr[ib
闖少林	il[mm uc[xp lb[aa
春蠶掌法	iy[so cj[ti vh[xf fa[dt
純武俠	iy[st wu[hv xx[rj
純陽無極功	iy[st yh[eo wu[ee ji[aj gs[gl
春雲乍展	iy[so yy[es va[ru vj[ug
慈悲刀	ci[bx bw[fx dc[vp
次生茶葉	ci[dd ug[pf ia[cr ye[ku
次生大蒜	ci[dd ug[pf da[hr sr[ce
叢不棄	cs[rh bu[eu qi[wc
崔百勝	cv[uv bd[eo ug[op
崔鏢頭	cv[uv bn[jx tz[dd
催稿	cv[ru gc[hw
崔秋山	cv[uv qq[hh uj[uk
崔希敏	cv[uv xi[iu mb[rw
崔瞎子	cv[uv xx[mg zi[lh
崔志方	cv[uv vi[ux fh[dw
大半夜	da[hr bj[bf ye[wr
大悲老人	da[hr bw[fx lc[tb rf[pd
大乘期	da[hr ig[qb qi[qo
大痴	da[hr ii[bu
大癲	da[hr dm[bu
達爾巴	da[dz er[dx ba[ku
大風堂主	da[hr fg[ji th[xt vu[dw
大風雲飛掌	da[hr fg[ji yy[es fw[vp vh[xf
大伏魔拳法	da[hr fu[rq mo[gg qr[bf fa[dt
打狗入洞	da[fd gz[qb ru[pd ds[dk
大海沉沙	da[hr hd[dr if[dg ua[dx
大幻星宗宗主	da[hr hr[yv xk[op zs[ge zs[ge vu[dw
大金剛拳	da[hr jb[rw gh[kd qr[bf
大金剛掌	da[hr jb[rw gh[kd vh[xf
大力鷹爪功	da[hr li[vp yk[gn vc[pu gs[gl
大漠飛沙	da[hr mo[dc fw[vp ua[dx
達魔劍	da[dz mo[gg jm[rd
達摩劍法	da[dz mo[gf jm[rd fa[dt
達摩劍術	da[dz mo[gf jm[rd uu[ad
大漠平沙	da[hr mo[dc pk[hb ua[dx
達摩掌	da[dz mo[gf vh[xf
大擒拿手	da[hr qb[fr na[rf uz[su
大摔碑手	da[hr uk[fw bw[eb uz[su
大嵩陽神掌	da[hr ss[uw yh[eo uf[uo vh[xf
大鐵槍	da[hr tp[jp ql[ar
達娃卓瑪	da[dz wa[nt vo[bo ma[wm
大韋陀杵	da[hr ww[hh to[eg iu[aw
大俠傳奇	da[hr xx[rj ir[re qi[dk
大新君	da[hr xb[lj jy[xk
大洋同盟等	da[hr yh[dy ts[kh mg[om dg[vt
大夜叉棍	da[hr ye[wr ia[yd gy[ao
大英雄	da[hr yk[ck xs[uv
大智無定指	da[hr vi[uo wu[ee dk[gp vi[fb
戴獨行	dd[tt du[qi xk[rh
戴永明	dd[tt ys[dv mk[oo
岱宗如何	dd[ru zs[ge ru[nk he[rk
單鞭	dj[bo bm[gr
單伯山	dj[bo bo[rb uj[uk
單季山	dj[bo ji[hz uj[uk
丹青生	dj[kw qk[fo ug[pf
丹丘子	dj[kw qq[jh zi[lh
丹術	dj[kw uu[ad
單叔山	dj[bo uu[uy uj[uk
單鐵生	dj[bo tp[jp ug[pf
單小山	dj[bo xn[ub uj[uk
當代道宗	dh[xx dd[rq dc[bz zs[ge
刀巴記	dc[vp ba[ku ji[yk
刀叢裡的詩	dc[vp cs[rh li[ot de[bb ui[yt
刀帝傳	dc[vp di[lj ir[re
到江吳地盡	dc[hd jl[dg wu[kt di[ty jb[ud
道派	dc[bz pd[dp
倒提金鐘	dc[rh ti[fo jb[rw vs[jv
搗虛式	dc[fn xu[hy ui[qg
德布	de[ru bu[uj
德鄂	de[ru ee[ke
鄧八公	dg[ye ba[pd gs[bs
鄧炳春	dg[ye bk[hh iy[so
登嵩望月	dg[dd ss[uw wh[ww yt[ke
狄鏢頭	di[qh bn[jx tz[dd
地火功	di[ty ho[dp gs[gl
地裂術	di[ty lp[hy uu[ad
狄青降龍	di[qh qk[fo xl[ew ls[yp
諦融	di[yl rs[hi
地堂刀法	di[ty th[xt dc[vp fa[dt
狄修	di[qh xq[ru
羝羊觸蕃	di[yu yh[bs iu[di fj[cp
地藏頌經	di[ty zh[cw ss[by jk[ss
店伴	dm[gb bj[rb
點蒼劍法	dm[bd ch[cr jm[rd fa[dt
點蒼派	dm[bd ch[cr pd[dp
點蒼漁隱	dm[bd ch[cr yu[dy yb[ed
電母照鏡	dm[ov mu[vv vc[od jk[jl
碘鹽水	dm[ed yj[tm uv[uu
弔客臨門	dn[kj ke[gw lb[uv mf[du
疊翠浮青	dp[yq cv[xw fu[da qk[fo
蝶花盟	dp[in hx[cr mg[om
丁不三	dk[hu bu[eu sj[hh
丁不四	dk[hu bu[eu si[we
丁大全	dk[hu da[hr qr[rw
丁璫	dk[hu dh[wx
丁典	dk[hu dm[kb
丁堅	dk[hu jm[ut
定靜師太	dk[gp jk[fd ui[uh td[dd
丁靈琳	dk[hu lk[xh lb[wa
丁敏尹	dk[hu mb[rw yb[xp
定判生死	dk[gp pj[bd ug[pf si[hx
丁麒	dk[hu qi[gq
丁青青	dk[hu qk[fo qk[fo
丁鐵幹	dk[hu tp[jp gj[hu
丁同	dk[hu ts[kh
丁喜	dk[hu xi[uk
定陽針	dk[gp yh[eo vf[ju
定逸	dk[gp yi[dz
丁遊	dk[hu yz[df
東方玄穹	ds[qx fh[dw xr[wy qs[xg
董開山	ds[cp kd[hc uj[uk
洞虛	ds[dk xu[hy
洞玄	ds[dk xr[wy
都大錦	dz[te da[hr jb[jb
都史	dz[te ui[ki
斗轉星移	dz[du vr[ie xk[op yi[hx
杜百當	du[at bd[eo dh[xx
獨臂刀法	du[qi bi[uo dc[vp fa[dt
渡厄	du[dg ee[ie
獨孤九劍	du[qi gu[zp jq[pv jm[rd
渡劫	du[dg jp[tl
杜立德	du[at li[lh de[ru
毒龍鞭法	du[fm ls[yp bm[gr fa[dt
渡難	du[dg nj[yv
杜慶田	du[at qk[gd tm[wu
都市王	du[te ui[wj wh[su
杜希孟	du[at xi[iu mg[zm
獨陽子	du[qi yh[eo zi[lh
杜長老	du[at vh[ph lc[tb
端木氏赤焰洞	dr[lu mu[ub ui[pq ii[ty yj[hd ds[dk
對喀納	dv[yc ka[kg na[sk
遁甲宗	dy[pz jx[ou zs[ge
多隆	do[xx ls[ew
多羅葉指	do[xx lo[sx ye[ku vi[fb
奪命連環三仙劍	do[dc mk[rh lm[iz hr[wb sj[hh xm[ru jm[rd
奪魄指	do[dc po[bg vi[fb
鄂北鬼見愁鍾家	ee[ke bw[ub gv[be jm[ke iz[hx vs[jp jx[gu
惡虎攔路	ee[hx hu[hj lj[fb lu[zw
峨嵋劍法	ee[up mw[um jm[rd fa[dt
峨嵋九陽功	ee[up mw[um jq[pv yh[eo gs[gl
惡魔火神劍	ee[hx mo[gg ho[dp uf[uo jm[rd
惡犬攔路	ee[hx qr[dd lj[fb lu[zw
爾國臨格	er[dx go[ww lb[uv ge[aw
範幫主	fj[cd bh[fj vu[dw
梵光初現	fj[aj gl[xe iu[yd xm[wj
反截狗臀	fj[py jp[tv gz[qb ty[uo
飯來伸手	fj[up ld[hm uf[ro uz[su
反兩儀刀法	fj[py ll[hk yi[rd dc[vp fa[dt
範遙	fj[cd yc[az
範一飛	fj[cd yi[hh fw[vp
樊一翁	fj[ad yi[hh wg[bx
範禹	fj[cd yu[pk
範中恩	fj[cd vs[ku en[wx
翻轉乾坤	fj[px vr[ie qm[ur ky[to
方寶玉	fh[dw bc[gw yu[wd
方大洪	fh[dw da[hr hs[dg
方東白	fh[dw ds[qx bd[po
方人智	fh[dw rf[pd vi[uo
方有德	fh[dw yz[uo de[ru
方玉飛	fh[dw yu[wd fw[vp
方證	fh[dw vg[yh
飛鳳手	fw[vp fg[jy uz[su
斐螋	fw[fw sz[ij
飛天神行	fw[vp tm[hd uf[uo xk[rh
飛絮勁	fw[vp xu[ny jb[sl
飛燕穿柳	fw[vp yj[nk ir[xy lq[ap
飛燕迴翔	fw[vp yj[nk hv[wk xl[yx
費要多羅	fw[fb yc[xn do[xx lo[sx
斐蜮族	fw[fw yu[ig zu[fr
飛雲真人	fw[vp yy[es vf[uj rf[pd
風爆	fg[ji bc[ho
馮不摧	fg[dm bu[eu cv[fu
封不平	fg[tc bu[eu pk[hb
馮不破	fg[dm bu[eu po[ep
鳳飛煙	fg[jy fw[vp yj[hw
馮衡	fg[dm hg[rd
風際中	fg[ji ji[ee vs[ku
風捲長草	fg[ji jr[be vh[ph cc[co
風良	fg[ji ll[dg
馮默風	fg[dm mo[hq fg[ji
瘋魔杖法	fg[bf mo[gg vh[ah fa[dt
馮難敵	fg[dm nj[yv di[qw
鳳南天	fg[jy nj[uk tm[hd
鳳曲長鳴	fg[jy qu[ou ih[ph mk[kn
風沙莽莽	fg[ji ua[dx mh[cq mh[cq
風四娘	fg[ji si[we nl[nl
馮坦	fg[dm tj[to
封壇主	fg[tc tj[te vu[dw
馮同知	fg[dm ts[kh vi[uk
封萬里	fg[tc wj[hv li[ot
風無羈	fg[ji wu[ee ji[sg
風系道術	fg[ji xi[py dc[bz uu[ad
鳳一鳴	fg[jy yi[hh mk[kn
封緣銀城	fg[tc yr[sv yb[jg ig[tw
風雲三使	fg[ji yy[es sj[hh ui[rh
馮振武	fg[dm vf[fi wu[hv
佛域	fo[rf yu[tg
佛宗特使	fo[rf zs[ge te[nt ui[rh
傅嫦雪	fu[rf ih[nx xt[yx
拂塵拂法	fu[ff if[xt fu[ff fa[dt
伏虎掌	fu[rq hu[hj vh[xf
伏魔劍	fu[rq mo[gg jm[rd
伏魔杖法	fu[rq mo[gg vh[ah fa[dt
伏牛派	fu[rq nq[pf pd[dp
夫妻刀法	fu[er qi[hn dc[vp fa[dt
撫琴按簫	fu[fe qb[wr an[fg xn[vx
撫琴式	fu[fe qb[wr ui[qg
浮丘挹袖	fu[da qq[jh yi[fk xq[yy
芙蓉劍法	fu[ce rs[cx jm[rd fa[dt
芙蓉金針	fu[ce rs[cx jb[rw vf[ju
伏獅勝象	fu[rq ui[qu ug[op xl[dk
負手	fu[db uz[su
扶搖子	fu[fe yc[fa zi[lh
福緣深厚	fu[uh yr[sv uf[dg hz[io
負子渡河	fu[db zi[lh du[dg he[dk
蓋運聰	gd[bm yy[ez cs[eb
罡風撼蕩	gh[sh fg[ji hj[fw dh[cd
罡風掃葉	gh[sh fg[ji sc[fx ye[ku
剛相	gh[kd xl[am
高管家	gc[wk gr[vg jx[gu
高冠勇	gc[wk gr[ge ys[sl
高冠忠	gc[wk gr[ge vs[vx
高漸飛	gc[wk jm[di fw[vp
高克新	gc[wk ke[ge xb[lj
高老大	gc[wk lc[tb da[hr
高老者	gc[wk lc[tb ve[to
高裡津	gc[wk li[ot jb[dy
高明根	gc[wk mk[oo gf[ag
高三娘子	gc[wk sj[hh nl[nl zi[lh
高師弟	gc[wk ui[uh di[bg
高太君	gc[wk td[dd jy[xk
高探馬	gc[wk tj[fg ma[vv
高亞南	gc[wk ya[hy nj[uk
高顏超	gc[wk yj[ly ic[zd
葛爾丹	ge[co er[dx dj[kw
葛通	ge[co ts[sz
葛長老	ge[co vh[ph lc[tb
庚金天君	gg[gx jb[rw tm[hd jy[xk
耿天霜	gg[eh tm[hd ul[ya
耿萬鍾	gg[eh wj[hv vs[jv
宮九	gs[gk jq[pv
宮九佳	gs[gk jq[pv jx[rt
宮南頻	gs[gk nj[uk pb[vy
宮南萍	gs[gk nj[uk pk[cd
宮南燕	gs[gk nj[uk yj[nk
公輸瑾	gs[bs uu[ir jb[wn
公輸門	gs[bs uu[ir mf[du
宮素素	gs[gk su[fy su[fy
公孫蘭	gs[bs sy[zx lj[bs
公孫綠萼	gs[bs sy[zx lv[sx ee[ck
宮豔紅	gs[gk yj[fd hs[sg
公子羽	gs[bs zi[lh yu[xx
狗頭陀	gz[qb tz[dd to[eg
鉤弋握拳	gz[jb yi[qd wo[fu qr[bf
古半仙	gu[uk bj[bf xm[ru
古篤誠	gu[uk du[vm ig[yw
顧金標	gu[iy jb[rw bn[ae
古木叢青靄	gu[uk mu[ub cs[rh qk[fo ai[yy
孤萍對月	gu[zp pk[cd dv[yc yt[ke
賈人達	gu[xb rf[pd da[dz
古若般	gu[uk ro[cu bj[vj
鼓瑟式	gu[uu se[wx ui[qg
古士庸	gu[uk ui[uh ys[gx
孤松	gu[zp ss[ab
姑蘇慕容	gu[ng su[cl mu[cx rs[xr
古仙人	gu[uk xm[ru rf[pd
關安基	gr[bt an[gn ji[qt
關衝劍	gr[bt is[dv jm[rd
關明梅	gr[bt mk[oo mw[ar
龜慈王妃	gv[do ci[bx wh[su fw[nk
歸二孃	gv[ux er[hh nl[nl
貴妃回眸	gv[vb fw[nk hv[wk mz[ms
硅晶	gv[et jk[oo
鬼算盤	gv[be sr[vm pj[vm
歸辛樹	gv[ux xb[lu uu[ay
歸鍾	gv[ux vs[jv
郭大路	go[we da[hr lu[zw
郭破虜	go[we po[ep lu[hl
過三拳	go[cz sj[hh qr[bf
郭嵩陽	go[we ss[uw yh[eo
郭嘯天	go[we xn[kx tm[hd
郭玉堂	go[we yu[wd th[xt
國主	go[ww vu[dw
哈赤大師	ha[kr ii[ty da[hr ui[uh
哈合臺	ha[kr he[rh td[sk
蛤蟆功	ha[ir ma[ic gs[gl
哈總管	ha[kr zs[bx gr[vg
海蘭弼	hd[dr lj[bs bi[ge
韓寶駒	hj[uw bc[gw ju[mb
寒冰綿掌	hj[gd bk[du mm[sb vh[xf
寒冰神掌	hj[gd bk[du uf[uo vh[xf
韓春霖	hj[uw iy[so lb[ya
韓老丐	hj[uw lc[tb gd[xv
寒梅劍陣	hj[gd mw[ar jm[rd vf[ei
韓千葉	hj[uw qm[pu ye[ku
寒霜楓	hj[gd ul[ya fg[af
罕貼摩	hj[gg tp[bb mo[gf
韓文衝	hj[uw wf[wi is[dv
韓無垢	hj[uw wu[ee gz[tp
韓小瑩	hj[uw xn[ub yk[cw
寒字家族	hj[gd zi[gz jx[gu zu[fr
郝密	hc[te mi[gu
郝太監	hc[te td[dd jm[um
昊星真人	hc[ot xk[op vf[uj rf[pd
鶴筆翁	he[gn bi[vm wg[bx
赫大通	he[tt da[hr ts[sz
和爾大	he[hk er[dx da[hr
鶴飛九天	he[gn fw[vp jq[pv tm[hd
何紅藥	he[rk hs[sg yc[cs
合巹酒	he[rh jb[lh jq[dy
賀老三	he[lb lc[tb sj[hh
和里布	he[hk li[ot bu[uj
何三七	he[rk sj[hh qi[hv
賀尚書	he[lb uh[xk uu[vv
鶴蛇八打	he[gn ue[ig ba[pd da[fd
河朔立威	he[dk uo[no li[lh ww[wh
何思豪	he[rk si[tx hc[wu
何太沖	he[rk td[dd is[dv
何惕守	he[rk ti[xo uz[gc
何鐵手	he[rk tp[jp uz[su
何望海	he[rk wh[ww hd[dr
鶴翔紫蓋	he[gn xl[yx zi[vy gd[bm
黑白子	hw[sd bd[po zi[lh
黑風雙煞	hw[sd fg[ji ul[yy ua[dd
黑砂掌	hw[sd ua[ex vh[xf
橫拜觀音	hg[ag bd[fh gr[yj yb[lo
恆河入海	hg[xh he[dk ru[pd hd[dr
橫江飛渡	hg[ag jl[dg fw[vp du[dg
恆山劍法	hg[xh uj[uk jm[rd fa[dt
恆山劍陣	hg[xh uj[uk jm[rd vf[ei
衡山五神劍	hg[rd uj[uk wu[hu uf[uo jm[rd
橫雲斷峰	hg[ag yy[es dr[mj fg[uw
恆雲憫天	hg[xh yy[es mb[xm tm[hd
洪安通	hs[dg an[gn ts[sz
洪朝	hs[dg ic[uo
紅電	hs[sg dm[ov
洪凌波	hs[dg lk[dt bo[dp
虹魔嗜血劍	hs[ig mo[gg ui[kt xt[pm jm[rd
紅娘子	hs[sg nl[nl zi[lh
洪七公	hs[dg qi[hv gs[bs
洪人雄	hs[dg rf[pd xs[uv
洪勝海	hs[dg ug[op hd[dr
洪武星雲霄殿	hs[dg wu[hv xk[op yy[es xn[yx dm[uj
洪崖拍肩	hs[dg ya[ui pd[fb jm[ho
紅雲老祖	hs[sg yy[es lc[tb zu[uq
紅雲器齋	hs[sg yy[es qi[kq vd[we
侯飛文	hz[rv fw[vp wf[wi
侯人英	hz[rv rf[pd yk[ck
後山三絕招	hz[pk uj[uk sj[hh jt[sd vc[fd
侯通海	hz[rv ts[sz hd[dr
胡安屏	hu[go an[gn pk[ub
呼巴音	hu[kp ba[ku yb[lo
湖北阮家	hu[dg bw[ub rr[ee jx[gu
胡不愁	hu[go bu[eu iz[hx
胡德第	hu[go de[ru di[vg
忽都虎	hu[bx dz[te hu[hj
胡桂南	hu[go gv[at nj[uk
胡家刀法	hu[go jx[gu dc[vp fa[dt
胡老七	hu[go lc[tb qi[hv
忽倫大虎	hu[bx ly[rr da[hr hu[hj
忽倫二虎	hu[bx ly[rr er[hh hu[hj
忽倫三虎	hu[bx ly[rr sj[hh hu[hj
忽倫四虎	hu[bx ly[rr si[we hu[hj
胡馬越嶺	hu[go ma[vv yt[zh lk[ur
胡青羊	hu[go qk[fo yh[bs
胡鐵花	hu[go tp[jp hx[cr
呼延十八鞭	hu[kp yj[pj ui[hu ba[pd bm[gr
呼延萬善	hu[kp yj[pj wj[hv uj[yk
胡逸之	hu[go yi[dz vi[dv
呼音克	hu[kp yb[lo ke[ge
虎爪絕戶手	hu[hj vc[pu jt[sd hu[du uz[su
虎爪手	hu[hj vc[pu uz[su
華伯斯基	hx[ru bo[rb si[qj ji[qt
化功大法	hx[rq gs[gl da[hr fa[dt
花海飄香	hx[cr hd[dr pn[xf xl[ho
華華鳳	hx[ru hx[ru fg[jy
花開見佛	hx[cr kd[hc jm[ke fo[rf
花滿樓	hx[cr mj[dc lz[am
華拳門	hx[ru qr[bf mf[du
花容雲鬢	hx[cr rs[xr yy[es bb[ig
華山劍法	hx[ru uj[uk jm[rd fa[dt
花鐵幹	hx[cr tp[jp gj[hu
花萬紫	hx[cr wj[hv zi[vy
花月樓	hx[cr yt[ke lz[am
花雲	hx[cr yy[es
華真真	hx[ru vf[uj vf[uj
幻劍式	hr[yv jm[rd ui[qg
幻魔星力	hr[yv mo[gg xk[op li[vp
幻魔星陣	hr[yv mo[gg xk[op vf[ei
幻千尋	hr[yv qm[pu xy[xc
幻小復	hr[yv xn[ub fu[ro
幻星門人	hr[yv xk[op mf[du rf[pd
幻星上人	hr[yv xk[op uh[bh rf[pd
幻陰指	hr[yv yb[eo vi[fb
幻陣	hr[yv vf[ei
黃伯流	hl[gy bo[rb lq[dw
黃二毛子	hl[gy er[hh mc[sv zi[lh
黃甫	hl[gy fu[uo
皇甫閣	hl[bw fu[uo ge[mw
黃國柏	hl[gy go[ww bd[ab
黃金魁	hl[gy jb[rw kv[gd
黃龍劍宗	hl[gy ls[yp jm[rd zs[ge
黃龍子	hl[gy ls[yp zi[lh
黃眉和尚	hl[gy mw[mm he[hk uh[xk
黃面道人	hl[gy mm[ew dc[bz rf[pd
黃泉逆流	hl[gy qr[bu ni[nz lq[dw
黃沙萬里鞭法	hl[gy ua[dx wj[hv li[ot bm[gr fa[dt
黃希節	hl[gy xi[iu jp[ce
黃鬚人	hl[gy xu[py rf[pd
皇揚震首	hl[bw yh[fv vf[yi uz[be
黃鐘公	hl[gy vs[jv gs[bs
黃鍾公	hl[gy vs[jp gs[bs
晦聰禪師	hv[or cs[eb ij[ub ui[uh
回打軟鞭十三式	hv[wk da[fd rr[id bm[gr ui[hu sj[hh ui[qg
迴風拂柳刀	hv[wk fg[ji fu[ff lq[ap dc[vp
迴風拂柳拳	hv[wk fg[ji fu[ff lq[ap qr[bf
迴風落雁劍	hv[wk fg[ji lo[cd yj[ir jm[rd
迴風落雁劍法	hv[wk fg[ji lo[cd yj[ir jm[rd fa[dt
迴風掌	hv[wk fg[ji vh[xf
慧觀	hv[fx gr[yj
迴夢通幽	hv[wk mg[ax ts[sz yz[yy
彗星飛墮	hv[fx xk[op fw[vp do[et
回雁三決	hv[wk yj[ir sj[hh jt[dv
輝月使	hv[xg yt[ke ui[rh
慧真	hv[fx vf[uj
混沌一破	hy[do dy[dt yi[hh po[ep
混天功	hy[do tm[hd gs[gl
混元劍	hy[do yr[ee jm[rd
混元氣	hy[do yr[ee qi[rh
霍阿伊	ho[yv aa[ek yi[rx
火系道術	ho[dp xi[py dc[bz uu[ad
火焰刀	ho[dp yj[hd dc[vp
霍元龍	ho[yv yr[ee ls[yp
季鏢頭	ji[hz bn[jx tz[dd
姬冰雁	ji[nk bk[du yj[ir
寂滅爪	ji[gu mp[hh vc[pu
姬清玄	ji[nk qk[df xr[wy
吉人通	ji[uk rf[pd ts[sz
姬無非	ji[nk wu[ee fw[su
計無施	ji[yu wu[ee ui[fr
姬曉峰	ji[nk xn[oq fg[uw
急雨打萍	ji[dx yu[hk da[fd pk[cd
姬戰天	ji[nk vj[bg tm[hd
季長老	ji[hz vh[ph lc[tb
擠字訣	ji[fw zi[gz jt[yv
賈布	jx[xb bu[uj
家傳劍法	jx[gu ir[re jm[rd fa[dt
假東方不敗	jx[rk ds[qx fh[dw bu[eu bd[bw
賈老六	jx[xb lc[tb lq[wb
賈老者	jx[xb lc[tb ve[to
賈樂山	jx[xb le[px uj[uk
迦業和尚	jx[lz ye[ub he[hk uh[xk
剪補自如	jm[bd bu[yb zi[pm ru[nk
建除	jm[yj iu[er
簡管家	jm[vm gr[vg jx[gu
劍落雙雁	jm[rd lo[cd ul[yy yj[ir
劍氣長江	jm[rd qi[rh ih[ph jl[dg
見人伸手	jm[ke rf[pd uf[ro uz[su
簡長老	jm[vm vh[ph lc[tb
江百勝	jl[dg bd[eo ug[op
江湖閒話	jl[dg hu[dg xm[ma hx[yq
江南史家	jl[dg nj[uk ui[ki jx[gu
江輕霞	jl[dg qk[is xx[yk
江上弄笛	jl[dg uh[bh ns[wc di[vy
殭屍拳	jl[rh ui[kp qr[bf
姜師叔	jl[bn ui[uh uu[uy
蔣四根	jl[cd si[we gf[ag
蔣天壽	jl[cd tm[hd uz[fc
蔣調侯	jl[cd tn[yk hz[rv
姜小鐵	jl[bn xn[ub tp[jp
江重威	jl[dg vs[ph ww[wh
焦公禮	jn[vd gs[bs li[uv
焦木和尚	jn[vd mu[ub he[hk uh[xk
焦宛兒	jn[vd wj[gx er[pv
焦文期	jn[vd wf[wi qi[qo
嬌無那	jn[np wu[ee na[ve
解風	jp[dd fg[ji
截教	jp[tv jn[tw
截手九式	jp[tv uz[su jq[pv ui[qg
解文豹	jp[dd wf[wi bc[pb
解穴祕訣	jp[dd xt[gb mi[hx jt[yv
錦筆生花	jb[jb bi[vm ug[pf hx[cr
進步搬攔錘	jb[ez bu[vu bj[fv lj[fb iv[ji
金剛般若掌	jb[rw gh[kd bo[vj re[cu vh[xf
金剛禪獅子吼	jb[rw gh[kd ij[ub ui[qu zi[lh hz[kz
金剛掣尾	jb[rw gh[kd ie[nf ww[um
金剛伏虎	jb[rw gh[kd fu[rq hu[hj
金剛伏虎刀法	jb[rw gh[kd fu[rq hu[hj dc[vp fa[dt
金剛護體神功	jb[rw gh[kd hu[fh ti[ra uf[uo gs[gl
金剛門	jb[rw gh[kd mf[du
金剛指	jb[rw gh[kd vi[fb
金龍鞭法	jb[rw ls[yp bm[gr fa[dt
金輪度劫	jb[rw ly[ir du[gn jp[tl
緊羅那王棍	jb[uy lo[sx na[ve wh[su gy[ao
金蛇纏絲式	jb[rw ue[ig ij[sg si[sh ui[qg
金蛇盤身式	jb[rw ue[ig pj[vm uf[pu ui[qg
金蛇擒鶴拳	jb[rw ue[ig qb[fr he[gn qr[bf
金蛇昇天式	jb[rw ue[ig ug[pc tm[hd ui[qg
金蛇吐信式	jb[rw ue[ig tu[kt xb[ry ui[qg
金蛇遊身式	jb[rw ue[ig yz[df uf[pu ui[qg
金蛇遊身掌	jb[rw ue[ig yz[df uf[pu vh[xf
金蛇錐	jb[rw ue[ig vv[jv
金烏刀法	jb[rw wu[bv dc[vp fa[dt
金烏派	jb[rw wu[bv pd[dp
金無望	jb[rw wu[ee wh[ww
金血	jb[rw xt[pm
金雁功	jb[rw yj[ir gs[gl
金雁橫空	jb[rw yj[ir hg[ag ks[xg
金鷹掌櫃	jb[rw yk[gn vh[xf gv[ak
靜慧	jk[fd hv[fx
淨濟	jk[dd ji[dw
靜迦	jk[fd jx[lz
靜空	jk[fd ks[xg
敬捧寶經	jk[cw pg[fs bc[gw jk[ss
淨清	jk[dd qk[df
靜虛師太	jk[fd xu[hy ui[uh td[dd
靜玄師太	jk[fd xr[wy ui[uh td[dd
靜因	jk[fd yb[wd
靜音師太	jk[fd yb[lo ui[uh td[dd
靜照	jk[fd vc[od
靜智大師	jk[fd vi[uo da[hr ui[uh
九龍鞭法	jq[pv ls[yp bm[gr fa[dt
九龍派	jq[pv ls[yp pd[dp
鳩摩智	jq[jn mo[gf vi[uo
九品連臺	jq[pv pb[kk lm[iz td[sk
九死生	jq[pv si[hx ug[pf
九天落雷	jq[pv tm[hd lo[cd lw[yt
九玄星箭	jq[pv xr[wy xk[op jm[vb
九玄星力天網	jq[pv xr[wy xk[op li[vp tm[hd wh[ki
九玄星雨	jq[pv xr[wy xk[op yu[hk
九翼道人	jq[pv yi[xt dc[bz rf[pd
九陰白骨爪	jq[pv yb[eo bd[po gu[ko vc[pu
九陰真經	jq[pv yb[eo vf[uj jk[ss
九幽離水訣	jq[pv yz[yy li[wk uv[uu jt[yv
救趙揮金錘	jq[hw vc[zi hv[fg jb[rw iv[ji
舉火撩天	ju[xf ho[dp ln[fd tm[hd
舉火燎天	ju[xf ho[dp ln[hd tm[hd
俱明寶樹王	ju[rj mk[oo bc[gw uu[ay wh[su
巨瞑星	ju[kk mk[mg xk[op
拘神術	ju[fb uf[uo uu[ad
俱通	ju[rj ts[sz
聚星化虛	ju[ep xk[op hx[rq xu[hy
菊友	ju[cb yz[uy
絕對不要惹我	jt[sd dv[yc bu[eu yc[xn re[cx wo[pf
絕劍	jt[sd jm[rd
覺遠	jt[xj yr[ez
覺遠大師	jt[xj yr[ez da[hr ui[uh
覺月	jt[xj yt[ke
峻嶺橫空	jy[us lk[ur hg[ag ks[xg
喀絲麗	ka[kg si[sh li[hk
凱別興	kd[uj bp[kd xk[xb
開山掌	kd[hc uj[uk vh[xf
柯萬鈞	ke[ak wj[hv jy[jb
柯鎮惡	ke[ak vf[ju ee[hx
控鶴功	ks[fx he[gn gs[gl
空擊蒼鷹	ks[xg ji[fk ch[cr yk[gn
空間地行之術	ks[xg jm[mo di[ty xk[rh vi[dv uu[ad
空明拳	ks[xg mk[oo qr[bf
空聞	ks[xg wf[me
空智	ks[xg vi[uo
苦禪大師	ku[cg ij[ub da[hr ui[uh
苦嗔大師	ku[cg if[ku da[hr ui[uh
苦瓜大師	ku[cg gx[ps da[hr ui[uh
骷髏畫	ku[gg lz[gm hx[ht
苦惱拳	ku[cg nc[xw qr[bf
枯榮禪功	ku[ag rs[ca ij[ub gs[gl
枯榮長老	ku[ag rs[ca vh[ph lc[tb
枯榮真人	ku[ag rs[ca vf[uj rf[pd
快活三十掌	kk[xv ho[dq sj[hh ui[hu vh[xf
鄺寶官	kl[ge bc[gw gr[gu
狂風快劍	kl[qw fg[ji kk[xv jm[rd
鄺天雄	kl[ge tm[hd xs[uv
葵花寶典	kv[cd hx[cr bc[gw dm[kb
傀儡術	kv[rg lw[rt uu[ad
崑崙劍法	ky[ob ly[rb jm[rd fa[dt
崑崙劍宗	ky[ob ly[rb jm[rd zs[ge
來福兒	ld[hm fu[uh er[pv
來鶴清泉	ld[hm he[gn qk[df qr[bu
藍秦	lj[cu qb[sh
藍天和	lj[cu tm[hd he[hk
郎師傅	lh[le ui[uh fu[rf
朗月無雲	lh[lo yt[ke wu[ee yy[es
勞德諾	lc[cl de[ru no[yc
老實和尚	lc[tb ui[gd he[hk uh[xk
勞太監	lc[cl td[dd jm[um
撈月式	lc[fc yt[ke ui[qg
老枝橫斜	lc[tb vi[au hg[ag xp[rd
樂厚	le[px hz[io
雷猛	lw[yt mg[qz
雷系道術	lw[yt xi[py dc[bz uu[ad
雷一嘯	lw[yt yi[hh xn[kx
冷秋魂	lg[dr qq[hh hy[eg
李大元	li[az da[hr yr[ee
李觀魚	li[az gr[yj yu[dt
李紅袖	li[az hs[sg xq[yy
李壞	li[az hk[tb
李可秀	li[az ke[dk xq[hn
李力世	li[az li[vp ui[nv
力劈三關	li[vp pi[ud sj[hh gr[bt
李綺	li[az qi[sd
李三	li[az sj[hh
黎生	li[hr ug[pf
李式開	li[az ui[qg kd[hc
李四摧	li[az si[we cv[fu
李天恆	li[az tm[hd hg[xh
李廷豹	li[az tk[qj bc[pb
李萬山	li[az wj[hv uj[uk
李西華	li[az xi[hk hx[ru
李玉涵	li[az yu[wd hj[dl
李沅芷	li[az yr[de vi[cv
連城璧	lm[iz ig[tw bi[uw
連誠訣	lm[iz ig[yw jt[yv
憐花研姿	lm[xr hx[cr yj[ek zi[dn
蓮花掌	lm[ci hx[cr vh[xf
連環迷蹤腿	lm[iz hr[wb mi[mz zs[zg tv[og
瀲霓裳	lm[dr ni[yj ih[xy
煉神	lm[hq uf[uo
煉神期	lm[hq uf[uo qi[qo
煉神士	lm[hq uf[uo ui[uh
連世昌	lm[iz ui[nv ih[oo
煉體	lm[hq ti[ra
煉體士	lm[hq ti[ra ui[uh
煉獄使	lm[hq yu[qy ui[rh
兩廣豪傑	ll[hk gl[di hc[wu jp[ad
兩回瑪法	ll[hk hv[wk ma[wm fa[dt
兩儀劍法	ll[hk yi[rd jm[rd fa[dt
梁長老	ll[da vh[ph lc[tb
梁自進	ll[da zi[pm jb[ez
樑子翁	ll[da zi[lh wg[bx
廖自礪	ln[gx zi[pm li[ei
獵戶令者	lp[qg hu[du lk[rd ve[to
林太平	lb[aa td[dd pk[hb
林興珠	lb[aa xk[xb vu[wp
林永超	lb[aa ys[dv ic[zd
林遠圖	lb[aa yr[ez tu[ww
靈鰲步	lk[xh ao[fy bu[vu
羚豹	lk[yr bc[pb
凌波微步	lk[dt bo[dp ww[ru bu[vu
令狐雲煙	lk[rd hu[qp yy[es yj[hw
靈寂期	lk[xh ji[gu qi[qo
靈鷲聽經	lk[xh jq[wn tk[kj jk[ss
靈山禮佛	lk[xh uj[uk li[uv fo[rf
嶺上雙梅	lk[ur uh[bh ul[yy mw[ar
靈蛇拳	lk[xh ue[ig qr[bf
凌霜華	lk[dt ul[ya hx[ru
凌素娥	lk[dt su[fy ee[np
淩退思	lk[dt tv[gz si[tx
凌源星	lk[dt yr[di xk[op
靈智上人	lk[xh vi[uo uh[bh rf[pd
劉敖	lq[wd ao[fw
柳長街	lq[ap ih[ph jp[rt
劉乘風	lq[wd ig[qb fg[ji
柳大洪	lq[ap da[hr hs[dg
劉芳亮	lq[wd fh[cf ll[wj
劉鶴真	lq[wd he[gn vf[uj
六脈神劍	lq[wb md[od uf[uo jm[rd
劉培生	lq[wd pw[tl ug[pf
流泉下山	lq[dw qr[bu xx[hb uj[uk
流殤陣	lq[dw uh[hr vf[ei
柳無眉	lq[ap wu[ee mw[mm
流星飛墮	lq[dw xk[op fw[vp do[et
流星灌頂	lq[dw xk[op gr[dc dk[dy
柳絮劍法	lq[ap xu[ny jm[rd fa[dt
劉玄處	lq[wd xr[wy iu[wb
劉一舟	lq[wd yi[hh vz[pk
柳蔭聯句	lq[ap yb[ce lm[eb ju[bk
劉瑛姑	lq[wd yk[wc gu[ng
劉於義	lq[wd yu[fr yi[di
劉元鶴	lq[wd yr[ee he[gn
流雲疊影	lq[dw yy[es dp[yq yk[op
流雲居士	lq[dw yy[es ju[ug ui[uh
流雲使	lq[dw yy[es ui[rh
劉之餘	lq[wd vi[dv yu[re
龍島主	ls[yp dc[nu vu[dw
龍德鄰	ls[yp de[ru lb[re
龍駿	ls[yp jy[ms
聾啞婆婆	ls[ye ya[kh po[dn po[dn
龍躍在淵	ls[yp yt[zp zd[ut yr[dp
龍爪擒拿手	ls[yp vx[pu qb[fr na[rf uz[su
陸伯	lu[ef bo[rb
陸乘風	lu[ef ig[qb fg[ji
魯達拔柳	lu[yo da[dz ba[fu lq[ap
陸大有	lu[ef da[hr yz[uo
鹿鼎記	lu[gb dk[mv ji[yk
陸鼎立	lu[ef dk[mv li[lh
陸二孃	lu[ef er[hh nl[nl
陸菲青	lu[ef fw[cf qk[fo
路副將	lu[zw fu[hd jl[dx
陸高軒	lu[ef gc[wk xr[ig
陸冠英	lu[ef gr[ge yk[ck
六合刀	lu[wb he[rh dc[vp
六合勁	lu[wb he[rh jb[sl
六合槍	lu[wb he[rh ql[ar
魯連榮	lu[yo lm[iz rs[ca
鹿清篤	lu[gb qk[df du[vm
陸天抒	lu[ef tm[hd uu[fy
陸小鳳	lu[ef xn[ub fg[jy
盧一峰	lu[bu yi[hh fg[uw
陸音路	lu[ef yb[lo lu[zw
魯有腳	lu[yo yz[uo jn[ot
魯智深醉跌	lu[yo vi[uo uf[dg zv[yw dp[zp
路自中峰上	lu[zw zi[pm vs[ku fg[uw uh[bh
亂環訣	lr[qv hr[wb jt[yv
亂世情懷	lr[qv ui[nv qk[xf hk[xb
駱冰	lo[mw bk[du
羅剎二使	lo[sx ia[id er[hh ui[rh
羅大千	lo[sx da[hr qm[pu
羅漢級別	lo[sx hj[dy ji[sj bp[kd
羅漢劍法	lo[sx hj[dy jm[rd fa[dt
玀睺使	lo[qs hz[[ ui[rh
羅立如	lo[sx li[lh ru[nk
羅人傑	lo[sx rf[pd jp[ad
落日大旗	lo[cd ri[wh da[hr qi[fr
落日照大旗	lo[cd ri[wh vc[od da[hr qi[fr
洛神凌波	lo[dw uf[uo lk[dt bo[dp
羅天上仙	lo[sx tm[hd uh[bh xm[ru
羅信	lo[sx xb[ry
螺旋九影	lo[it xr[fr jq[pv yk[op
落雁拳	lo[cd yj[ir qr[bf
洛陽韓家	lo[dw yh[eo hj[uw jx[gu
落英劍法	lo[cd yk[ck jm[rd fa[dt
落英神劍掌	lo[cd yk[ck uf[uo jm[rd vh[xf
呂葆中	lv[kk bc[cr vs[ku
呂南人	lv[kk nj[uk rf[pd
呂七	lv[kk qi[hv
呂素文	lv[kk su[fy wf[wi
呂文德	lv[kk wf[wi de[ru
呂小妹	lv[kk xn[ub mw[nh
呂毅中	lv[kk yi[lj vs[ku
呂正平	lv[kk vg[hv pk[hb
綠竹翁	lv[sx vu[rr wg[bx
馬博仁	ma[vv bo[uf rf[re
馬超興	ma[vv ic[zd xk[xb
馬大鳴	ma[vv da[hr mk[kn
馬大挺	ma[vv da[hr tk[fq
馬法通	ma[vv fa[dt ts[sz
馬公子	ma[vv gs[bs zi[lh
馬光佐	ma[vv gl[xe zo[ru
馬家駿	ma[vv jx[gu jy[ms
馬敬俠	ma[vv jk[cw xx[rj
瑪米爾	ma[wm mi[ba er[dx
馬面挑心	ma[vv mm[ew tn[fv xb[dv
馬青雄	ma[vv qk[fo xs[uv
馬善均	ma[vv uj[yk jy[tb
馬上上馬	ma[vv uh[bh uh[bh ma[vv
馬行空	ma[vv xk[rh ks[xg
瑪雅帝國	ma[wm ya[yv di[lj go[ww
麻衣漢子	ma[ga yi[wy hj[dy zi[lh
馬佑	ma[vv yz[ru
麥鯨	md[fw jk[yw
麥少幫主	md[fw uc[xp bh[fj vu[dw
茅十八	mc[cy ui[hu ba[pd
毛文珠	mc[sv wf[wi vu[wp
梅芳姑	mw[ar fh[cf gu[ng
梅花拳	mw[ar hx[cr qr[bf
梅劍和	mw[ar jm[rd he[hk
梅良鳴	mw[ar ll[dg mk[kn
媚媚貓	mw[nm mw[nm mc[qc
梅念笙	mw[ar nm[rx ug[vp
美女拳法	mw[bw nv[vp qr[bf fa[dt
美人三招	mw[bw rf[pd sj[hh vc[fd
梅文馨	mw[ar wf[wi xb[uh
梅雪逢夏	mw[ar xt[yx fg[wz xx[ew
梅雪爭春	mw[ar xt[yx vg[dx iy[so
梅吟雪	mw[ar yb[kr xt[yx
孟伯飛	mg[zm bo[rb fw[vp
蒙古摔跤	mg[ch gu[uk uk[fw jn[zl
猛虎伏樁	mg[qz hu[hj fu[rq vl[ag
猛雞奪粟	mg[qz ji[yn do[dc su[xm
孟家神拳	mg[zm jx[gu uf[uo qr[bf
孟健雄	mg[zm jm[ry xs[uv
蒙雷	mg[ch lw[yt
蒙娜塔莎	mg[ch na[nv ta[tc ua[cd
孟婆灌湯	mg[zm po[dn gr[dc th[dv
孟師叔	mg[zm ui[uh uu[uy
蒙闐	mg[ch tm[mu
孟錚	mg[zm vg[jd
孟正鴻	mg[zm vg[hv hs[dn
孟鑄	mg[zm vu[jf
米橫野	mi[ba hg[ag ye[oy
彌珈洛荒原	mi[gd jx[wl lo[dw hl[cw yr[ib
米思翰	mi[ba si[tx hj[ur
米為義	mi[ba ww[dl yi[di
綿掌	mm[sb vh[xf
妙風使	mn[nx fg[ji ui[rh
苗家劍	mn[ct jx[gu jm[rd
苗家劍法	mn[ct jx[gu jm[rd fa[dt
妙僧無花	mn[nx sg[rb wu[ee hx[cr
滅劍	mp[hh jm[rd
滅星境	mp[hh xk[op jk[tl
閔柔	mb[mw rz[ya
閔子華	mb[mw zi[lh hx[ru
冥皇	mk[go hl[bw
明駝駿足	mk[oo to[mg jy[ms zu[kv
明域	mk[oo yu[tg
明月羌笛	mk[oo yt[ke ql[yv di[vy
魔閉	mo[gg bi[mc
魔刀洪烈	mo[gg dc[vp hs[dg lp[hd
驀得	mo[cm de[ro
魔定	mo[gg dk[gp
墨菲託	mo[ht fw[cf to[fp
魔封	mo[gg fg[tc
魔固	mo[gg gu[wg
摩訶巴思	mo[gf he[yk ba[ku si[tx
摩訶指	mo[gf he[yk vi[fb
魔戟誅仙訣	mo[gg ji[ug vu[yp xm[ru jt[yv
魔解	mo[gg jp[dd
摩羯星	mo[gf jp[yo xk[op
魔禁	mo[gg jb[ae
魔訣	mo[gg jt[yv
魔力黑洞	mo[gg li[vp hw[sd ds[dk
魔龍天神劍	mo[gg ls[yp tm[hd uf[uo jm[rd
墨門	mo[ht mf[du
魔破	mo[gg po[ep
莫聲谷	mo[co ug[um gu[bk
魔嬰	mo[gg yk[bn
魔域的太陽使	mo[gg yu[tg de[bb td[dd yh[eo ui[rh
莫之然	mo[co vi[dv rj[xd
穆貝德	mu[hb bw[kr de[ru
木島主	mu[ub dc[nu vu[dw
木高峰	mu[ub gc[wk fg[uw
穆貴妃	mu[hb gv[vb fw[nk
穆護	mu[hb hu[fh
沐家劍	mu[da jx[gu jm[rd
沐家拳	mu[da jx[gu qr[bf
沐劍聲	mu[da jm[rd ug[um
木蘭織衣	mu[ub lj[bs vi[sk yi[wy
木龍真人	mu[ub ls[yp vf[uj rf[pd
穆人清	mu[hb rf[pd qk[df
慕容景嶽	mu[cx rs[xr jk[ow yt[qu
慕容九	mu[cx rs[xr jq[pv
慕容雙	mu[cx rs[xr ul[yy
木桑道長	mu[ub sh[ya dc[bz vh[ph
暮宿曉行	mu[co su[gr xn[oq xk[rh
慕天顏	mu[cx tm[hd yj[ly
沐王府	mu[da wh[su fu[gr
木文察	mu[ub wf[wi ia[gx
木葉蕭蕭	mu[ub ye[ku xn[cx xn[cx
木卓倫	mu[ub vo[bo ly[rr
納斯爾丁	na[sk si[qj er[dx dk[hu
拿雲式	na[rf yy[es ui[qg
奈何功	nd[de he[rk gs[gl
南宮靈	nj[uk gs[gk lk[xh
南宮平	nj[uk gs[gk pk[hb
南海劍宗	nj[uk hd[dr jm[rd zs[ge
南海椰花島	nj[uk hd[dr ye[ae hx[cr dc[nu
南蘭	nj[uk lj[bs
南仁通	nj[uk rf[re ts[sz
南山掌法	nj[uk uj[uk vh[xf fa[dt
南少林派	nj[uk uc[xp lb[aa pd[dp
南希仁	nj[uk xi[iu rf[re
內八卦掌法	nw[kr ba[pd gx[tb vh[xf fa[dt
倪不大	ni[rj bu[eu da[hr
倪不小	ni[rj bu[eu xn[ub
霓裳金蓮	ni[yj ih[xy jb[rw lm[ci
倪浩	ni[rj hc[dn
尼瑪拉姆	ni[ub ma[wm la[fl mu[nm
尼摩星	ni[ub mo[gf xk[op
泥鰍功	ni[du qq[yh gs[gl
逆行經脈	ni[nz xk[rh jk[ss md[od
拈花擒拿手	nm[fb hx[cr qb[fr na[rf uz[su
聶鉞	np[ey yt[jh
寧強盜	nk[gd ql[gk dc[dm
寧氏一劍	nk[gd ui[pq yi[hh jm[rd
寧完我	nk[gd wj[ge wo[pf
凝血神抓	nk[db xt[pm uf[uo vx[fp
甯中則	nk[gd vs[ku ze[bd
拗道師	nq[fy dc[bz ui[uh
牛頭人身	nq[pf tz[dd rf[pd uf[pu
怒劍真人	nu[nx jm[rd vf[uj rf[pd
女貌郎才珠萬斛	nv[vp mc[pb lh[le cd[hu vu[wp wj[hv hu[dd
歐飛雄	ou[kd fw[vp xs[uv
歐羅巴聯邦	ou[kd lo[sx ba[ku lm[eb bh[fe
偶染風寒	ou[ro rj[da fg[ji hj[gd
歐陽公政	ou[kd yh[eo gs[bs vg[hw
歐陽牧之	ou[kd yh[eo mu[nw vi[dv
歐英文	ou[kd yk[ck wf[wi
拍斷	pd[fb dr[mj
徘徊空谷	pd[rf hk[rw ks[xg gu[bk
盤根錯節十八斧	pj[vm gf[ag co[jg jp[ce ui[hu ba[pd fu[bj
盤弓射鵰	pj[vm gs[kv ue[uc dn[kv
判官翻簿	pj[bd gr[gu fj[px bu[vd
盤迴出壁籮	pj[vm hv[wk iu[ck bi[ut lo[vs
潘秀達	pj[dp xq[hn da[dz
胖婦人	ph[ob fu[nx rf[pd
胖丐	ph[ob gd[xv
胖商人	ph[ob uh[lk rf[pd
庖丁解牛掌	pc[gb dk[hu jp[dd nq[pf vh[xf
裴將軍詩	pw[fy jl[dx jy[gi ui[yt
裴珏	pw[fy jt[ww
彭參將	pg[up cj[sd jl[dx
彭連虎	pg[up lm[iz hu[hj
彭三春	pg[up sj[hh iy[so
彭瑩玉	pg[up yk[cw yu[wd
彭長老	pg[up vh[ph lc[tb
批亢式	pi[fb kh[wj ui[qg
琵琶公主	pi[wb pa[wb gs[bs vu[dw
琵琶遮面	pi[wb pa[wb ve[gz mm[ew
皮清雲	pi[vp qk[df yy[es
皮裘	pi[vp qq[hy
飄雪穿雲掌	pn[xf xt[yx ir[xy yy[es vh[xf
平阿四	pk[hb aa[ek si[we
平等寶樹王	pk[hb dg[vt bc[gw uu[ay wh[su
平夫人	pk[hb fu[er rf[pd
平工頭	pk[hb gs[hu tz[dd
平婆婆	pk[hb po[dn po[dn
平旺先	pk[hb wh[ow xm[ne
平威	pk[hb ww[wh
平一指	pk[hb yi[hh vi[fb
破鞭式	po[ep bm[gr ui[qg
破刀式	po[ep dc[vp ui[qg
破箭式	po[ep jm[vb ui[qg
潑墨披麻劍法	po[dv mo[ht pi[fp ma[ga jm[rd fa[dt
破牌	po[ep pd[pb
破氣式	po[ep qi[rh ui[qg
破槍式	po[ep ql[ar ui[qg
破碎虛空	po[ep sv[ew xu[hy ks[xg
破索式	po[ep so[uy ui[qg
破玉拳	po[ep yu[wd qr[bf
破月錐	po[ep yt[ke vv[jv
破掌式	po[ep vh[xf ui[qg
普門杖法	pu[bo mf[du vh[ah fa[dt
普通仙人	pu[bo ts[sz xm[ru rf[pd
樸者和尚	pu[ab ve[to he[hk uh[xk
齊伯濤	qi[wp bo[rb tc[df
悽慘的刀口	qi[dh cj[xs de[bb dc[vp kz[uv
戚長髮	qi[wu ih[ph fa[vy
七大寇之鋒將	qi[hv da[hr kz[ge vi[dv fg[jw jl[dx
七大寇之祭劍	qi[hv da[hr kz[ge vi[dv ji[xe jm[rd
七大首座	qi[hv da[hr uz[be zo[gr
戚芳	qi[wu fh[cf
祁家劍	qi[ue jx[gu jm[rd
祁六三	qi[ue lq[wb sj[hh
齊洛諾夫	qi[wp lo[dw no[yc fu[er
奇門三才刀	qi[dk mf[du sj[hh cd[hu dc[vp
奇門五轉	qi[dk mf[du wu[hu vr[ie
棋盤招式	qi[aq pj[vm vc[fd ui[qg
祁清彪	qi[ue qk[df bn[hp
齊堂主	qi[wp th[xt vu[dw
祁天彪	qi[ue tm[hd bn[hp
七絃無形劍法	qi[hv xm[gw wu[ee xk[kp jm[rd fa[dt
齊心寶樹王	qi[wp xb[dv bc[gw uu[ay wh[su
齊元凱	qi[wp yr[ee kd[uj
祁志誠	qi[ue vi[ux ig[yw
齊自勉	qi[wp zi[pm mm[dl
千道縱橫	qm[pu dc[bz zs[sr hg[ag
千跌張	qm[pu dp[zp vh[gi
錢二敗	qm[jj er[hh bd[bw
千古人龍	qm[pu gu[uk rf[pd ls[yp
千斤墮地	qm[pu jb[ph do[et di[ty
千鈞壓駝	qm[pu jy[jb ya[it to[mg
乾坤大挪移	qm[ur ky[to da[hr no[fv yi[hx
乾坤湮滅	qm[ur ky[to yj[dx mp[hh
錢老本	qm[jj lc[tb bf[ah
千里流沙	qm[pu li[ot lq[dw ua[dx
錢青健	qm[jj qk[fo jm[ry
錢通四	qm[jj ts[sz si[we
錢正倫	qm[jj vg[hv ly[rr
千蛛萬毒手	qm[pu vu[ip wj[hv du[fm uz[su
羌再生	ql[yv zd[hk ug[pf
搶珠式	ql[fr vu[wp ui[qg
峭壁斷雲	qn[ux bi[ut dr[mj yy[es
喬福	qn[pp fu[uh
俏鬼	qn[rx gv[be
喬寨主	qn[pp vd[ga vu[dw
琴兒	qb[wr er[pv
秦老五	qb[sh lc[tb wu[hu
擒龍功	qb[fr ls[yp gs[gl
秦耐之	qb[sh nd[ec vi[dv
覃天丞	qb[xo tm[hd ig[lh
秦偉幫	qb[sh ww[rw bh[fj
青城道家	qk[fo ig[tw dc[bz jx[gu
清風引佩下瑤臺	qk[df fg[ji yb[gu pw[rj xx[hb yc[wa td[sk
青蜂針	qk[fo fg[iw vf[ju
晴畫	qk[of hx[ht
青靈子	qk[fo lk[xh zi[lh
輕羅小扇	qk[is lo[sx xn[ub uj[hx
輕上斜紅	qk[is uh[bh xp[rd hs[sg
青松望亭	qk[fo ss[ab wh[ww tk[wd
青銅時代	qk[fo ts[jk ui[oc dd[rq
清心凝意	qk[df xb[dv nk[db yi[lx
清虛道人	qk[df xu[hy dc[bz rf[pd
輕吟迴風	qk[is yb[kr hv[wk fg[ji
清飲小酌	qk[df yb[ud xn[ub vo[yb
青字九打	qk[fo zi[gz jq[pv da[fd
龜茲國王	qq[do ci[by go[ww wh[su
秋菊	qq[hh ju[cb
秋靈素	qq[hh lk[xh su[fy
裘千丈	qq[hy qm[pu vh[hi
邱山風	qq[qe uj[uk fg[ji
秋山遠	qq[hh uj[uk yr[ez
秋小韻	qq[hh xn[ub yy[lb
秋字家族	qq[hh zi[gz jx[gu zu[fr
去傍馬頭生	qu[ts bh[rl ma[vv tz[dd ug[pf
去煩惱指	qu[ts fj[hy nc[xw vi[fb
曲非煙	qu[ou fw[su yj[hw
取經棍法	qu[ey jk[ss gy[ao fa[dt
曲三	qu[ou sj[hh
曲傻姑	qu[ou ua[rp gu[ng
曲無容	qu[ou wu[ee rs[xr
曲洋	qu[ou yh[dy
覷準	qu[hj vy[dv
曲走奈何	qu[ou zz[tv nd[de he[rk
泉建男	qr[bu jm[yj nj[tl
全金髮	qr[rw jb[rw fa[vy
泉媽	qr[bu ma[nm
泉鳴芙蓉	qr[bu mk[kn fu[ce rs[cx
全強盜	qr[rw ql[gk dc[dm
全真劍法	qr[rw vf[uj jm[rd fa[dt
群龍之首	qy[xy ls[yp vi[dv uz[be
群邪辟易	qy[xy xp[ye pi[ul yi[ob
燃木刀法	rj[hx mu[ub dc[vp fa[dt
繞指柔劍	rc[sq vi[fb rz[ya jm[rd
任慈	rf[rq ci[bx
任通武	rf[rq ts[sz wu[hv
任我行	rf[rq wo[pf xk[rh
榮彩	rs[ca cd[ap
熔星丹鼎	rs[hx xk[op dj[kw dk[mv
容子矩	rs[xr zi[lh ju[uk
柔雲劍術	rz[ya yy[es jm[rd uu[ad
如來千手式	ru[nk ld[hm qm[pu uz[su ui[qg
入魔道	ru[pd mo[gg dc[bz
儒以文非今	ru[ry yi[sr wf[wi fw[su jb[rd
如影隨形腿	ru[nk yk[op sv[eu xk[kp tv[og
阮士忠	rr[ee ui[uh vs[vx
蕊初	rv[cx iu[yd
瑞大林	rv[wu da[hr lb[aa
瑞棟	rv[wu ds[aq
睿木族	rv[bh mu[ub zu[fr
瑞婆婆	rv[wu po[dn po[dn
芮瑋	rv[ck ww[ww
若克琳	ro[cu ke[ge lb[wa
薩多	sa[ce do[xx
塞北白家堡	sd[gt bw[ub bd[po jx[gu bc[rt
賽總管	sd[gb zs[bx gr[vg
三杯吐言諾	sj[hh bw[ab tu[kt yj[we no[yc
三代弟子	sj[hh dd[rq di[bg zi[lh
三分劍術	sj[hh ff[bd jm[rd uu[ad
三花聚頂掌法	sj[hh hx[cr ju[ep dk[dy vh[xf fa[dt
散花掌	sj[gw hx[cr vh[xf
三江閣	sj[hh jl[dg ge[mw
三十六護法韋馱	sj[hh ui[hu lq[wb hu[fh fa[dt ww[hh to[md
三無三不手	sj[hh wu[ee sj[hh bu[eu uz[su
三燕投林	sj[hh yj[nk tz[fj lb[aa
三鑄神裝	sj[hh vu[jf uf[uo vl[dy
桑結	sh[ya jp[su
桑昆	sh[ya ky[ob
桑拉巴	sh[ya la[fl ba[ku
喪門鬼	sh[ty mf[du gv[be
桑三娘	sh[ya sj[hh nl[nl
桑斯	sh[ya si[qj
桑土公	sh[ya tu[uh gs[bs
掃蕩群魔	sc[fx dh[cd qy[xy mo[gg
掃雪烹茶	sc[fx xt[yx pg[wd ia[cr
掃葉腿法	sc[fx ye[ku tv[og fa[dt
殺楚	ua[ia iu[ap
沙廣天	ua[dx gl[di tm[hd
沙老大	ua[dx lc[tb da[hr
殺了你好嗎	ua[ia le[vu ni[rd hc[nz ma[km
殺人的心跳	ua[ia rf[pd de[bb xb[dv tn[zv
煞神當道	ua[dd uf[uo dh[xx dc[bz
煞神鬼	ua[dd uf[uo gv[be
殺手善哉	ua[ia uz[su uj[yk zd[tk
殺死雪山飛狐	ua[ia si[hx xt[yx uj[uk fw[vp hu[qp
沙天江	ua[dx tm[hd jl[dg
沙通天	ua[dx ts[sz tm[hd
山門護法	uj[uk mf[du hu[fh fa[dt
山外清音	uj[uk wd[xb qk[df yb[lo
山西童家	uj[uk xi[hk ts[lo jx[gu
商寶震	uh[lk bc[gw vf[yi
上官虹	uh[bh gr[gu hs[ig
上官金虹	uh[bh gr[gu jb[rw hs[ig
上官憐憐	uh[bh gr[gu lm[xr lm[xr
上官刃	uh[bh gr[gu rf[dd
上官鐵生	uh[bh gr[gu tp[jp ug[pf
上官仙兒	uh[bh gr[gu xm[ru er[pv
上官毅山	uh[bh gr[gu yi[lj uj[uk
上官雲	uh[bh gr[gu yy[es
商老太	uh[lk lc[tb td[dd
上清觀	uh[bh qk[df gr[yj
上清劍法	uh[bh qk[df jm[rd fa[dt
上清拳	uh[bh qk[df qr[bf
少衝劍	uc[xp is[dv jm[rd
少典之子	uc[xp dm[kb vi[dv zi[lh
邵鶴	uc[de he[gn
少林長拳	uc[xp lb[aa ih[ph qr[bf
少林伏魔神功	uc[xp lb[aa fu[rq mo[gg uf[uo gs[gl
少林擒拿十八打	uc[xp lb[aa qb[fr na[rf ui[hu ba[pd da[fd
少年冷血	uc[xp nm[rn lg[dr xt[pm
少年鐵手	uc[xp nm[rn tp[jp uz[su
少年追命	uc[xp nm[rn vv[pz mk[rh
少商劍	uc[xp uh[lk jm[rd
邵燕	uc[de yj[nk
射鵰英雄傳	ue[uc dn[kv yk[ck xs[uv vr[re
懾服外道	ue[xe fu[oe wd[xb dc[bz
蛇磐青竹	ue[ig pj[ve qk[fo vu[rr
蛇皮張	ue[ig pi[vp vh[gi
蛇行狸翻	ue[ig xk[rh li[qo fj[px
蛇行鼠竄	ue[ig xk[rh uu[jv cr[xk
沈壁君	uf[dg bi[ut jy[xk
神鵰俠侶	uf[uo dn[kv xx[rj lv[rk
慎篤行	uf[xu du[vm xk[rh
沈慧琳	uf[dg hv[fx lb[wa
沈慧珊	uf[dg hv[fx uj[wk
慎空行	uf[xu ks[xg hh[rh
神木王鼎	uf[uo mu[ub wh[su dk[mv
神器開天	uf[uo qi[kq kd[hc tm[hd
沈青剛	uf[dg qk[fo gh[kd
申人俊	uf[ou rf[pd jy[rs
神山上人	uf[uo uj[uk uh[bh rf[pd
申屠計都	uf[ou tu[ut ji[yu dz[te
身外化身	uf[pu wd[xb hx[rq uf[pu
神醫賴藥兒	uf[uo yi[ku ld[hd yc[cs er[pv
神音	uf[uo yb[lo
神照上人	uf[uo vc[od uh[bh rf[pd
申志凡	uf[ou vi[ux fj[jd
神州無敵	uf[uo vz[dp wu[ee di[qw
聖火令武功	ug[yt ho[dp lk[rd wu[hv gs[gl
生靈輪迴	ug[pf lk[xh ly[ir hv[wk
生死令	ug[pf si[hx lk[rd
盛顏	ug[wm yj[ly
聖因師太	ug[yt yb[wd ui[uh td[dd
獅鼻子	ui[qu bi[zt zi[lh
史鏢頭	ui[ki bn[jx tz[dd
史秉光	ui[ki bk[ph gl[xe
史秉文	ui[ki bk[ph wf[wi
史伯威	ui[ki bo[rb ww[wh
石崇武	ui[ek is[ug wu[hv
施戴子	ui[fr dd[tt zi[lh
史登達	ui[ki dg[dd da[dz
十二菩薩之一	ui[hu er[hh pu[cl sa[ce vi[dv yi[hh
噬骨龍獸	ui[kv gu[ko ls[yp uz[bh
石關回馬	ui[ek gr[bt hv[wk ma[vv
史紅石	ui[ki hs[sg ui[ek
史火龍	ui[ki ho[dp ls[yp
史季強	ui[ki ji[hz ql[gk
釋迦擲象功	ui[py jx[lz vi[fb xl[dk gs[gl
侍劍	ui[rt jm[rd
時間規則	ui[oc jm[mo gv[ej ze[bd
石駿	ui[ek jy[ms
室裡	ui[gh li[ot
石樑派	ui[ek ll[da pd[dp
石廩劍法	ui[ek lb[gw jm[rd fa[dt
石廩書聲	ui[ek lb[gw uu[vv ug[um
施令威	ui[fr lk[rd ww[wh
史孟龍	ui[ki mg[zm ls[yp
石破天	ui[ek po[ep tm[hd
史七郎	ui[ki qi[hv lh[le
史叔剛	ui[ki uu[uy gh[kd
石雙英	ui[ek ul[yy yk[ck
史松	ui[ki ss[ab
石頭拳	ui[ek tz[dd qr[bf
石駝	ui[ek to[mg
石萬嗔	ui[ek wj[hv if[ku
時未寒	ui[oc ww[ha hj[gd
史小翠	ui[ki xn[ub cv[xw
史仲俊	ui[ki vs[rv jy[rs
史仲猛	ui[ki vs[rv mg[qz
獅子吼	ui[qu zi[lh hz[kz
瘦丐	uz[bj gd[xv
手揮琵琶	uz[su hv[fg pi[wb pa[wb
守缺式	uz[gc qt[pv ui[qg
瘦商人	uz[bj uh[lk rf[pd
瘦頭陀	uz[bj tz[dd to[eg
蜀道難牌法	uu[sb dc[bz nj[yv pd[pb fa[dt
倏得	uu[ru de[ro
書法武學	uu[vv fa[dt wu[hv xt[xz
舒化龍	uu[ry hx[rq ls[yp
書劍恩仇錄	uu[vv jm[rd en[wx iz[rj lu[xu
淑女劍	uu[du nv[vp jm[rd
舒奇	uu[ry qi[dk
蜀山劍宗	uu[sb uj[uk jm[rd zs[ge
樹梢擒猴	uu[ay uc[ax qb[fr hz[qr
雙龍取水	ul[yy ls[yp qu[ey uv[uu
雙駝西來	ul[yy to[mg xi[hk ld[hm
水岱	uv[uu dd[ru
水福	uv[uu fu[uh
水鑑	uv[uu jm[uj
水靈光	uv[uu lk[xh gl[xe
水龍一族	uv[uu ls[yp yi[hh zu[fr
水龍族	uv[uu ls[yp zu[fr
水母陰姬	uv[uu mu[vv yb[eo ji[nk
水天姬	uv[uu tm[hd ji[nk
水系道術	uv[uu xi[py dc[bz uu[ad
水雲道人	uv[uu yy[es dc[bz rf[pd
朔風忽起	uo[no fg[ji hu[bx qi[zk
朔風狂嘯	uo[no fg[ji kl[qw xn[kx
四大名捕打老虎	si[we da[hr mk[xk bu[ff da[fd lc[tb hu[hj
四大名捕鬥殭屍	si[we da[hr mk[xk bu[ff dz[du jl[rh ui[kp
四大名捕震關東	si[we da[hr mk[xk bu[ff vf[yi gr[bt ds[qx
四大天君	si[we da[hr tm[hd jy[xk
四大主司	si[we da[hr vu[dw si[vh
司鬼	si[vh gv[be
司鬼者	si[vh gv[be ve[to
四海遨遊	si[we hd[dr ao[fz yz[df
司空玄	si[vh ks[xg xr[wy
司空摘星	si[vh ks[xg vd[fl xk[op
絲蘿百結	si[sh lo[cs bd[eo jp[su
司馬長空	si[vh ma[vv ih[ph ks[xg
司馬大	si[vh ma[vv da[hr
司馬林	si[vh ma[vv lb[aa
四妹	si[we mw[nh
司冥	si[vh mk[go
司徒伯雷	si[vh tu[rz bo[rb lw[yt
司徒光	si[vh tu[rz gl[xe
司徒鶴	si[vh tu[rz he[gn
司徒橫	si[vh tu[rz hg[ag
司徒靜	si[vh tu[rz jk[fd
司徒雷	si[vh tu[rz lw[yt
司徒流星	si[vh tu[rz lq[dw xk[op
司徒千鍾	si[vh tu[rz qm[pu vs[jv
四象步法	si[we xl[dk bu[vu fa[dt
四象掌法	si[we xl[dk vh[xf fa[dt
司陰	si[vh yb[eo
司陰者	si[vh yb[eo ve[to
嵩山劍法	ss[uw uj[uk jm[rd fa[dt
宋善朋	ss[ga uj[yk pg[oo
松濤如雷	ss[ab tc[df ru[nk lw[yt
宋天保	ss[ga tm[hd bc[rk
宋甜兒	ss[ga tm[qg er[pv
宋五	ss[ga wu[hu
松下對弈	ss[ab xx[hb dv[yc yi[yc
宋獻策	ss[ga xm[uq ce[vc
嵩旭一振	ss[uw xu[jo yi[hh vf[fi
嵩陽幹元	ss[uw yh[eo gj[hu yr[ee
嵩陽派	ss[uw yh[eo pd[dp
宋長老	ss[ga vh[ph lc[tb
搜魂使	sz[fj hy[eg ui[rh
搜魂術	sz[fj hy[eg uu[ad
蘇岡	su[cl gh[ki
蘇李宋	su[cl li[az ss[ga
蘇夢清	su[cl mg[ax qk[df
蘇普	su[cl pu[bo
蘇荃	su[cl qr[cr
蘇三姐	su[cl sj[hh jp[nq
蘇習之	su[cl xi[vd vi[dv
酸儒文人	sr[ys ru[ry wf[wi rf[pd
孫大善	sy[zx da[hr uj[yk
孫剛峰	sy[zx gh[kd fg[uw
孫克通	sy[zx ke[ge ts[sz
孫老三	sy[zx lc[tb sj[hh
孫三毀	sy[zx sj[hh hv[jj
孫思克	sy[zx si[tx ke[ge
孫萬年	sy[zx wj[hv nm[rn
孫小紅	sy[zx xn[ub hs[sg
孫秀清	sy[zx xq[hn qk[df
孫學圃	sy[zx xt[xz pu[wf
損則有孚	sy[fk ze[bd yz[uo fu[az
孫仲壽	sy[zx vs[rv uz[fc
孫仲尹	sy[zx vs[rv yb[xp
縮地成寸	so[sg di[ty ig[wv cy[hu
索命使	so[uy mk[rh ui[rh
太別山	td[dd bp[kd uj[uk
太皇太后	td[dd hl[bw td[dd hz[pk
太極兩儀生滅陣	td[dd ji[aj ll[hk yi[rd ug[pf mp[hh vf[ei
泰山劍法	td[su uj[uk jm[rd fa[dt
泰山十八盤	td[su uj[uk ui[hu ba[pd pj[vm
太虛子	td[dd xu[hy zi[lh
太玄神功	td[dd xr[wy uf[uo gs[gl
太陽令	td[dd yh[eo lk[rd
太陽使	td[dd yh[eo ui[rh
太乙派	td[dd yi[vv pd[dp
太嶽三青峰	td[dd yt[qu sj[hh qk[fo fg[uw
太祖棒	td[dd zu[uq bh[as
太祖長拳	td[dd zu[uq ih[ph qr[bf
譚迪人	tj[yx di[yz rf[pd
譚青	tj[yx qk[fo
譚文理	tj[yx wf[wi li[wo
檀中	tj[aw vs[ku
唐方一戰	th[gx fh[dw yi[hh vj[bg
唐光雄	th[gx gl[xe xs[uv
唐六爺	th[gx lq[wb ye[be
唐詩劍法	th[gx ui[yt jm[rd fa[dt
唐文亮	th[gx wf[wi ll[wj
唐洋	th[gx yh[dy
湯祖德	th[dv zu[uq de[ru
陶百歲	tc[eb bd[eo sv[ux
桃幹仙	tc[av gj[hu xm[ru
陶管家	tc[eb gr[vg jx[gu
陶紅英	tc[eb hs[sg yk[ck
陶師傅	tc[eb ui[uh fu[rf
陶子安	tc[eb zi[lh an[gn
藤萍	tg[co pk[cd
騰一雷	tg[ob yi[hh lw[yt
提手上式	ti[fo uz[su uh[bh ui[qg
天長掌法	tm[hd ih[ph vh[xf fa[dt
天道仙域宗	tm[hd dc[bz xm[ru yu[tg zs[ge
天地真人	tm[hd di[ty vf[uj rf[pd
天防結界	tm[hd fh[ef jp[su jp[tr
天峰大師	tm[hd fg[uw da[hr ui[uh
天楓十四郎	tm[hd fg[af ui[hu si[we lh[le
天賦秉異	tm[hd fu[bw bk[ph yi[kc
天賦異秉	tm[hd fu[bw yi[kc bk[ph
天罡梅花樁	tm[hd gh[sh mw[ar hx[cr vl[ag
天艮真人	tm[hd gf[xv vf[uj rf[pd
天虹禪師	tm[hd hs[ig ij[ub ui[uh
天狐星	tm[hd hu[qp xk[op
田見秀	tm[wu jm[ke xq[hn
天決上人	tm[hd jt[dv uh[bh rf[pd
天雷真人	tm[hd lw[yt vf[uj rf[pd
天離真人	tm[hd li[wk vf[uj rf[pd
天龍八部	tm[hd ls[yp ba[pd bu[le
天羅地網勢	tm[hd lo[sx di[ty wh[ki ui[fl
天門道人	tm[hd mf[du dc[bz rf[pd
天鳴方丈	tm[hd mk[kn fh[dw vh[hi
田青文	tm[wu qk[fo wf[wi
天嫂	tm[hd sc[nj
天山六陽掌	tm[hd uj[uk lq[wb yh[eo vh[xf
天山折梅手	tm[hd uj[uk ve[fj mw[ar uz[su
天紳倒懸	tm[hd uf[so dc[rh xr[qx
天師符菉宗	tm[hd ui[uh fu[vr lu[[ zs[ge
天樞星力劍	tm[hd uu[ak xk[op li[vp jm[rd
天樞星力箭	tm[hd uu[ak xk[op li[vp jm[vb
天樞星力網	tm[hd uu[ak xk[op li[vp wh[ki
天水真人	tm[hd uv[uu vf[uj rf[pd
天松道人	tm[hd ss[ab dc[bz rf[pd
天孫織錦	tm[hd sy[zx vi[sk jb[jb
天外飛龍	tm[hd wd[xb fw[vp ls[yp
天外來雲	tm[hd wd[xb ld[hm yy[es
天王補心針	tm[hd wh[su bu[yb xb[dv vf[ju
天虛	tm[hd xu[hy
天巽真	tm[hd xy[kg vf[uj
天乙道人	tm[hd yi[vv dc[bz rf[pd
天澤真人	tm[hd ze[dy vf[uj rf[pd
天竺佛指	tm[hd vu[ve fo[rf vi[fb
天柱劍法	tm[hd vu[ad jm[rd fa[dt
天竺僧	tm[hd vu[ve sg[rb
天竺僧人	tm[hd vu[ve sg[rb rf[pd
天柱雲氣	tm[hd vu[ad yy[es qi[rh
調和醬油	tn[yk he[hk jl[dy yz[dy
鐵鉤功夫	tp[jp gz[jb gs[gl fu[er
鐵劍門	tp[jp jm[rd mf[du
鐵開誠	tp[jp kd[hc ig[yw
鐵蓮子	tp[jp lm[ci zi[lh
鐵門閂刀法	tp[jp mf[du ur[mh dc[vp fa[dt
鐵牛耕地	tp[jp nq[pf gg[le di[ty
鐵琵琶手	tp[jp pi[wb pa[wb uz[su
鐵騎突出	tp[jp qi[md tu[xq iu[ck
鐵線拳	tp[jp xm[sj qr[bf
鐵血基地	tp[jp xt[pm ji[qt di[ty
鐵血星	tp[jp xt[pm xk[op
鐵掌	tp[jp vh[xf
鐵指訣	tp[jp vi[fb jt[yv
鐵中棠	tp[jp vs[ku th[xa
鐵帚腿法	tp[jp vz[xj tv[og fa[dt
童百熊	ts[lo bd[eo xs[sd
童大海	ts[lo da[hr hd[dr
同歸劍法	ts[kh gv[ux jm[rd fa[dt
佟國綱	ts[rw go[ww gh[sk
童懷道	ts[lo hk[xb dc[bz
童家流星錘法	ts[lo jx[gu lq[dw xk[op iv[ji fa[dt
童兆和	ts[lo vc[eu he[hk
同桌後生	ts[kh vo[ba hz[pk ug[pf
透骨打穴	tz[hz gu[ko da[fd xt[gb
禿筆翁	tu[hj bi[vm wg[bx
圖爾布青	tu[ww er[dx bu[uj qk[fo
圖海道	tu[ww hd[dr dc[bz
土系道術	tu[uh xi[py dc[bz uu[ad
推窗望月	tv[fv il[xp wh[ww yt[ke
吞火情懷	ty[tk ho[dp qk[xf hk[xb
瓦爾拉齊	wa[hv er[dx la[fl qi[wp
萬大平	wj[hv da[hr pk[hb
萬圭	wj[hv gv[tt
萬花劍法	wj[hv hx[cr jm[rd fa[dt
萬里風	wj[hv li[ot fg[ji
萬路雷霆	wj[hv lu[zw lw[yt tk[yq
萬慶瀾	wj[hv qk[gd lj[dm
萬蛇洶湧	wj[hv ue[ig xs[di ys[ds
完顏阿古打	wj[ge yj[ly aa[ek gu[uk da[fd
完顏洪熙	wj[ge yj[ly hs[dg xi[kd
完顏萍	wj[ge yj[ly pk[cd
萬震山	wj[hv vf[yi uj[uk
王八衰	wh[su ba[pd uk[wk
王保保	wh[su bc[rk bc[rk
王伯奮	wh[su bo[rb ff[dt
王動	wh[su ds[el
王罕	wh[su hj[gg
汪浩天	wh[dw hc[dn tm[hd
王家駒	wh[su jx[gu ju[mb
王家駿	wh[su jx[gu jy[ms
王劍傑	wh[su jm[rd jp[ad
王進寶	wh[su jb[ez bc[gw
王老六	wh[su lc[tb lq[wb
王難姑	wh[su nj[yv gu[ng
王十三	wh[su ui[hu sj[hh
王師兄	wh[su ui[uh xs[ke
汪鐵鶚	wh[dw tp[jp ee[kn
王鐵匠	wh[su tp[jp jl[kj
王萬仞	wh[su wj[hv rf[rd
汪萬翼	wh[dw wj[hv yi[xt
王維揚	wh[su ww[sv yh[fv
王惟忠	wh[su ww[xv vs[vx
王武通	wh[su wu[hv ts[sz
王元霸	wh[su yr[ee ba[yg
王掌櫃	wh[su vh[xf gv[ak
王志坦	wh[su vi[ux tj[to
王仲萍	wh[su vs[rv pk[cd
王仲強	wh[su vs[rv ql[gk
王字四刀	wh[su zi[gz si[we dc[vp
衛璧	ww[eh bi[uw
韋春花	ww[hh iy[so hx[cr
衛春華	ww[eh iy[so hx[ru
衛鳳娘	ww[eh fg[jy nl[nl
衛四娘	ww[eh si[we nl[nl
韋陀門	ww[hh to[eg mf[du
韋陀掌	ww[hh to[eg vh[xf
韋一笑	ww[hh yi[hh xn[vp
威震瑪法	ww[wh vf[yi ma[wm fa[dt
聞蒼松	wf[me ch[cr ss[ab
溫黛黛	wf[do dd[rh dd[rh
溫方達	wf[do fh[dw da[dz
溫方山	wf[do fh[dw uj[uk
溫方施	wf[do fh[dw ui[fr
溫方悟	wf[do fh[dw wu[xw
溫方義	wf[do fh[dw yi[di
文君當爐	wf[wi jy[xk dh[xx lu[hh
溫南揚	wf[do nj[uk yh[fv
溫青	wf[do qk[fo
溫仁厚	wf[do rf[re hz[io
溫柔一刀	wf[do rz[ya yi[hh dc[vp
文泰來	wf[wi td[su ld[hm
聞萬夫	wf[me wj[hv fu[er
聞先生	wf[me xm[ne ug[pf
溫有道	wf[do yz[uo dc[bz
溫有方	wf[do yz[uo fh[dw
溫正	wf[do vg[hv
文醉翁	wf[wi zv[yw wg[bx
吳柏英	wu[kt bd[ab yk[ck
武版	wu[hv bj[pp
吳寶宇	wu[kt bc[gw yu[ge
吳鏢頭	wu[kt bn[jx tz[dd
無常抖索	wu[ee ih[xk dz[fd so[uy
吳長風	wu[kt ih[ph fg[ji
無常鬼	wu[ee ih[xk gv[be
無常鎖命	wu[ee ih[xk so[jx mk[rh
無塵道人	wu[ee if[xt dc[bz rf[pd
無塵道長	wu[ee if[xt dc[bz vh[ph
五大夫劍	wu[hu da[hr fu[er jm[rd
吳大鵬	wu[kt da[hr pg[on
武當長拳	wu[hv dh[xx ih[ph qr[bf
吳道通	wu[kt dc[bz ts[sz
五斗米神功	wu[hu dz[du mi[ba uf[uo gs[gl
五毒神掌	wu[hu du[fm uf[uo vh[xf
武敦儒	wu[hv dy[ww ru[ry
五符	wu[hu fu[vr
無根道人	wu[ee gf[ag dc[bz rf[pd
五姑	wu[hu gu[ng
吳光勝	wu[kt gl[xe ug[op
五鬼投叉	wu[hu gv[be tz[fj ia[yd
無極玄功拳	wu[ee ji[aj xr[wy gs[gl qr[bf
無教豔質為眷屬	wu[ee jn[tw yj[fd vi[pu ww[dl jr[bm uu[up
無劫飛昇	wu[ee jp[tl fw[vp ug[pc
吳菊軒	wu[kt ju[cb xr[ig
吳坎	wu[kt kj[td
五雷灌頂	wu[hu lw[yt gr[dc dk[dy
吳立身	wu[kt li[lh uf[pu
無量劍	wu[ee ll[oh jm[rd
無量劍法	wu[ee ll[oh jm[rd fa[dt
武烈	wu[hv lp[hd
吳六破	wu[kt lq[wb po[ep
五羅輕煙掌	wu[hu lo[sx qk[is yj[hw vh[xf
武銘	wu[hv mk[jx
吳青烈	wu[kt qk[fo lp[hd
武青嬰	wu[hv qk[fo yk[bn
無青子	wu[ee qk[fo zi[lh
巫如鹹	wu[gr ru[nk xm[wh
武三娘	wu[hv sj[hh nl[nl
武三通	wu[hv sj[hh ts[sz
無色無相	wu[ee se[db wu[ee xl[am
無生者	wu[ee ug[pf ve[to
無雙無對	wu[ee ul[yy wu[ee dv[yc
五臺山清涼寺	wu[hu td[sk uj[uk qk[df ll[dw si[tc
吳天德	wu[kt tm[hd de[ru
烏旺阿普	wu[bv wh[ow aa[ek pu[bo
五賢對敘	wu[hu xm[ub dv[yc xu[ry
無相禪師	wu[ee xl[am ij[ub ui[uh
無相劫指	wu[ee xl[am jp[tl vi[fb
無相音罡	wu[ee xl[am yb[lo gh[sh
悟星境	wu[xw xk[op jk[tl
悟星境第	wu[xw xk[op jk[tl di[vg
五行連環拳	wu[hu xk[rh lm[iz hr[wb qr[bf
五行六合掌	wu[hu xk[rh lu[wb he[rh vh[xf
武修文	wu[hv xq[ru wf[wi
午夜蘭花	wu[ru ye[wr lj[bs hx[cr
無影幻腿	wu[ee yk[op hr[yv tv[og
無憂真人	wu[ee yz[xy vf[uj rf[pd
吳之榮	wu[kt vi[dv rs[ca
霧中初見	wu[yw vs[ku iu[yd jm[ke
五轉幽冥	wu[hu vr[ie yz[yy mk[go
西奧圖三世	xi[hk ao[pd tu[ww sj[hh ui[nv
西川雙俠	xi[hk ir[pu ul[yy xx[rj
西窗夜話	xi[hk il[xp ye[wr hx[yq
西毒杖法	xi[hk du[fm vh[ah fa[dt
西風倒卷	xi[hk fg[ji dc[rh jr[be
西華子	xi[hk hx[ru zi[lh
西靈道人	xi[hk lk[xh dc[bz rf[pd
西門吹雪	xi[hk mf[du iv[kd xt[yx
西門觀止	xi[hk mf[du gr[yj vi[uh
西失	xi[hk ui[pe
洗髓經	xi[dn sv[gu jk[ss
西夏宮女	xi[hk xx[ew gs[gk nv[vp
西夏回人	xi[hk xx[ew hv[wk rf[pd
希夷劍	xi[iu yi[hg jm[rd
奚長老	xi[ay vh[ph lc[tb
峽谷天風	xx[uj gu[bk tm[hd fg[ji
夏國相	xx[ew go[ww xl[am
俠客行	xx[rj ke[gw xk[rh
夏老拳師	xx[ew lc[tb qr[bf ui[uh
俠少	xx[rj uc[xp
俠以武犯禁	xx[rj yi[sr wu[hv fj[qe jb[ae
霞雲迴繞	xx[yk yy[es hv[wk rc[sq
夏胄	xx[ew vz[yo
仙閉	xm[ru bi[mc
仙帝	xm[ru di[lj
仙定	xm[ru dk[gp
仙都派	xm[ru du[te pd[dp
仙封	xm[ru fg[tc
仙固	xm[ru gu[wg
閒過信陵飲	xm[ma go[cz xb[ry lk[et yb[ud
仙后令者	xm[ru hz[pk lk[rd ve[to
仙劍斬龍	xm[ru jm[rd vj[ij ls[yp
仙解	xm[ru jp[dd
仙禁	xm[ru jb[ae
仙靈威壓結界	xm[ru lk[xh ww[wh ya[it jp[su jp[tr
仙破	xm[ru po[ep
仙器坊	xm[ru qi[kq fh[tf
鮮于通	xm[yy yu[eu ts[sz
向大年	xl[pk da[hr nm[rn
響隔樓臺	xl[kp ge[eh lz[am td[sk
相國夫人	xl[am go[ww fu[er rf[pd
降龍十八掌	xl[ew ls[yp ui[hu ba[pd vh[xf
降魔刀法	xl[ew mo[gg dc[vp fa[dt
項長老	xl[gy vh[ph lc[tb
笑傲江湖	xn[vp ao[rf jl[dg hu[dg
蕭半和	xn[cx bj[bf he[hk
小鬼叫門	xn[ub gv[be jn[kv mf[du
小桂子	xn[ub gv[at zi[lh
笑臉鬼	xn[vp lm[or gv[be
小憐橫陳	xn[ub lm[xr hg[ag if[eq
小擒拿手	xn[ub qb[fr na[rf uz[su
蕭少英	xn[cx uc[xp yk[ck
蕭史乘龍	xn[cx ui[ki ug[qb ls[yp
簫史乘龍	xn[vx ui[ki ug[qb ls[yp
蕭石逸	xn[cx ui[ek yi[dz
小王將軍	xn[ub wh[su jl[dx jy[gi
小無相功	xn[ub wu[ee xl[am gs[gl
蕭湘道長	xn[cx xl[da dc[bz vh[ph
逍遙劍宗	xn[xz yc[az jm[rd zs[ge
逍遙遊	xn[xz yc[az yz[df
逍遙掌	xn[xz yc[az vh[xf
逍遙子	xn[xz yc[az zi[lh
小夜叉棍	xn[ub ye[wr ia[yd gy[ao
小園藝菊	xn[ub yr[we yi[cv ju[cb
蕭中慧	xn[cx vs[ku hv[fx
謝不當	xp[yu bu[eu dh[xx
斜打狗背	xp[rd da[fd gz[qb bw[bo
謝鏗	xp[yu kg[ju
蟹鉗功	xp[di qm[jg gs[gl
謝遜	xp[yu xy[zz
謝煙客	xp[yu yj[hw ke[gw
心動期	xb[dv ds[el qi[qo
辛國樑	xb[lu go[ww ll[da
辛然	xb[lu rj[xd
心溪	xb[dv xi[da
心硯	xb[dv yj[ej
心意氣混元功	xb[dv yi[lx qi[rh hy[do yr[ee gs[gl
星辰裂	xk[op if[ie lp[hy
星辰破碎	xk[op if[ie po[ep sv[ew
星辰子	xk[op if[ie zi[lh
行痴	xk[rh ii[bu
行顛	xk[rh dm[uy
星盾	xk[op dy[pu
星光輝映	xk[op gl[xe hv[xg yk[ok
星空投影	xk[op ks[xg tz[fj yk[op
星力法陣	xk[op li[vp fa[dt vf[ei
星破	xk[op po[ep
星演上人	xk[op yj[dg uh[bh rf[pd
雄霸群山	xs[uv ba[yg qy[xy uj[uk
熊貓兒	xs[sd mc[qc er[pv
雄娘子	xs[uv nl[nl zi[lh
熊元獻	xs[sd yr[ee xm[uq
修羅棋盤城	xq[ru lo[sx qi[aq pj[vm ig[tw
修魔悟道者	xq[ru mo[gg wu[xw dc[bz ve[to
袖中指	xq[yy vs[ku vi[fb
虛魔	xu[hy mo[gg
虛式分金	xu[hy ui[qg ff[bd jb[rw
徐天川	xu[rr tm[hd ir[pu
徐天宏	xu[rr tm[hd hs[gu
虛無宗	xu[hy wu[ee zs[ge
許雪亭	xu[yw xt[yx tk[wd
徐長老	xu[rr vh[ph lc[tb
徐錚	xu[rr vg[jd
許卓誠	xu[yw vo[bo ig[yw
懸浮飛車	xr[qx fu[da fw[vp ie[qu
煊赫大梁城	xr[hg he[tt da[hr ll[da ig[tw
玄慧	xr[wy hv[fx
玄機子	xr[wy ji[aj zi[lh
玄覺	xr[wy jt[xj
玄空	xr[wy ks[xg
玄苦	xr[wy ku[cg
玄冥二老	xr[wy mk[go er[hh lc[tb
玄魔級別	xr[wy mo[gg ji[sj bp[kd
玄天指	xr[wy tm[hd vi[fb
玄鐵劍法	xr[wy tp[jp jm[rd fa[dt
玄痛	xr[wy ts[bs
玄通子	xr[wy ts[sz zi[lh
玄武天君	xr[wy wu[hv tm[hd jy[xk
軒無翼	xr[ig wu[ee yi[xt
玄虛刀法	xr[wy xu[hy dc[vp fa[dt
玄玄刀法	xr[wy xr[wy dc[vp fa[dt
玄衣	xr[wy yi[wy
玄真道人	xr[wy vf[uj dc[bz rf[pd
血刀刀法	xt[pm dc[vp dc[vp fa[dt
血刀門	xt[pm dc[vp mf[du
薛夫人	xt[cp fu[er rf[pd
薛公遠	xt[cp gs[bs yr[ez
薛慕華	xt[cp mu[cx hx[ru
雪歐上人	xt[yx ou[kd uh[bh rf[pd
薛鵲	xt[cp qt[gn
雪山飛狐	xt[yx uj[uk fw[vp hu[qp
雪山劍法	xt[yx uj[uk jm[rd fa[dt
雪擁藍橋	xt[yx ys[fo lj[cu qn[ap
雪中奇蓮	xt[yx vs[ku qi[dk lm[ci
迅雷劍	xy[vz lw[yt jm[rd
啞婆婆	ya[kh po[dn po[dn
啞梢公	ya[kh uc[ax gs[bs
言伯乾	yj[we bo[rb qm[ur
言達平	yj[we da[dz pk[hb
燕歌	yj[nk ge[kd
雁行刀	yj[ir hh[rh dc[vp
雁行輕功	yj[ir hh[rh qk[is gs[gl
雁迴天南	yj[ir hv[wk tm[hd nj[uk
雁回祝融	yj[ir hv[wk vu[uk rs[hi
閻基	yj[md ji[qt
言家拳	yj[we jx[gu qr[bf
嚴媽媽	yj[hy ma[nm ma[nm
雁破九重	yj[ir po[ep jq[pv is[ph
燕七	yj[nk qi[hv
嚴三星	yj[hy sj[hh xk[op
閻世魁	yj[md ui[nv kv[gd
燕十三	yj[nk ui[hu sj[hh
閻世章	yj[md ui[nv vh[lo
煙鎖霧攏	yj[hw so[jx wu[yw ls[fy
閻王點名	yj[md wh[su dm[bd mk[xk
閻王擲筆	yj[md wh[su vi[fb bi[vm
炎炎功	yj[hh yj[hh gs[gl
焉知魚	yj[hh vi[uk yu[dt
楊成協	yh[av ig[wv xp[ul
楊姐姐	yh[av jp[nq jp[nq
楊景亭	yh[av jk[ow tk[wd
楊老令公	yh[av lc[tb lk[rd gs[bs
楊鵬舉	yh[av pg[on ju[xf
陽蹺脈	yh[eo qn[zq md[od
陽山迭迭	yh[eo uj[uk dp[pz dp[pz
陽維脈	yh[eo ww[sv md[od
養吾劍	yh[yp wu[wk jm[rd
楊溢之	yh[av yi[db vi[dv
楊中慧	yh[av vs[ku hv[fx
姚必達	yc[nv bi[xp da[dz
姚伯當	yc[nv bo[rb dh[xx
姚春	yc[nv iy[so
姚清泉	yc[nv qk[df qr[bu
遙天浸白波	yc[az tm[hd jb[dx bd[po bo[dp
夜半烽煙	ye[wr bj[bf fg[hw yj[hw
葉長青	ye[ku ih[ph qk[fo
耶律晉	ye[ee lv[ry jb[ho
耶律涅魯古	ye[ee lv[ry np[do lu[yo gu[uk
耶律燕	ye[ee lv[ry yj[nk
耶律重元	ye[ee lv[ry vs[ph yr[ee
野馬奔馳	ye[oy ma[vv bf[du ii[my
葉夢色	ye[ku mg[ax se[db
夜繡鴛鴦	ye[wr xq[sh yr[xn yh[kn
疑兵之計	yi[bs bk[qb vi[dv ji[yu
易塵天	yi[ob if[xt tm[hd
易重天	yi[ob is[ph tm[hd
易大彪	yi[ob da[hr bn[hp
易國梓	yi[ob go[ww zi[al
儀和	yi[rd he[hk
易吉	yi[ob ji[uk
一劍封魔	yi[hh jm[rd fg[tc mo[gg
易筋煅骨篇	yi[ob jb[vo dr[hp gu[ko pm[vh
易筋經	yi[ob jb[vo jk[ss
意氣素霓生	yi[lx qi[rh su[fy ni[yj ug[pf
儀清	yi[rd qk[df
易三娘	yi[ob sj[hh nl[nl
義生	yi[di ug[pf
一十八路登堂拳	yi[hh ui[hu ba[pd lu[zw dg[dd th[xt qr[bf
一十二路入室拳	yi[hh ui[hu er[hh lu[zw ru[pd ui[gh qr[bf
易師爺	yi[ob ui[uh ye[be
易水天	yi[ob uv[uu tm[hd
易堂主	yi[ob th[xt vu[dw
倚天屠龍筆法	yi[rd tm[hd tu[ut ls[yp bi[vm fa[dt
倚天屠龍記	yi[rd tm[hd tu[ut ls[yp ji[yk
一嘯風生	yi[hh xn[kx fg[ji ug[pf
一陽指	yi[hh yh[eo vi[fb
一字電劍	yi[hh zi[gz dm[ov jm[rd
陰風刀	yb[eo fg[ji dc[vp
陰風吼	yb[eo fg[ji hz[kz
銀河橫空	yb[jg he[dk hg[ag ks[xg
隱狐族	yb[ed hu[qp zu[fr
殷吉	yb[pj ji[uk
殷錦	yb[pj jb[jb
尹克西	yb[xp ke[ge xi[hk
殷離	yb[pj li[wk
隱魔一族	yb[ed mo[gg yi[hh zu[fr
陰蹺脈	yb[eo qn[zq md[od
陰山鬼帥	yb[eo uj[uk gv[be uk[uj
陰山掌大九式	yb[eo uj[uk vh[xf da[hr jq[pv ui[qg
銀索金鈴索法	yb[jg so[uy jb[rw lk[jr so[uy fa[dt
殷天正	yb[pj tm[hd vg[hv
因陀羅抓	yb[wd to[eg lo[sx vx[fp
陰維脈	yb[eo ww[sv md[od
殷無福	yb[pj wu[ee fu[uh
殷無祿	yb[pj wu[ee lu[ux
殷無壽	yb[pj wu[ee uz[fc
陰陽訣	yb[eo yh[eo jt[yv
殷野王	yb[pj ye[oy wh[su
尹章垓	yb[xp vh[lo gd[tw
殷仲翔	yb[pj vs[rv xl[yx
英白羅	yk[ck bd[po lo[sx
英顎	yk[ck ee[ky
鷹蛇生死搏	yk[gn ue[ig ug[pf si[hx bo[ff
應松	yk[gx ss[ab
英雄三招	yk[ck xs[uv sj[hh vc[fd
英長老	yk[ck vh[ph lc[tb
鷹爪力	yk[gn vc[pu li[vp
鷹爪擒拿手	yk[gn vc[pu qb[fr na[rf uz[su
鷹爪雁行門	yk[gn vc[pu yj[ir hh[rh mf[du
永慈	ys[dv ci[bx
永恆視覺墨水	ys[dv hg[xh ui[uj jt[xj mo[ht uv[uu
庸醫下藥	ys[gx yi[ku xx[hb yc[cs
尤得勝	yz[yd de[ro ug[op
遊驥	yz[df ji[mb
遊駒	yz[df ju[mb
優客李玲	yz[ry ke[gw li[az lk[wr
游龍探爪	yz[df ls[yp tj[fg vc[pu
優生者	yz[ry ug[pf ve[to
右書僮	yz[uk uu[vv ts[rl
遊迅	yz[df xy[vz
有冤報冤	yz[uo yr[gd bc[fe yr[gd
於八	yu[eu ba[pd
俞朝奉	yu[rh ic[uo fg[sf
尉遲連	yu[uc ii[uz lm[iz
雨打飛花劍法	yu[hk da[fd fw[vp hx[cr jm[rd fa[dt
玉帶圍腰	yu[wd dd[cj ww[ww yc[ox
俞岱巖	yu[rh dd[ru yj[ue
魚販頭子	yu[dt fj[bp tz[dd zi[lh
於管家	yu[eu gr[vg jx[gu
鬱光標	yu[ue gl[xe bn[ae
於光豪	yu[eu gl[xe hc[wu
餘護花	yu[re hu[fh hx[cr
玉進天池	yu[wd jb[ez tm[hd ii[dy
俞連舟	yu[rh lm[iz vz[pk
玉靈道人	yu[wd lk[xh dc[bz rf[pd
玉女劍法	yu[wd nv[vp jm[rd fa[dt
玉女劍十九式	yu[wd nv[vp jm[rd ui[hu jq[pv ui[qg
玉女素心劍	yu[wd nv[vp su[fy xb[dv jm[rd
玉女素心劍法	yu[wd nv[vp su[fy xb[dv jm[rd fa[dt
俞佩玉	yu[rh pw[rj yu[wd
玉磬子	yu[wd qk[ue zi[lh
於人豪	yu[eu rf[pd hc[wu
餘人彥	yu[re rf[pd yj[lp
於嫂	yu[eu sc[nj
馭獸師	yu[my uz[bh ui[uh
漁叟鉤法	yu[dy sz[jy gz[jb fa[dt
玉碎昆岡	yu[wd sv[ew ky[ob gh[ki
於萬亭	yu[eu wj[hv tk[wd
御下不嚴	yu[rw xx[hb bu[eu yj[hy
玉蕭劍法	yu[wd xn[cx jm[rd fa[dt
玉簫劍法	yu[wd xn[vx jm[rd fa[dt
羽衣刀	yu[xx yi[wy dc[vp
玉音子	yu[wd yb[lo zi[lh
餘魚同	yu[re yu[dt ts[kh
魚躍於淵	yu[dt yt[zp yu[eu yr[dp
餘兆興	yu[re vc[eu xk[xb
玉真子	yu[wd vf[uj zi[lh
玉鍾子	yu[wd vs[jv zi[lh
羽字家族	yu[xx zi[gz jx[gu zu[fr
元悲	yr[ee bw[fx
元澄道人	yr[ee ig[dd dc[bz rf[pd
袁夫人	yr[tk fu[er rf[pd
緣根	yr[sv gf[ag
袁冠南	yr[tk gr[ge nj[uk
元廣波	yr[ee gl[di bo[dp
怨魂纏足	yr[xx hy[eg ij[sg zu[kv
元傷	yr[ee uh[rr
袁士霄	yr[tk ui[uh xn[yx
袁士宵	yr[tk ui[uh xn[gx
原隨雲	yr[ib sv[eu yy[es
淵停嶽峙	yr[dp tk[rw yt[qu vi[ut
元痛	yr[ee ts[bs
鴛鴦刀	yr[xn yh[kn dc[vp
圓業	yr[wk ye[ub
元義方	yr[ee yi[di fh[dw
元嬰	yr[ee yk[bn
圓真	yr[wk vf[uj
月二聖	yt[ke er[hh ug[yt
越女劍法	yt[zh nv[vp jm[rd fa[dt
嶽揚	yt[qu yh[fv
粵州	yt[pk vz[dp
雲島主	yy[es dc[nu vu[dw
雲橫西嶺	yy[es hg[ag xi[hk lk[ur
雲強盜	yy[es ql[gk dc[dm
雲若卿	yy[es ro[cu qk[pg
雲若虛	yy[es ro[cu xu[hy
雲素梅	yy[es su[fy mw[ar
雲天空	yy[es tm[hd ks[xg
雲錚	yy[es vg[jd
雲中鶴	yy[es vs[ku he[gn
雲州秦家寨	yy[es vz[dp qb[sh jx[gu vd[ga
藏族牧民	zh[cw zu[fr mu[nw mb[kv
扎西嘉措	va[fv xi[hk jx[ul co[fg
展白	vj[ug bd[po
詹春	vj[dy iy[so
展飛	vj[ug fw[vp
斬蛟拳	vj[ij jn[il qr[bf
展夢白	vj[ug mg[ax bd[po
氈毯	vj[mb tj[mh
粘字訣	vj[mb zi[gz jt[yv
張阿生	vh[gi aa[ek ug[pf
張安官	vh[gi an[gn gr[gu
掌棒龍頭	vh[xf bh[as ls[yp tz[dd
掌缽龍頭	vh[xf bo[ja ls[yp tz[dd
張朝唐	vh[gi ic[uo th[gx
張春九	vh[gi iy[so jq[pv
張淡月	vh[gi dj[dh yt[ke
張二叔	vh[gi er[hh uu[uy
張飛雄	vh[gi fw[vp xs[uv
張管家	vh[gi gr[vg jx[gu
張繼麟	vh[gi ji[sm lb[gm
張潔潔	vh[gi jp[du jp[du
張金鏊	vh[gi jb[rw ao[fj
張九	vh[gi jq[pv
張康年	vh[gi kh[gx nm[rn
章老三	vh[lo lc[tb sj[hh
張媽	vh[gi ma[nm
張若谷	vh[gi ro[cu gu[bk
張十五	vh[gi ui[hu wu[hu
張松溪	vh[gi ss[ab xi[da
長孫紅	vh[ph sy[zx hs[sg
張姓老者	vh[gi xk[np lc[tb ve[to
張一氓	vh[gi yi[hh mh[wm
張召重	vh[gi vc[dk vs[ph
張志光	vh[gi vi[ux gl[xe
張總管	vh[gi zs[bx gr[vg
棹歌中流	vc[ab ge[kd vs[ku lq[dw
趙齊賢	vc[zi qi[wp xm[ub
照虛	vc[od xu[hy
趙洵	vc[zi xy[db
趙一傷	vc[zi yi[hh uh[rr
趙志敬	vc[zi vi[ux jk[cw
浙東祁家	ve[df ds[qx qi[ue jx[gu
者勒米	ve[to le[gl mi[ba
哲羅星	ve[fk lo[sx xk[op
鎮魂術	vf[ju hy[eg uu[ad
震山子	vf[yi uj[uk zi[lh
震天三十掌	vf[yi tm[hd sj[hh ui[hu vh[xf
震天鐵掌	vf[yi tm[hd tp[jp vh[xf
鄭鏢頭	vg[be bn[jx tz[dd
鄭豐	vg[be fg[su
鄭光芝	vg[be gl[xe vi[cv
鄭七滅	vg[be qi[hv mp[hh
鄭起雲	vg[be qi[zk yy[es
鄭三娘	vg[be sj[hh nl[nl
鄭長老	vg[be vh[ph lc[tb
執法長老	vi[fj fa[dt vh[ph lc[tb
織女穿衣	vi[sk nv[vp ir[xy yi[wy
止清	vi[uh qk[df
鍾阿四	vs[jv aa[ek si[we
中衝劍	vs[ku is[dv jm[rd
中東方家族	vs[ku ds[qx fh[dw jx[gu zu[fr
鐘鼓齊鳴	vs[jv gu[uu qi[wp mk[kn
中華聯盟	vs[ku hx[ru lm[eb mg[om
中華元	vs[ku hx[ru yr[ee
終極裁決	vs[sw ji[aj cd[ty jt[dv
重節守義	vs[ph jp[ce uz[gc yi[di
鍾馗抉目	vs[jp kv[jb jt[fv mu[we
中南全真劍宗	vs[ku nj[uk qr[rw vf[uj jm[rd zs[ge
中年武師	vs[ku nm[rn wu[hv ui[uh
鍾四嫂	vs[jv si[we sc[nj
鍾小二	vs[jv xn[ub er[hh
中原一點紅	vs[ku yr[ib yi[hh dm[bd hs[sg
鍾兆能	vs[jv vc[eu ng[sb
鍾兆文	vs[jv vc[eu wf[wi
鍾兆英	vs[jv vc[eu yk[ck
鍾鎮	vs[jv vf[ju
鍾志靈	vs[jv vi[ux lk[xh
周阿三	vz[kt aa[ek sj[hh
周伯通	vz[kt bo[rb ts[sz
周大奶奶	vz[kt da[hr nd[nn nd[nn
周公劍	vz[kt gs[bs jm[rd
周孤桐	vz[kt gu[zp ts[ak
周隆	vz[kt ls[ew
周牧	vz[kt mu[nw
周圻	vz[kt qi[tj
周綺	vz[kt qi[sd
周鐵鶴	vz[kt tp[jp he[gn
周威信	vz[kt ww[wh xb[ry
週五輸	vz[kt wu[hu uu[ir
周英傑	vz[kt yk[ck jp[ad
周雲陽	vz[kt yy[es yh[eo
周仲英	vz[kt vs[rv yk[ck
朱安國	vu[ph an[gn go[ww
諸保昆	vu[yt bc[rk ky[ob
祝鏢頭	vu[uk bn[jx tz[dd
朱長齡	vu[ph ih[ph lk[vr
朱聰	vu[ph cs[eb
褚轟	vu[yt hs[iy
褚紅柏	vu[yt hs[sg bd[ab
褚紅柳	vu[yt hs[sg lq[ap
朱九真	vu[ph jq[pv vf[uj
朱淚兒	vu[ph lw[dm er[pv
朱七七	vu[ph qi[hv qi[hv
朱雀天君	vu[ph qt[xv tm[hd jy[xk
祝融劍法	vu[uk rs[hi jm[rd fa[dt
蛛索功夫	vu[ip so[uy gs[gl fu[er
朱停	vu[ph tk[rw
褚萬春	vu[yt wj[hv iy[so
誅心使	vu[yp xb[dv ui[rh
褚圓	vu[yt yr[wk
朱貞儀	vu[ph vf[bb yi[rd
朱子柳	vu[ph zi[lh lq[ap
朱祖蔭	vu[ph zu[uq yb[ce
賺便宜	vr[bb pm[rh yi[gq
顓魖魔尊	vr[uy xu[[ mo[gg zy[bc
莊夫人	vl[gt fu[er rf[pd
莊廷龍	vl[gt tk[qj ls[yp
莊允城	vl[gt yy[se ig[tw
莊錚	vl[gt vg[jd
追魂奪命劍	vv[pz hy[eg do[dc mk[rh jm[rd
追神使	vv[pz uf[uo ui[rh
卓不凡	vo[bo bu[eu fj[jd
卓天雄	vo[bo tm[hd xs[uv
捉影式	vo[fz yk[op ui[qg
子聰	zi[lh cs[eb
紫蓋劍法	zi[vy gd[bm jm[rd fa[dt
紫龍子	zi[vy ls[yp zi[lh
子母鐵膽	zi[lh mu[vv tp[jp dj[oo
紫霞功	zi[vy xx[yk gs[gl
子胥舉鼎	zi[lh xu[po ju[xf dk[mv
紫築宮丁	zi[vy vu[vg gs[gk dk[hu
總訣式	zs[bx jt[yv ui[qg
宗維俠	zs[ge ww[sv xx[rj
宗雄	zs[ge xs[uv
左冷禪	zo[ug lg[dr ij[ub
左書僮	zo[ug uu[vv ts[rl
左協侍	zo[ug xp[ul ui[rt
