哀而不傷	ai[wk er[ek bu[eu uh[rr
哀公問	ai[wk gs[bs wf[mk
哀公問社於宰我	ai[wk gs[bs wf[mk ue[ut yu[eu zd[gl wo[pf
哀公問於有若曰	ai[wk gs[bs wf[mk yu[eu yz[uo ro[cu yt[wh
哀公問曰	ai[wk gs[bs wf[mk yt[wh
愛人	ai[au rf[pd
愛之	ai[au vi[dv
愛之慾其生	ai[au vi[dv yu[bd qi[cb ug[pf
安見方六七十	an[gn jm[ke fh[dw lq[wb qi[hv ui[hu
安女安則為之	an[gn nv[vp an[gn ze[bd ww[dl vi[dv
安無傾	an[gn wu[ee qk[rb
奡盪舟	ao[[ dh[cd vz[pk
八佾第三	ba[pd yi[rb di[vg sj[hh
八佾舞於庭	ba[pd yi[rb wu[rx yu[eu tk[gq
霸諸侯	ba[yg vu[yt hz[rv
拜而受之	bd[fh er[ek uz[ay vi[dv
百工居肆以成其事	bd[eo gs[hu ju[ug si[iy yi[sr ig[wv qi[cb ui[hk
百官之富	bd[eo gr[gu vi[dv fu[gh
百官總己以聽於冢宰	bd[eo gr[gu zs[bx ji[kv yi[sr tk[kj yu[eu vs[gu zd[gl
百物生焉	bd[eo wu[nb ug[pf yj[hh
拜下	bd[fh xx[hb
百姓不足	bd[eo xk[np bu[eu zu[kv
百姓有過	bd[eo xk[np yz[uo go[cz
百姓足	bd[eo xk[np zu[kv
版者	bj[pp ve[to
邦分崩離析	bh[fe ff[bd bg[uo li[wk xi[aj
邦君樹塞門	bh[fe jy[xk uu[ay sd[gt mf[du
邦君為兩君之好	bh[fe jy[xk ww[dl ll[hk jy[xk vi[dv hc[nz
邦君之妻	bh[fe jy[xk vi[dv qi[hn
邦人稱之曰君夫人	bh[fe rf[pd ig[hd vi[dv yt[wh jy[xk fu[er rf[pd
邦無道	bh[fe wu[ee dc[bz
邦無道如矢	bh[fe wu[ee dc[bz ru[nk ui[rd
邦無道則可卷而懷之	bh[fe wu[ee dc[bz ze[bd ke[dk jr[be er[ek hk[xb vi[dv
邦有道	bh[fe yz[uo dc[bz
邦有道如矢	bh[fe yz[uo dc[bz ru[nk ui[rd
邦有道則仕	bh[fe yz[uo dc[bz ze[bd ui[ru
邦曰寡小君	bh[fe yt[wh gx[gf xn[ub jy[xk
暴虎馮河	bc[og hu[hj pk[dm he[dk
飽食終日	bc[ub ui[rl vs[sw ri[wh
奔而殿	bf[du er[ek dm[uj
本立而道生	bf[ah li[lh er[ek dc[bz ug[pf
本之則無	bf[ah vi[dv ze[bd wu[ee
必變	bi[xp bm[yy
必變色而作	bi[xp bm[yy se[db er[ek zo[rv
必表而出之	bi[xp bn[fy er[ek iu[ck vi[dv
必不得已而去	bi[xp bu[eu de[ro yi[kv er[ek qu[ts
必察焉	bi[xp ia[gx yj[hh
裨諶草創之	bi[yb if[yq cc[co il[rd vi[dv
必畜之	bi[xp iu[wt vi[dv
鄙夫可與事君也與哉	bi[ke fu[er ke[dk yu[hv ui[hk jy[xk ye[vu yu[hv zd[tk
必覆命曰	bi[xp fu[ro mk[rh yt[wh
比干諫而死	bi[bb gj[hu jm[yh er[ek si[hx
比及三年	bi[bb ji[pv sj[hh nm[rn
必齊如也	bi[xp qi[wp ru[nk ye[vu
必趨	bi[xp qu[zd
必殺之	bi[xp ua[ia vi[dv
必世而後仁	bi[xp ui[nv er[ek hz[pk rf[re
必使反之	bi[xp ui[rh fj[py vi[dv
必失之	bi[xp ui[pe vi[dv
必熟而薦之	bi[xp uu[wd er[ek jm[cu vi[dv
必文	bi[xp wf[wi
必聞其政	bi[xp wf[me qi[cb vg[hw
必先利其器	bi[xp xm[ne li[hd qi[cb qi[kq
必偃	bi[xp yj[rk
必也狂狷乎	bi[xp ye[vu kl[qw jr[qk hu[pb
必也臨事而懼	bi[xp ye[vu lb[uv ui[hk er[ek ju[xj
必也親喪乎	bi[xp ye[vu qb[la sh[ty hu[pb
必也射乎	bi[xp ye[vu ue[uc hu[pb
必也聖乎	bi[xp ye[vu ug[yt hu[pb
必也使無訟乎	bi[xp ye[vu ui[rh wu[ee ss[yb hu[pb
必也正名乎	bi[xp ye[vu vg[hv mk[xk hu[pb
必以貌	bi[xp yi[sr mc[pb
必有近憂	bi[xp yz[uo jb[jz yz[xy
必有可觀者焉	bi[xp yz[uo ke[dk gr[yj ve[to yj[hh
必有鄰	bi[xp yz[uo lb[re
必有明衣	bi[xp yz[uo mk[oo yi[wy
必有寢衣	bi[xp yz[uo qb[gd yi[wy
必有我師焉	bi[xp yz[uo wo[pf ui[uh yj[hh
鄙哉	bi[ke zd[tk
彼哉	bi[rp zd[tk
必正立執綏	bi[xp vg[hv li[lh vi[fj sv[sa
必正席先嚐之	bi[xp vg[hv xi[gn xm[ne ih[xe vi[dv
必作	bi[xp zo[rv
便便言	bm[rh bm[rh yj[we
籩豆之事	bm[vl dz[hk vi[dv ui[hk
辨惑	bm[ld ho[gx
卞莊子之勇	bm[dx vl[gt zi[lh vi[dv ys[sl
賓不顧矣	bb[gq bu[eu gu[iy yi[su
賓退	bb[gq tv[gz
病間	bk[bh jm[mo
屏氣似不息者	bk[ub qi[rh si[rs bu[eu xi[zx ve[to
伯牛有疾	bo[rb nq[pf yz[uo ji[bu
勃如戰色	bo[ul ru[nk vj[bg se[db
播鞀	bo[fp tc[vu
博我以文	bo[uf wo[pf yi[sr wf[wi
博學而篤志	bo[uf xt[xz er[ek du[vm vi[ux
博學而無所成名	bo[uf xt[xz er[ek wu[ee so[pj ig[wv mk[xk
博學於文	bo[uf xt[xz yu[eu wf[wi
伯夷叔	bo[rb yi[hg uu[uy
伯夷叔齊餓於首陽之下	bo[rb yi[hg uu[uy qi[wp ee[up yu[eu uz[be yh[eo vi[dv xx[hb
伯夷叔齊與	bo[rb yi[hg uu[uy qi[wp yu[hv
不拜	bu[eu bd[fh
不保其往也	bu[eu bc[rk qi[cb wh[rd ye[vu
不病人之不己知也	bu[eu bk[bh rf[pd vi[dv bu[eu ji[kv vi[uk ye[vu
不撤姜食	bu[eu ie[fw jl[bn ui[rl
不成人之惡	bu[eu ig[wv rf[pd vi[dv ee[hx
不處也	bu[eu iu[wb ye[vu
不達	bu[eu da[dz
不得	bu[eu de[ro
不得大葬	bu[eu de[ro da[hr zh[ch
不得其醬	bu[eu de[ro qi[cb jl[dy
不得其死然	bu[eu de[ro qi[cb si[hx rj[xd
不得與之言	bu[eu de[ro yu[hv vi[dv yj[we
不得中行而與之	bu[eu de[ro vs[ku hh[rh er[ek yu[hv vi[dv
不多也	bu[eu do[xx ye[vu
不貳過	bu[eu er[qb go[cz
不悱不發	bu[eu fw[xf bu[eu fa[vy
不憤不啟	bu[eu ff[xu bu[eu qi[hk
不敢不告也	bu[eu gj[vw bu[eu gc[nk ye[vu
不敢嘗	bu[eu gj[vw ih[xe
不好犯上	bu[eu hc[nz fj[qe uh[bh
不恆其德	bu[eu hg[xh qi[cb de[ru
不患寡	bu[eu hr[kx gx[gf
不患莫己知	bu[eu hr[kx mo[co ji[kv vi[uk
不患貧而患不安	bu[eu hr[kx pb[fb er[ek hr[kx bu[eu an[gn
不患人之不己知	bu[eu hr[kx rf[pd vi[dv bu[eu ji[kv vi[uk
不患無位	bu[eu hr[kx wu[ee ww[rl
不幾乎一言而	bu[eu ji[pv hu[pb yi[hh yj[we er[ek
不幾乎一言而興邦乎	bu[eu ji[pv hu[pb yi[hh yj[we er[ek xk[xb bh[fe hu[pb
不及亂	bu[eu ji[pv lr[qv
不疾言	bu[eu ji[bu yj[we
不踐跡	bu[eu jm[zj ji[yz
不見宗廟之美	bu[eu jm[ke zs[ge mn[gy vi[dv mw[bw
不教而殺謂之虐	bu[eu jn[tw er[ek ua[ia ww[yt vi[dv nt[hk
不戒視成謂之暴	bu[eu jp[gc ui[uj ig[wv ww[yt vi[dv bc[og
不敬	bu[eu jk[cw
不可	bu[eu ke[dk
不可不知也	bu[eu ke[dk bu[eu vi[uk ye[vu
不可廢也	bu[eu ke[dk fw[gv ye[vu
不可好從事而亟失時	bu[eu ke[dk hc[nz cs[rr ui[hk er[ek ji[lh ui[pe ui[oc
不可棄也	bu[eu ke[dk qi[wc ye[vu
不可使知之	bu[eu ke[dk ui[rh vi[uk vi[dv
不可徒行也	bu[eu ke[dk tu[rz xk[rh ye[vu
不可罔也	bu[eu ke[dk wh[kb ye[vu
不可陷也	bu[eu ke[dk xm[ed ye[vu
不可以長處樂	bu[eu ke[dk yi[sr ih[ph iu[wb le[px
不可以為滕薛大夫	bu[eu ke[dk yi[sr ww[dl tg[ob xt[cp dd[hr fu[er
不可以語上也	bu[eu ke[dk yi[sr yu[yw uh[bh ye[vu
不可以作巫醫	bu[eu ke[dk yi[sr zo[rv wu[gr yi[ku
不可與言而與之言	bu[eu ke[dk yu[hv yj[we er[ek yu[hv vi[dv yj[we
不可則止	bu[eu ke[dk ze[bd vi[uh
不令而行	bu[eu lk[rd er[ek xk[rh
不謀其政	bu[eu mz[yg qi[cb vg[hw
不能	bu[eu ng[sb
不能死	bu[eu ng[sb si[hx
不能以禮讓為國	bu[eu ng[sb yi[sr li[uv rh[yu ww[dl go[ww
不能用也	bu[eu ng[sb ys[ou ye[vu
不能者止	bu[eu ng[sb ve[to vi[uh
不能正其身	bu[eu ng[sb vg[hv qi[cb uf[pu
不能專對	bu[eu ng[sb vr[ev dv[yc
不逆詐	bu[eu ni[nz va[yv
不其	bu[eu qi[cb
布齊必變食	bu[uj qi[wp bi[xp bm[yy ui[rl
不遷怒	bu[eu qm[qz nu[nx
不親指	bu[eu qb[la vi[fb
不取乎	bu[eu qu[ey hu[pb
不去也	bu[eu qu[ts ye[vu
不然	bu[eu rj[xd
不仁者不可以久處約	bu[eu rf[re ve[to bu[eu ke[dk yi[sr jq[xd iu[wb yt[sb
不仁者遠矣	bu[eu rf[re ve[to yr[ez yi[su
不如好之者	bu[eu ru[nk hc[nz vi[dv ve[to
不辱君命	bu[eu ru[ic jy[xk mk[rh
不如樂之者	bu[eu ru[nk le[px vi[dv ve[to
不辱其身	bu[eu ru[ic qi[cb uf[pu
不如仁人	bu[eu ru[nk rf[re rf[pd
不如是之甚也	bu[eu ru[nk ui[op vi[dv uf[qv ye[vu
不如學也	bu[eu ru[nk xt[xz ye[vu
不如諸夏之亡也	bu[eu ru[nk vu[yt xx[ew vi[dv wh[wv ye[vu
不善不能改	bu[eu uj[yk bu[eu ng[sb gd[kw
不捨晝夜	bu[eu ue[rg vz[uo ye[wr
不食	bu[eu ui[rl
不時	bu[eu ui[oc
不使不仁者加乎其身	bu[eu ui[rh bu[eu rf[re ve[to jx[lk hu[pb qi[cb uf[pu
不使大臣怨乎不以	bu[eu ui[rh da[hr if[ku yr[xx hu[pb bu[eu yi[sr
不使勝食氣	bu[eu ui[rh ug[op ui[rl qi[rh
不仕無義	bu[eu ui[ru wu[ee yi[di
不食之矣	bu[eu ui[rl vi[dv yi[su
不說也	bu[eu uo[yb ye[vu
不俟駕行矣	bu[eu si[rs jx[lm xk[rh yi[su
不宿肉	bu[eu su[gr rz[kr
不圖為樂之至於斯也	bu[eu tu[ww ww[dl le[px vi[dv vi[ht yu[eu si[qj ye[vu
不違	bu[eu ww[wz
不為酒困	bu[eu ww[dl jq[dy ky[wa
不問馬	bu[eu wf[mk ma[vv
不吾知也如或知爾	bu[eu wu[wk vi[uk ye[vu ru[nk ho[gk vi[uk er[dx
不賢者識其小者	bu[eu xm[ub ve[to ui[yk qi[cb xn[ub ve[to
不降其志	bu[eu xl[ew qi[cb vi[ux
不相為謀	bu[eu xl[am ww[dl mz[yg
不笑	bu[eu xn[vp
不幸短命死矣	bu[eu xk[tb dr[ud mk[rh si[hx yi[su
不行焉	bu[eu xk[rh yj[hh
不學禮	bu[eu xt[xz li[uv
不學詩	bu[eu xt[xz ui[yt
不以兵車	bu[eu yi[sr bk[qb ie[qu
不億不信	bu[eu yi[rv bu[eu xb[ry
不易得也	bu[eu yi[ob de[ro ye[vu
不義而富且貴	bu[eu yi[di er[ek fu[gh qp[ke gv[vb
不亦君子乎	bu[eu yi[wy jy[xk zi[lh hu[pb
不亦可乎	bu[eu yi[wy ke[dk hu[pb
不亦樂乎	bu[eu yi[wy le[px hu[pb
不以禮節之	bu[eu yi[sr li[uv jp[ce vi[dv
不以其道得之	bu[eu yi[sr qi[cb dc[bz de[ro vi[dv
不以人廢言	bu[eu yi[sr rf[pd fw[gv yj[we
不亦善乎	bu[eu yi[wy uj[yk hu[pb
不亦宜乎	bu[eu yi[wy yi[gq hu[pb
不亦遠乎	bu[eu yi[wy yr[ez hu[pb
不亦說乎	bu[eu yi[wy yt[yb hu[pb
不亦重乎	bu[eu yi[wy vs[ph hu[pb
不有博弈者乎	bu[eu yz[uo bo[uf yi[yc ve[to hu[pb
不憂不懼	bu[eu yz[xy bu[eu ju[xj
不尤人	bu[eu yz[yd rf[pd
不有祝鮀之佞	bu[eu yz[uo vu[uk to[[ vi[dv nk[re
不逾矩	bu[eu yu[rz ju[uk
不與其退也	bu[eu yu[hv qi[cb tv[gz ye[vu
不怨天	bu[eu yr[xx tm[hd
不遠遊	bu[eu yr[ez yz[df
不曰白乎	bu[eu yt[wh bd[po hu[pb
不曰堅乎	bu[eu yt[wh jm[ut hu[pb
不曰如之何	bu[eu yt[wh ru[nk vi[dv he[rk
不在其位	bu[eu zd[ut qi[cb ww[rl
不在顓臾	bu[eu zd[ut vr[uy yu[jr
不佔而已矣	bu[eu vj[bk er[ek yi[kv yi[su
不忮不求	bu[eu vi[xu bu[eu qq[hu
不知老之將至云爾	bu[eu vi[uk lc[tb vi[dv jl[dx vi[ht yy[es er[dx
不知禮	bu[eu vi[uk li[uv
不知命	bu[eu vi[uk mk[rh
不知其可也	bu[eu vi[uk qi[cb ke[dk ye[vu
不知為不知	bu[eu vi[uk ww[dl bu[eu vi[uk
不知言	bu[eu vi[uk yj[we
不知也	bu[eu vi[uk ye[vu
不至於谷	bu[eu vi[ht yu[eu gu[bk
不莊	bu[eu vl[gt
不足以為士矣	bu[eu zu[kv yi[sr ww[dl ui[uh yi[su
不坐	bu[eu zo[rr
才不才	cd[hu bu[eu cd[hu
才難	cd[hu nj[yv
參乎	cj[sd hu[pb
參也魯	cj[sd ye[vu lu[yo
草上之風	cc[co uh[bh vi[dv fg[ji
策其馬曰	ce[vc qi[cb ma[vv yt[wh
曾是以為	cg[bo ui[op yi[sr ww[dl
曾謂泰山不如林放乎	cg[bo ww[yt td[su uj[uk bu[eu ru[nk lb[aa fh[fw hu[pb
曾皙後	cg[bo xi[ab hz[pk
曾皙曰	cg[bo xi[ab yt[wh
曾由	cg[bo yz[ou
察其所安	ia[gx qi[cb so[pj an[gn
察言而觀色	ia[gx yj[we er[ek gr[yj se[db
柴也愚	id[va ye[vu yu[ox
襜如也	ij[[ ru[nk ye[vu
諂也	ij[yd ye[vu
嘗獨立	ih[xe du[qi li[lh
長而無述焉	ih[ph er[ek wu[ee uu[az yj[hh
長沮桀溺耦而耕	ih[ph ju[dq jp[xa ni[dg ou[lo er[ek gg[le
長沮曰	ih[ph ju[dq yt[wh
常師之有	ih[xk ui[uh vi[dv yz[uo
長一身有半	ih[ph yi[hh uf[pu yz[uo bj[bf
朝服而立於阼階	ic[uo fu[oe er[ek li[lh yu[eu zo[ev jp[er
車中不內顧	ie[qu vs[ku bu[eu nw[kr gu[iy
陳成子弒簡公	if[eq ig[wv zi[lh ui[iq jm[vm gs[bs
陳恆弒其君	if[eq hg[xh ui[iq qi[cb jy[xk
陳亢退而喜曰	if[eq kh[wj tv[gz er[ek xi[uk yt[wh
陳亢問於伯魚曰	if[eq kh[wj wf[mk yu[eu bo[rb yu[dt yt[wh
陳力就列	if[eq li[vp jq[wy lp[hd
晨門曰	if[oi mf[du yt[wh
臣事君	if[ku ui[hk jy[xk
陳司敗問	if[eq si[vh bd[bw wf[mk
陳子禽謂子貢曰	if[eq zi[lh qb[rw ww[yt zi[lh gs[gb yt[wh
誠不以富	ig[yw bu[eu yi[sr fu[gh
乘肥馬	ig[qb fw[ob ma[vv
稱其德也	ig[hd qi[cb de[ru ye[vu
成事不說	ig[wv ui[hk bu[eu uo[yb
逞顏	ig[kz yj[ly
乘殷之輅	ig[qb yb[pj vi[dv lu[iw
成於樂	ig[wv yu[eu le[px
誠哉是言也	ig[yw zd[tk ui[op yj[we ye[vu
稱諸異	ig[hd vu[yt yi[kc
赤爾何如	ii[ty er[dx he[rk ru[nk
恥躬之不逮也	ii[ev gs[ug vi[dv bu[eu dd[xz ye[vu
恥也	ii[ev ye[vu
赤也惑	ii[ty ye[vu ho[gx
赤也為之小	ii[ty ye[vu ww[dl vi[dv xn[ub
赤之適齊也	ii[ty vi[dv ui[qz qi[wp ye[vu
崇德也	is[ug de[ru ye[vu
臭惡	iz[zq ee[hx
出辭氣	iu[ck ci[ql qi[rh
楚狂接輿歌而過孔子曰	iu[ap kl[qw jp[fl yu[pb ge[kd er[ek go[cz ks[zv zi[lh yt[wh
出門如見大賓	iu[ck mf[du ru[nk jm[ke da[hr bb[gq
出納之吝	iu[ck na[sk vi[dv lb[wk
出三日	iu[ck sj[hh ri[wh
出曰	iu[ck yt[wh
出則事公卿	iu[ck ze[bd ui[hk gs[bs qk[pg
出則悌	iu[ck ze[bd ti[xb
傳不習乎	ir[re bu[eu xi[vd hu[pb
春服既成	iy[so fu[oe ji[gj ig[wv
純如也	iy[st ru[nk ye[vu
賜不受命	ci[bo bu[eu uz[ay mk[rh
辭達而已矣	ci[ql da[dz er[ek yi[kv yi[su
辭毋	ci[ql wu[vv
賜也	ci[bo ye[vu
賜也達	ci[bo ye[vu da[dz
賜也可使從政也與	ci[bo ye[vu ke[dk ui[rh cs[rr vg[hw ye[vu yu[hv
次矣	ci[dd yi[su
賜之牆也及肩	ci[bo vi[dv ql[tt ye[vu ji[pv jm[ho
從而不改	cs[rr er[ek bu[eu gd[kw
從我於陳蔡者	cs[rr wo[pf yu[eu if[eq cd[cx ve[to
從吾所好	cs[rr wu[wk so[pj hc[nz
從者病	cs[rr ve[to bk[bh
從者見之	cs[rr ve[to jm[ke vi[dv
從者曰	cs[rr ve[to yt[wh
從之	cs[rr vi[dv
踧如也	cu[[ ru[nk ye[vu
大車無輗	da[hr ie[qu wu[ee ni[[
大德不逾閒	da[hr de[ru bu[eu yu[rz xm[ma
大事不成	da[hr ui[hk bu[eu ig[wv
大師摯適齊	da[hr ui[uh vi[ff ui[qz qi[wp
達巷黨人曰	da[dz xl[gk dh[xk rf[pd yt[wh
大哉孔子	da[hr zd[tk ks[zv zi[lh
大哉問	da[hr zd[tk wf[mk
大哉堯之為君也	da[hr zd[tk yc[qh vi[dv ww[dl jy[xk ye[vu
蕩蕩乎	dh[cd dh[cd hu[pb
當仁不讓於師	dh[xx rf[re bu[eu rh[yu yu[eu ui[uh
當灑掃應對進退	dh[xx sa[dx sc[fx yk[gx dv[yc jb[ez tv[gz
當暑	dh[xx uu[ot
道不同	dc[bz bu[eu ts[kh
道不憂貧	dc[bz bu[eu yz[xy pb[fb
禱爾於	dc[uf er[dx yu[eu
道千乘之國	dc[bz qm[pu ug[qb vi[dv go[ww
道聽而途說	dc[bz tk[kj er[ek tu[rz uo[yb
道之不行	dc[bz vi[dv bu[eu xk[rh
道之將廢也與	dc[bz vi[dv jl[dx fw[gv ye[vu yu[hv
道之將行也與	dc[bz vi[dv jl[dx xk[rh ye[vu yu[hv
道之斯行	dc[bz vi[dv si[qj xk[rh
道之以德	dc[bz vi[dv yi[sr de[ru
道之以政	dc[bz vi[dv yi[sr vg[hw
德不孤	de[ru bu[eu gu[zp
得見君子者	de[ro jm[ke jy[xk zi[lh ve[to
得見有恆者	de[ro jm[ke yz[uo hg[xh ve[to
得其門者或寡矣	de[ro qi[cb mf[du ve[to ho[gk gx[gf yi[su
德行	de[ru xk[rh
德之不修	de[ru vi[dv bu[eu xq[ru
德之棄也	de[ru vi[dv qi[wc ye[vu
德之賊也	de[ru vi[dv zw[bg ye[vu
帝臣不蔽	di[lj if[ku bu[eu bi[cb
弟也	di[bg ye[vu
弟子服其勞	di[bg zi[lh fu[oe qi[cb lc[cl
禘自既灌而往者	di[[ zi[pm ji[gj gr[dc er[ek wh[rd ve[to
弟子入則孝	di[bg zi[lh ru[pd ze[bd xn[tz
弟子孰為好學	di[bg zi[lh uu[wj ww[dl hc[nz xt[xz
顛而不扶	dm[uy er[ek bu[eu fu[fe
點爾何如	dm[bd er[dx he[rk ru[nk
顛沛必於是	dm[uy pw[dh bi[xp yu[eu ui[op
定公問	dk[gp gs[bs wf[mk
侗而不願	ds[rk er[ek bu[eu yr[ix
東里子產潤色	ds[qx li[ot zi[lh ij[lp ry[dm se[db
動容貌	ds[el rs[xr mc[pb
東首	ds[qx uz[be
動之不以禮	ds[el vi[dv bu[eu yi[sr li[uv
動之斯和	ds[el vi[dv si[qj he[hk
斗筲之人	dz[du uc[vx vi[dv rf[pd
篤信好學	du[vm xb[ry hc[nz xt[xz
短右袂	dr[ud yz[uk mw[yv
端章甫	dr[lu vh[lo fu[uo
對曰	dv[yc yt[wh
奪伯氏駢邑三百	do[dc bo[rb ui[pq pm[mb yi[kb sj[hh bd[eo
多見而識	do[xx jm[ke er[ek ui[yk
多見其不知量也	do[xx jm[ke qi[cb bu[eu vi[uk ll[oh ye[vu
多見闕殆	do[xx jm[ke qt[mn dd[hs
多食	do[xx ui[rl
多識於鳥獸草木之名	do[xx ui[yk yu[eu nn[nh uz[bh cc[co mu[ub vi[dv mk[xk
多聞	do[xx wf[me
多聞闕疑	do[xx wf[me qt[mn yi[bs
多怨	do[xx yr[xx
惡不仁者	ee[hx bu[eu rf[re ve[to
惡不孫以為勇者	ee[hx bu[eu sy[zx yi[sr ww[dl ys[sl ve[to
惡稱人之惡者	ee[hx ig[hd rf[pd vi[dv ee[hx ve[to
惡果敢而窒者	ee[hx go[oa gj[vw er[ek vi[xh ve[to
惡乎成名	ee[hx hu[pb ig[wv mk[xk
惡徼以為知者	ee[hx jn[rb yi[sr ww[dl vi[uk ve[to
惡訐以為直	ee[hx jp[yg yi[sr ww[dl vi[uj
惡利口之覆邦家者	ee[hx li[hd kz[uv vi[dv fu[xr bh[fe jx[gu ve[to
惡衣服而致美乎黻冕	ee[hx yi[wy fu[oe er[ek vi[hw mw[bw hu[pb fu[yu mm[od
惡勇而無禮者	ee[hx ys[sl er[ek wu[ee li[uv ve[to
惡鄭聲之亂雅樂也	ee[hx vg[be ug[um vi[dv lr[qv ya[yv yt[px ye[vu
惡之慾其	ee[hx vi[dv yu[bd qi[cb
惡紫之奪朱也	ee[hx zi[vy vi[dv do[dc vu[ph ye[vu
爾愛其羊	er[dx ai[au qi[cb yh[bs
而不	er[ek bu[eu
而不恥者	er[ek bu[eu ii[ev ve[to
而不能守也	er[ek bu[eu ng[sb uz[gc ye[vu
而不三黜	er[ek bu[eu sj[hh iu[hi
而不與立也	er[ek bu[eu yu[hv li[lh ye[vu
而不慍	er[ek bu[eu yy[xo
而朝齊	er[ek ic[uo qi[wp
而恥惡衣惡食者	er[ek ii[ev ee[hx yi[wy ee[hx ui[rl ve[to
而犯之	er[ek fj[qe vi[dv
而非邦也者	er[ek fw[su bh[fe ye[vu ve[to
而好犯上者	er[ek hc[nz fj[qe uh[bh ve[to
而好作亂者	er[ek hc[nz zo[rv lr[qv ve[to
而和	er[ek he[hk
而後從之	er[ek hz[pk cs[rr vi[dv
而後和之	er[ek hz[pk he[hk vi[dv
而後其食	er[ek hz[pk qi[cb ui[rl
而患不均	er[ek hr[kx bu[eu jy[tb
而貨殖焉	er[ek ho[rb vi[hu yj[hh
而今而後	er[ek jb[rd er[ek hz[pk
而可大受也	er[ek ke[dk da[hr uz[ay ye[vu
而可小知也	er[ek ke[dk xn[ub vi[uk ye[vu
而亂大倫	er[ek lr[qv da[hr ly[rr
而謀動干戈於邦內	er[ek mz[yg ds[el gj[hu ge[qp yu[eu bh[fe nw[kr
而豈徒哉	er[ek qi[uk tu[rz zd[tk
而親仁	er[ek qb[la rf[re
而求也為之聚斂而附益之	er[ek qq[hu ye[vu ww[dl vi[dv ju[ep lm[rw er[ek fu[er yi[bm vi[dv
二三子	er[hh sj[hh zi[lh
二三子何患於喪乎	er[hh sj[hh zi[lh he[rk hr[kx yu[eu sh[ty hu[pb
二三子以我為隱乎	er[hh sj[hh zi[lh yi[sr wo[pf ww[dl yb[ed hu[pb
而誰以易之	er[ek uv[yv yi[sr yi[ob vi[dv
爾所不知	er[dx so[pj bu[eu vi[uk
爾所謂達者	er[dx so[pj ww[yt da[dz ve[to
而往拜之	er[ek wh[rd bd[fh vi[dv
而行違	er[ek xk[rh ww[wz
而學詩	er[ek xt[xz ui[yt
而亦何	er[ek yi[wy he[rk
而由人乎哉	er[ek yz[ou rf[pd hu[pb zd[tk
而有宋朝之美	er[ek yz[uo ss[ga ic[uo vi[dv mw[bw
而在蕭牆之內也	er[ek zd[ut xn[cx ql[tt vi[dv nw[kr ye[vu
邇之事父	er[dz vi[dv ui[hk fu[bi
而子證之	er[ek zi[lh vg[yh vi[dv
發憤忘食	fa[vy ff[xu wh[wx ui[rl
法語之言	fa[dt yu[yw vi[dv yj[we
泛愛眾	fj[dp ai[au vs[rr
樊遲出	fj[ad ii[uz iu[ck
樊遲從遊於舞雩之下	fj[ad ii[uz cs[rr yz[df yu[eu wu[rx yu[yh vi[dv xx[hb
樊遲請學稼	fj[ad ii[uz qk[yf xt[xz jx[hg
樊遲退	fj[ad ii[uz tv[gz
樊遲未達	fj[ad ii[uz ww[ha da[dz
樊遲問仁	fj[ad ii[uz wf[mk rf[re
樊遲問知	fj[ad ii[uz wf[mk vi[uk
樊遲御	fj[ad ii[uz yu[rw
樊遲曰	fj[ad ii[uz yt[wh
犯而不校	fj[qe er[ek bu[eu jn[al
飯疏食	fj[up uu[pw ui[rl
樊須也	fj[ad xu[py ye[vu
方六七十	fh[dw lq[wb qi[hv ui[hu
放於利而行	fh[fw yu[eu li[hd er[ek xk[rh
非不說子之道	fw[su bu[eu uo[yb zi[lh vi[dv dc[bz
非崇德與	fw[su is[ug de[ru yu[hv
非達也	fw[su da[dz ye[vu
非道弘人	fw[su dc[bz hs[gs rf[pd
非夫人之為慟而	fw[su fu[er rf[pd vi[dv ww[dl ts[xe er[ek
非敢後也	fw[su gj[vw hz[pk ye[vu
非敢為	fw[su gj[vw ww[dl
非公事	fw[su gs[bs ui[hk
非惑與	fw[su ho[gx yu[hv
非祭肉	fw[su ji[xe rz[kr
非禮勿動	fw[su li[uv wu[bp ds[el
非禮勿視	fw[su li[uv wu[bp ui[uj
非禮勿聽	fw[su li[uv wu[bp tk[kj
非禮勿言	fw[su li[uv wu[bp yj[we
非其鬼而祭之	fw[su qi[cb gv[be er[ek ji[xe vi[dv
非求益者也	fw[su qq[hu yi[bm ve[to ye[vu
非帷裳	fw[su ww[jv uh[xy
非我也	fw[su wo[pf ye[vu
非吾徒也	fw[su wu[wk tu[rz ye[vu
非修慝與	fw[su xq[ru te[kx yu[hv
非也	fw[su ye[vu
菲飲食而致孝乎鬼神	fw[cf yb[ud ui[rl er[ek vi[hw xn[tz hu[pb gv[be uf[uo
非曰能之	fw[su yt[wh ng[sb vi[dv
廢中權	fw[gv vs[ku qr[ay
非諸侯而何	fw[su vu[yt hz[rv er[ek he[rk
非助我者也	fw[su vu[ql wo[pf ve[to ye[vu
忿思難	ff[fx si[tx nj[yv
風乎舞雩	fg[ji hu[pb wu[rx yu[yh
鳳鳥不至	fg[jy nn[nh bu[eu vi[ht
鳳兮鳳兮	fg[jy xi[bk fg[jy xi[bk
佛肸以中牟畔	fo[rf xi[[ yi[sr vs[ku mu[sn pj[tb
佛肸召	fo[rf xi[[ vc[dk
夫達也者	fu[er da[dz ye[vu ve[to
富而好禮者也	fu[gh er[ek hc[nz li[uv ve[to ye[vu
富而可求也	fu[gh er[ek ke[dk qq[hu ye[vu
夫二三	fu[er er[hh sj[hh
富而無驕	fu[gh er[ek wu[ee jn[mp
富而無驕易	fu[gh er[ek wu[ee jn[mp yi[ob
富貴在天	fu[gh gv[vb zd[ut tm[hd
夫何	fu[er he[rk
夫何為哉	fu[er he[rk ww[dl zd[tk
夫何憂何懼	fu[er he[rk yz[xy he[rk ju[xj
夫君	fu[er jy[xk
父沒	fu[bi mw[dj
父母唯其疾之憂	fu[bi mu[vv ww[kv qi[cb ji[bu vi[dv yz[xy
父母在	fu[bi mu[vv zd[ut
父母之年	fu[bi mu[vv vi[dv nm[rn
復其位	fu[ro qi[cb ww[rl
富且貴焉	fu[gh qp[ke gv[vb yj[hh
夫然後行	fu[er rj[xd hz[pk xk[rh
夫人不言	fu[er rf[pd bu[eu yj[we
夫仁者	fu[er rf[re ve[to
夫人自稱曰小童	fu[er rf[pd zi[pm ig[hd yt[wh xn[ub ts[lo
夫如是	fu[er ru[nk ui[op
夫三年之喪	fu[er sj[hh nm[rn vi[dv sh[ty
夫三子者之言何如	fu[er sj[hh zi[lh ve[to vi[dv yj[we he[rk ru[nk
膚受之愬	fu[oe uz[ay vi[dv uo[[
父為子隱	fu[bi ww[dl zi[lh yb[ed
夫聞也者	fu[er wf[me ye[vu ve[to
夫我則不暇	fu[er wo[pf ze[bd bu[eu xx[ok
富有	fu[gh yz[uo
富與貴	fu[gh yu[hv gv[vb
富哉	fu[gh zd[tk
父在	fu[bi zd[ut
夫召我者	fu[er vc[dk wo[pf ve[to
富之	fu[gh vi[dv
夫執輿者為誰	fu[er vi[fj yu[pb ve[to ww[dl uv[yv
服周之冕	fu[oe vz[kt vi[dv mm[od
夫顓臾	fu[er vr[uy yu[jr
夫子	fu[er zi[lh
夫子不答	fu[er zi[lh bu[eu da[vr
夫子不為也	fu[er zi[lh bu[eu ww[dl ye[vu
夫子不言	fu[er zi[lh bu[eu yj[we
夫子固有惑志於公伯寮	fu[er zi[lh gu[wg yz[uo ho[gx vi[ux yu[eu gs[bs bo[rb ln[gd
夫子何哂由也	fu[er zi[lh he[rk uf[kx yz[ou ye[vu
夫子何為	fu[er zi[lh he[rk ww[dl
夫子喟然嘆曰	fu[er zi[lh kv[kt rj[xd tj[ky yt[wh
夫子哂之	fu[er zi[lh uf[kx vi[dv
夫子聖者與	fu[er zi[lh ug[yt ve[to yu[hv
夫子時然後言	fu[er zi[lh ui[oc rj[xd hz[pk yj[we
夫子矢之曰	fu[er zi[lh ui[rd vi[dv yt[wh
夫子莞爾而笑	fu[er zi[lh wj[cg er[dx er[ek xn[vp
夫子為衛君乎	fu[er zi[lh ww[dl ww[eh jy[xk hu[pb
夫子溫良恭儉讓以得之	fu[er zi[lh wf[do ll[dg gs[gx jm[rr rh[yu yi[sr de[ro vi[dv
夫子憮然曰	fu[er zi[lh wu[xe rj[xd yt[wh
夫子循循然	fu[er zi[lh xy[rp xy[rp rj[xd
夫子焉不學	fu[er zi[lh yj[hh bu[eu xt[xz
夫子欲之	fu[er zi[lh yu[bd vi[dv
夫子之道	fu[er zi[lh vi[dv dc[bz
夫子之得邦家者	fu[er zi[lh vi[dv de[ro bh[fe jx[gu ve[to
夫子之牆數仞	fu[er zi[lh vi[dv ql[tt uu[mw rf[rd
夫子之求之也	fu[er zi[lh vi[dv qq[hu vi[dv ye[vu
夫子之說君子	fu[er zi[lh vi[dv uo[yb jy[xk zi[lh
夫子至於是邦也	fu[er zi[lh vi[ht yu[eu ui[op bh[fe ye[vu
夫子之雲	fu[er zi[lh vi[dv yy[es
夫子自道也	fu[er zi[lh zi[pm dc[bz ye[vu
蓋均無貧	gd[bm jy[tb wu[ee pb[fb
蓋闕如也	gd[bm qt[mn ru[nk ye[vu
蓋十世希不失矣	gd[bm ui[hu ui[nv xi[iu bu[eu ui[pe yi[su
蓋有不知而作之者	gd[bm yz[uo bu[eu vi[uk er[ek zo[rv vi[dv ve[to
蓋有之	gd[bm yz[uo vi[dv
改之為貴	gd[kw vi[dv ww[dl gv[vb
敢問	gj[vw wf[mk
敢問崇德	gj[vw wf[mk is[ug de[ru
敢問其次	gj[vw wf[mk qi[cb ci[dd
敢問死	gj[vw wf[mk si[hx
敢用玄牡	gj[vw ys[ou xr[wy mu[nt
敢昭告於皇皇后帝	gj[vw vc[od gc[nk yu[eu hl[bw hl[bw hz[pk di[lj
剛毅木訥	gh[kd yi[lj mu[ub ne[yk
告夫三子	gc[nk fu[er sj[hh zi[lh
羔裘	gc[bd qq[hy
羔裘玄冠不以吊	gc[bd qq[hy xr[wy gr[ge bu[eu yi[sr dn[kj
告於哀公曰	gc[nk yu[eu ai[wk gs[bs yt[wh
告諸往而知來者	gc[nk vu[yt wh[rd er[ek vi[uk ld[hm ve[to
高宗	gc[wk zs[ge
高宗諒陰	gc[wk zs[ge ll[yw yb[eo
割不正	ge[gd bu[eu vg[hv
割雞焉用牛刀	ge[gd ji[yn yj[hh ys[ou nq[pf dc[vp
各於其黨	ge[wk yu[eu qi[cb dh[xk
耕也	gg[le ye[vu
更也人皆仰之	gg[ho ye[vu rf[pd jp[bb yh[rp vi[dv
公伯寮其如命何	gs[bs bo[rb ln[gd qi[cb ru[nk mk[rh he[rk
公伯寮愬子路於季孫	gs[bs bo[rb ln[gd uo[[ zi[lh lu[zw yu[eu ji[hz sy[zx
公綽之不欲	gs[bs io[sb vi[dv bu[eu yu[bd
恭而安	gs[gx er[ek an[gn
恭而無禮則勞	gs[gx er[ek wu[ee li[uv ze[bd lc[cl
攻乎異端	gs[gw hu[pb yi[kc dr[lu
恭己正南面而已矣	gs[gx ji[kv vg[hv nj[uk mm[ew er[ek yi[kv yi[su
恭近於禮	gs[gx jb[jz yu[eu li[uv
恭寬信敏惠	gs[gx kr[gc xb[ry mb[rw hv[hx
公明賈對曰	gs[bs mk[oo jx[xb dv[yc yt[wh
攻其惡	gs[gw qi[cb ee[hx
公山弗擾以費畔召	gs[bs uj[uk fu[gp rc[fy yi[sr fw[fb pj[tb vc[dk
宮室而盡力乎溝洫	gs[gk ui[gh er[ek jb[ud li[vp hu[pb gz[db xu[dp
公叔文子之臣大夫僎	gs[bs uu[uy wf[wi zi[lh vi[dv if[ku dd[hr fu[er vr[[
公西華曰	gs[bs xi[hk hx[ru yt[wh
躬行君子	gs[ug xk[rh jy[xk zi[lh
工欲善其事	gs[hu yu[bd uj[yk qi[cb ui[hk
公曰	gs[bs yt[wh
恭則不侮	gs[gx ze[bd bu[eu wu[rr
公則說	gs[bs ze[bd uo[yb
攻之	gs[gw vi[dv
躬自厚而薄責於人	gs[ug zi[pm hz[io er[ek bo[cd ze[fb yu[eu rf[pd
苟合矣	gz[cb he[rh yi[su
苟美矣	gz[cb mw[bw yi[su
苟完矣	gz[cb wj[ge yi[su
苟無所不至矣	gz[cb wu[ee so[pj bu[eu vi[ht yi[su
苟有過	gz[cb yz[uo go[cz
苟有用我者	gz[cb yz[uo ys[ou wo[pf ve[to
苟正其身矣	gz[cb vg[hv qi[cb uf[pu yi[su
苟志於仁矣	gz[cb vi[ux yu[eu rf[re yi[su
苟子之不欲	gz[cb zi[lh vi[dv bu[eu yu[bd
觚不觚	gu[dp bu[eu gu[dp
故不為也	gu[gw bu[eu ww[dl ye[vu
故多能鄙事	gu[gw do[xx ng[sb bi[ke ui[hk
固而近於費	gu[wg er[ek jb[jz yu[eu fw[fb
鼓方叔入於河	gu[uu fh[dw uu[uy ru[pd yu[eu he[dk
故夫三桓之子孫微矣	gu[gw fu[er sj[hh hr[ah vi[dv zi[lh sy[zx ww[ru yi[su
故進之	gu[gw jb[ez vi[dv
故舊不遺	gu[gw jq[uo bu[eu yi[vz
沽酒市脯不食	gu[dg jq[dy ui[wj pu[of bu[eu ui[rl
故舊無大故	gu[gw jq[uo wu[ee da[hr gu[gw
故君子名之必可言也	gu[gw jy[xk zi[lh mk[xk vi[dv bi[xp ke[dk yj[we ye[vu
谷克伐怨欲不行焉	gu[bk ke[ge fa[rg yr[xx yu[bd bu[eu xk[rh yj[hh
鼓瑟希	gu[uu se[wx xi[iu
固天縱之將聖	gu[wg tm[hd zs[sr vi[dv jl[dx ug[yt
故退之	gu[gw tv[gz vi[dv
固相師之道也	gu[wg xl[am ui[uh vi[dv dc[bz ye[vu
故藝	gu[gw yi[cv
故遠人不服	gu[gw yr[ez rf[pd bu[eu fu[oe
觚哉	gu[dp zd[tk
古者民有三疾	gu[uk ve[to mb[kv yz[uo sj[hh ji[bu
古者言之不出	gu[uk ve[to yj[we vi[dv bu[eu iu[ck
古之	gu[uk vi[dv
古之道也	gu[uk vi[dv dc[bz ye[vu
古之狂也肆	gu[uk vi[dv kl[qw ye[vu si[iy
古之人皆然	gu[uk vi[dv rf[pd jp[bb rj[xd
古之賢人也	gu[uk vi[dv xm[ub rf[pd ye[vu
古之學者為己	gu[uk vi[dv xt[xz ve[to ww[dl ji[kv
古之愚也直	gu[uk vi[dv yu[ox ye[vu vi[uj
沽之哉	gu[dg vi[dv zd[tk
瓜祭	gx[ps ji[xe
觀過	gr[yj go[cz
關雎	gr[bt ju[qv
關雎之亂	gr[bt ju[qv vi[dv lr[qv
觀其所由	gr[yj qi[cb so[pj yz[ou
觀其行	gr[yj qi[cb xk[rh
觀其志	gr[yj qi[cb vi[ux
官事不攝	gr[gu ui[hk bu[eu ue[fe
管氏而知禮	gr[vg ui[pq er[ek vi[uk li[uv
管氏亦樹塞門	gr[vg ui[pq yi[wy uu[ay sd[gt mf[du
管氏有三歸	gr[vg ui[pq yz[uo sj[hh gv[ux
冠者五六人	gr[ge ve[to wu[hu lq[wb rf[pd
管仲不死	gr[vg vs[rv bu[eu si[hx
管仲非仁者與	gr[vg vs[rv fw[su rf[re ve[to yu[hv
管仲儉乎	gr[vg vs[rv jm[rr hu[pb
管仲之力也	gr[vg vs[rv vi[dv li[vp ye[vu
管仲之器小哉	gr[vg vs[rv vi[dv qi[kq xn[ub zd[tk
歸孔子豚	gv[ux ks[zv zi[lh ty[ou
龜玉毀於櫝中	gv[do yu[wd hv[jj yu[eu du[au vs[ku
過而不改	go[cz er[ek bu[eu gd[kw
過位	go[cz ww[rl
過也人皆見之	go[cz ye[vu rf[pd jp[bb jm[ke vi[dv
過猶不及	go[cz yz[qy bu[eu ji[pv
果哉	go[oa zd[tk
過則勿憚改	go[cz ze[bd wu[bp dj[xb gd[kw
過之	go[cz vi[dv
好剛不好學	hc[nz gh[kd bu[eu hc[nz xt[xz
好古	hc[nz gu[uk
好謀而成者也	hc[nz mz[yg er[ek ig[wv ve[to ye[vu
好仁不好學	hc[nz rf[re bu[eu hc[nz xt[xz
好仁者	hc[nz rf[re ve[to
好信不好學	hc[nz xb[ry bu[eu hc[nz xt[xz
好行小慧	hc[nz xk[rh xn[ub hv[fx
好學也已	hc[nz xt[xz ye[vu yi[kv
好勇不好學	hc[nz ys[sl bu[eu hc[nz xt[xz
好勇疾貧	hc[nz ys[sl ji[bu pb[fb
好直不好學	hc[nz vi[uj bu[eu hc[nz xt[xz
好知不好學	hc[nz vi[uk bu[eu hc[nz xt[xz
好之者	hc[nz vi[dv ve[to
何必	he[rk bi[xp
何必讀書	he[rk bi[xp du[yu uu[vv
何必改作	he[rk bi[xp gd[kw zo[rv
何必公山氏之之也	he[rk bi[xp gs[bs uj[uk ui[pq vi[dv vi[dv ye[vu
何必去父母之邦	he[rk bi[xp qu[ts fu[bi mu[vv vi[dv bh[fe
河不出圖	he[dk bu[eu iu[ck tu[ww
盍徹乎	he[tm ie[rq hu[pb
何德之衰	he[rk de[ru vi[dv uk[wk
何陋之有	he[rk lz[eh vi[dv yz[uo
何莫由斯道也	he[rk mo[co yz[ou si[qj dc[bz ye[vu
何其多能也	he[rk qi[cb do[xx ng[sb ye[vu
何如	he[rk ru[nk
何如斯可謂之士矣	he[rk ru[nk si[qj ke[dk ww[yt vi[dv ui[uh yi[su
何如斯可以從政矣	he[rk ru[nk si[qj ke[dk yi[sr cs[rr vg[hw yi[su
何傷乎	he[rk uh[rr hu[pb
何事於仁	he[rk ui[hk yu[eu rf[re
何為	he[rk ww[dl
和為貴	he[hk ww[dl gv[vb
何謂惠而不費	he[rk ww[yt hv[hx er[ek bu[eu fw[fb
何為其莫知子也	he[rk ww[dl qi[cb mo[co vi[uk zi[lh ye[vu
何謂四惡	he[rk ww[yt si[we ee[hx
何謂五美	he[rk ww[yt wu[hu mw[bw
何謂也	he[rk ww[yt ye[vu
何為則民服	he[rk ww[dl ze[bd mb[kv fu[oe
和無寡	he[hk wu[ee gx[gf
何晏也	he[rk yj[og ye[vu
何以報德	he[rk yi[sr bc[fe de[ru
何以伐為	he[rk yi[sr fa[rg ww[dl
何以文為	he[rk yi[sr wf[wi ww[dl
何有	he[rk yz[uo
何有於我哉	he[rk yz[uo yu[eu wo[pf zd[tk
何哉	he[rk zd[tk
何足算也	he[rk zu[kv sr[vm ye[vu
何足以臧	he[rk zu[kv yi[sr zh[wk
紅紫不以為褻服	hs[sg zi[vy bu[eu yi[sr ww[dl xp[wf fu[oe
後進於禮樂	hz[pk jb[ez yu[eu li[uv yt[px
後生可畏	hz[pk ug[pf ke[dk ww[th
後世必為子孫憂	hz[pk ui[nv bi[xp ww[dl zi[lh sy[zx yz[xy
後死者不得與	hz[pk si[hx ve[to bu[eu de[ro yu[hv
虎豹之鞟猶犬羊之鞟	hu[hj bc[pb vi[dv ko[[ yz[qy qr[dd yh[bs vi[dv ko[[
狐貉之厚以居	hu[qp he[pw vi[dv hz[io yi[sr ju[ug
狐裘	hu[qp qq[hy
虎兕出於柙	hu[hj si[ue iu[ck yu[eu xx[ao
互鄉難與言	hu[hv xl[sp nj[yv yu[hv yj[we
忽焉在後	hu[bx yj[hh zd[ut hz[pk
懷其寶而迷其邦	hk[xb qi[cb bc[gw er[ek mi[mz qi[cb bh[fe
患不知人也	hr[kx bu[eu vi[uk rf[pd ye[vu
患得之	hr[kx de[ro vi[dv
桓公九合諸侯	hr[ah gs[bs jq[pv he[rh vu[yt hz[rv
桓公殺公子糾	hr[ah gs[bs ua[ia gs[bs zi[lh jq[sv
煥乎其有文章	hr[hd hu[pb qi[cb yz[uo wf[wi vh[lo
患其不能也	hr[kx qi[cb bu[eu ng[sb ye[vu
患失之	hr[kx ui[pe vi[dv
患所以立	hr[kx so[pj yi[sr li[lh
桓魋其如予何	hr[ah tv[[ qi[cb ru[nk yu[sv he[rk
黃衣	hl[gy yi[wy
回何敢死	hv[wk he[rk gj[vw si[hx
誨女知之乎	hv[yr nv[vp vi[uk vi[dv hu[pb
誨人不倦	hv[yr rf[pd bu[eu jr[rb
惠人也	hv[hx rf[pd ye[vu
繪事後素	hv[sr ui[hk hz[pk su[fy
回雖不敏	hv[wk sv[ki bu[eu mb[rw
回也	hv[wk ye[vu
回也不改其樂	hv[wk ye[vu bu[eu gd[kw qi[cb le[px
回也不愚	hv[wk ye[vu bu[eu yu[ox
回也其庶乎	hv[wk ye[vu qi[cb uu[gn hu[pb
回也視予猶父也	hv[wk ye[vu ui[uj yu[sv yz[qy fu[bi ye[vu
惠則足以使人	hv[hx ze[bd zu[kv yi[sr ui[rh rf[pd
或承之羞	ho[gk ig[lu vi[dv xq[yi
或謂孔子曰	ho[gk ww[yt ks[zv zi[lh yt[wh
或問禘之說	ho[gk wf[mk di[[ vi[dv uo[yb
或問之曰	ho[gk wf[mk vi[dv yt[wh
或問子產	ho[gk wf[mk zi[lh ij[lp
或曰	ho[gk yt[wh
獲罪於天	ho[cq zv[sf yu[eu tm[hd
驥不稱其力	ji[mb bu[eu ig[hd qi[cb li[vp
既得之	ji[gj de[ro vi[dv
既而曰	ji[gj er[ek yt[wh
既富矣	ji[gj fu[gh yi[su
疾固也	ji[bu gu[wg ye[vu
季桓子受之	ji[hz hr[ah zi[lh uz[ay vi[dv
及階	ji[pv jp[er
既竭吾才	ji[gj jp[lo wu[wk cd[hu
繼絕世	ji[sm jt[sd ui[nv
季康子患盜	ji[hz kh[gx zi[lh hr[kx dc[dm
季康子問	ji[hz kh[gx zi[lh wf[mk
季康子問政於孔子	ji[hz kh[gx zi[lh wf[mk vg[hw yu[eu ks[zv zi[lh
季康子問政於孔子曰	ji[hz kh[gx zi[lh wf[mk vg[hw yu[eu ks[zv zi[lh yt[wh
既來之	ji[gj ld[hm vi[dv
季路問事鬼神	ji[hz lu[zw wf[mk ui[hk gv[be uf[uo
及其老也	ji[pv qi[cb lc[tb ye[vu
及其使人也	ji[pv qi[cb ui[rh rf[pd ye[vu
及其壯也	ji[pv qi[cb vl[du ye[vu
擊磬乎	ji[fk qk[ue hu[pb
祭肉不出三日	ji[xe rz[kr bu[eu iu[ck sj[hh ri[wh
祭如在	ji[xe ru[nk zd[ut
祭神如神在	ji[xe uf[uo ru[nk uf[uo zd[ut
季氏第十六	ji[hz ui[pq di[vg ui[hu lq[wb
季氏富於周公	ji[hz ui[pq fu[gh yu[eu vz[kt gs[bs
季氏將伐顓臾	ji[hz ui[pq jl[dx fa[rg vr[uy yu[jr
季氏將有事於顓臾	ji[hz ui[pq jl[dx yz[uo ui[hk yu[eu vr[uy yu[jr
季氏旅於泰山	ji[hz ui[pq lv[fr yu[eu td[su uj[uk
季氏使閔子騫為費宰	ji[hz ui[pq ui[rh mb[mw zi[lh qm[gm ww[dl fw[fb zd[gl
既庶矣	ji[gj uu[gn yi[su
祭思敬	ji[xe si[tx jk[cw
己所不欲	ji[kv so[pj bu[eu yu[bd
既往不咎	ji[gj wh[rd bu[eu jq[wk
及席	ji[pv xi[gn
己欲達而達人	ji[kv yu[bd da[dz er[ek da[dz rf[pd
祭於公	ji[xe yu[eu gs[bs
己欲立而立人	ji[kv yu[bd li[lh er[ek li[lh rf[pd
既欲其生	ji[gj yu[bd qi[cb ug[pf
吉月必朝服	ji[uk yt[ke bi[xp ic[uo fu[oe
期月而已可也	ji[qo yt[ke er[ek yi[kv ke[dk ye[vu
即之也溫	ji[ge vi[dv ye[vu wf[do
祭之以禮	ji[xe vi[dv yi[sr li[uv
疾之已甚	ji[bu vi[dv yi[kv uf[qv
棘子成曰	ji[cc zi[lh ig[wv yt[wh
季子然問	ji[hz zi[lh rj[xd wf[mk
箕子為之奴	ji[vq zi[lh ww[dl vi[dv nu[ny
加朝服	jx[lk ic[uo fu[oe
嘉善而矜不能	jx[ul uj[yk er[ek jb[yr bu[eu ng[sb
加我數年	jx[lk wo[pf uu[mw nm[rn
加之以師旅	jx[lk vi[dv yi[sr ui[uh lv[fr
見不善如探湯	jm[ke bu[eu uj[yk ru[nk tj[fg th[dv
見不賢而內自省也	jm[ke bu[eu xm[ub er[ek nw[kr zi[pm xk[xm ye[vu
見得思義	jm[ke de[ro si[tx yi[di
見利思義	jm[ke li[hd si[tx yi[di
見冕者與瞽者	jm[ke mm[od ve[to yu[hv gu[um ve[to
見其二子焉	jm[ke qi[cb er[hh zi[lh yj[hh
見齊衰者	jm[ke qi[wp uk[wk ve[to
見其與	jm[ke qi[cb yu[hv
見善如不及	jm[ke uj[yk ru[nk bu[eu ji[pv
見危授	jm[ke ww[de uz[fa
見賢思齊焉	jm[ke xm[ub si[tx qi[wp yj[hh
見小利則	jm[ke xn[ub li[hd ze[bd
見義不為	jm[ke yi[di bu[eu ww[dl
簡在帝心	jm[vm zd[ut di[lj xb[dv
儉則固	jm[rr ze[bd gu[wg
見之	jm[ke vi[dv
見志不從	jm[ke vi[ux bu[eu cs[rr
見子夏曰	jm[ke zi[lh xx[ew yt[wh
將命者出戶	jl[dx mk[rh ve[to iu[ck hu[du
將入門	jl[dx ru[pd mf[du
降一等	jl[ew yi[hh dg[vt
降志辱身矣	jl[ew vi[ux ru[ic uf[pu yi[su
皦如也	jn[[ ru[nk ye[vu
教之	jn[tw vi[dv
皆不及門也	jp[bb bu[eu ji[pv mf[du ye[vu
皆能有養	jp[bb ng[sb yz[uo yh[yp
桀溺曰	jp[xa ni[dg yt[wh
借人乘之	jp[rg rf[pd ig[qb vi[dv
皆雅言也	jp[bb ya[yv yj[we ye[vu
階也	jp[er ye[vu
節用而愛人	jp[ce ys[ou er[ek ai[au rf[pd
戒之在得	jp[gc vi[dv zd[ut de[ro
戒之在鬥	jp[gc vi[dv zd[ut dz[du
戒之在色	jp[gc vi[dv zd[ut se[db
皆坐	jp[bb zo[rr
今拜乎上	jb[rd bd[fh hu[pb uh[bh
今不取	jb[rd bu[eu qu[ey
謹而信	jb[yn er[ek xb[ry
今夫顓臾	jb[rd fu[er vr[uy yu[jr
盡美矣	jb[ud mw[bw yi[su
今女安	jb[rd nv[vp an[gn
今女畫	jb[rd nv[vp hx[ht
謹權量	jb[yn qr[ay ll[oh
近仁	jb[jz rf[re
浸潤之譖	jb[dx ry[dm vi[dv zf[yj
今亡矣夫	jb[rd wh[wv yi[su fu[er
晉文公譎而不正	jb[ho wf[wi gs[bs jt[yy er[ek bu[eu vg[hv
今也純儉	jb[rd ye[vu iy[st jm[rr
今也或是之亡也	jb[rd ye[vu ho[gk ui[op vi[dv wh[wv ye[vu
矜也廉	jb[yr ye[vu lm[gb
今也則亡	jb[rd ye[vu ze[bd wh[wv
今由與求也	jb[rd yz[ou yu[hv qq[hu ye[vu
近者說	jb[jz ve[to uo[yb
今之成人者何必然	jb[rd vi[dv ig[wv rf[pd ve[to he[rk bi[xp rj[xd
今之從政者殆而	jb[rd vi[dv cs[rr vg[hw ve[to dd[hs er[ek
今之從政者何如	jb[rd vi[dv cs[rr vg[hw ve[to he[rk ru[nk
今之矜也忿戾	jb[rd vi[dv jb[yr ye[vu ff[fx li[hq
今之狂也蕩	jb[rd vi[dv kl[qw ye[vu dh[cd
今之孝者	jb[rd vi[dv xn[tz ve[to
今之學者為人	jb[rd vi[dv xt[xz ve[to ww[dl rf[pd
今之愚也詐而已矣	jb[rd vi[dv yu[ox ye[vu va[yv er[ek yi[kv yi[su
近之則不孫	jb[jz vi[dv ze[bd bu[eu sy[zx
敬鬼神而遠之	jk[cw gv[be uf[uo er[ek yr[ez vi[dv
敬事而信	jk[cw ui[hk er[ek xb[ry
敬雖州里行乎哉	jk[cw sv[ki vz[dp li[ot xk[rh hu[pb zd[tk
井有仁焉	jk[ep yz[uo rf[re yj[hh
廄焚	jq[ig ff[ah
舊谷既沒	jq[uo gu[bk ji[gj mw[dj
九人而已	jq[pv rf[pd er[ek yi[kv
久要不忘平生之言	jq[xd yc[xn bu[eu wh[wx pk[hb ug[pf vi[dv yj[we
久矣吾不復夢見周公	jq[xd yi[su wu[wk bu[eu fu[ro mg[ax jm[ke vz[kt gs[bs
久矣哉	jq[xd yi[su zd[tk
就有道而正焉	jq[wy yz[uo dc[bz er[ek vg[hv yj[hh
居必遷坐	ju[ug bi[xp qm[qz zo[rr
俱不得其死然	ju[rj bu[eu de[ro qi[cb si[hx rj[xd
居不容	ju[ug bu[eu rs[xr
居處不安	ju[ug iu[wb bu[eu an[gn
居處恭	ju[ug iu[wb gs[gx
舉爾所知	ju[xf er[dx so[pj vi[uk
舉皋陶	ju[xf gc[bd yc[eb
鞠躬如也	ju[gb gs[ug ru[nk ye[vu
居簡而行簡	ju[ug jm[vm er[ek xk[rh jm[vm
居敬而行簡	ju[ug jk[cw er[ek xk[rh jm[vm
居其所而眾星共之	ju[ug qi[cb so[pj er[ek vs[rr xk[op gs[gb vi[dv
舉善而教不能	ju[xf uj[yk er[ek jn[tw bu[eu ng[sb
居上不寬	ju[ug uh[bh bu[eu kr[gc
居是邦也	ju[ug ui[op bh[fe ye[vu
舉枉錯諸	ju[xf wh[aw co[jg vu[yt
居無求安	ju[ug wu[ee qq[hu an[gn
居吾語女	ju[ug wu[wk yu[yw nv[vp
舉賢才	ju[xf xm[ub cd[hu
舉逸民	ju[xf yi[dz mb[kv
舉伊尹	ju[xf yi[rx yb[xp
舉一隅不以三隅反	ju[xf yi[hh yu[eo bu[eu yi[sr sj[hh yu[eo fj[py
據於德	ju[fu yu[eu de[ru
居則曰	ju[ug ze[bd yt[wh
居之不疑	ju[ug vi[dv bu[eu yi[bs
舉直錯諸枉	ju[xf vi[uj co[jg vu[yt wh[aw
居之無倦	ju[ug vi[dv wu[ee jr[rb
狷者有所不為也	jr[qk ve[to yz[uo so[pj bu[eu ww[dl ye[vu
君臣之義	jy[xk if[ku vi[dv yi[di
君稱之曰夫人	jy[xk ig[hd vi[dv yt[wh fu[er rf[pd
君賜生	jy[xk ci[bo ug[pf
君賜食	jy[xk ci[bo ui[rl
君賜腥	jy[xk ci[bo xk[oo
君而知禮	jy[xk er[ek vi[uk li[uv
君薨	jy[xk hs[ch
君祭	jy[xk ji[xe
君君臣臣父父子子	jy[xk jy[xk if[ku if[ku fu[bi fu[bi zi[lh zi[lh
軍旅之事	jy[gi lv[fr vi[dv ui[hk
君命召	jy[xk mk[rh vc[dk
君取於吳	jy[xk qu[ey yu[eu wu[kt
君使臣	jy[xk ui[rh if[ku
君使臣以禮	jy[xk ui[rh if[ku yi[sr li[uv
君視之	jy[xk ui[uj vi[dv
君孰與不足	jy[xk uu[wj yu[hv bu[eu zu[kv
君孰與足	jy[xk uu[wj yu[hv zu[kv
君曰告夫三子者	jy[xk yt[wh gc[nk fu[er sj[hh zi[lh ve[to
君在	jy[xk zd[ut
君召使擯	jy[xk vc[dk ui[rh bb[fg
君子	jy[xk zi[lh
君子病無能焉	jy[xk zi[lh bk[bh wu[ee ng[sb yj[hh
君子博學於文	jy[xk zi[lh bo[uf xt[xz yu[eu wf[wi
君子不可小知	jy[xk zi[lh bu[eu ke[dk xn[ub vi[uk
君子不器	jy[xk zi[lh bu[eu qi[kq
君子不入也	jy[xk zi[lh bu[eu ru[pd ye[vu
君子不施其親	jy[xk zi[lh bu[eu ui[fr qi[cb qb[la
君子不以紺緅飾	jy[xk zi[lh bu[eu yi[sr gj[sg zz[[ ui[ur
君子不以言舉人	jy[xk zi[lh bu[eu yi[sr yj[we ju[xf rf[pd
君子不憂不懼	jy[xk zi[lh bu[eu yz[xy bu[eu ju[xj
君子不重	jy[xk zi[lh bu[eu vs[ph
君子成人之美	jy[xk zi[lh ig[wv rf[pd vi[dv mw[bw
君子恥其言而過其行	jy[xk zi[lh ii[ev qi[cb yj[we er[ek go[cz qi[cb xk[rh
君子道者三	jy[xk zi[lh dc[bz ve[to sj[hh
君子多乎哉	jy[xk zi[lh do[xx hu[pb zd[tk
君子而不仁者有矣夫	jy[xk zi[lh er[ek bu[eu rf[re ve[to yz[uo yi[su fu[er
君子和而不同	jy[xk zi[lh he[hk er[ek bu[eu ts[kh
君子何患乎無兄	jy[xk zi[lh he[rk hr[kx hu[pb wu[ee xs[ke
君子懷德	jy[xk zi[lh hk[xb de[ru
君子懷刑	jy[xk zi[lh hk[xb xk[kd
君子惠而不費	jy[xk zi[lh hv[hx er[ek bu[eu fw[fb
君子疾夫舍曰欲之而必為之辭	jy[xk zi[lh ji[bu fu[er ue[rg yt[wh yu[bd vi[dv er[ek bi[xp ww[dl vi[dv ci[ql
君子疾沒世而名不稱焉	jy[xk zi[lh ji[bu mo[dj ui[nv er[ek mk[xk bu[eu ig[hd yj[hh
君子矜而不爭	jy[xk zi[lh jb[yr er[ek bu[eu vg[dx
君子敬而無失	jy[xk zi[lh jk[cw er[ek wu[ee ui[pe
君子居之	jy[xk zi[lh ju[ug vi[dv
君子可逝也	jy[xk zi[lh ke[dk ui[fz ye[vu
君子謀道不謀食	jy[xk zi[lh mz[yg dc[bz bu[eu mz[yg ui[rl
君子求諸己	jy[xk zi[lh qq[hu vu[yt ji[kv
君子去仁	jy[xk zi[lh qu[ts rf[re
君子人	jy[xk zi[lh rf[pd
君子三年不為禮	jy[xk zi[lh sj[hh nm[rn bu[eu ww[dl li[uv
君子上達	jy[xk zi[lh uh[bh da[dz
君子尚勇乎	jy[xk zi[lh uh[xk ys[sl hu[pb
君子食無求飽	jy[xk zi[lh ui[rl wu[ee qq[hu bc[ub
君子思不出其位	jy[xk zi[lh si[tx bu[eu iu[ck qi[cb ww[rl
君子所貴乎道者三	jy[xk zi[lh so[pj gv[vb hu[pb dc[bz ve[to sj[hh
君子泰而不驕	jy[xk zi[lh td[su er[ek bu[eu jn[mp
君子坦蕩蕩	jy[xk zi[lh tj[to dh[cd dh[cd
君子務本	jy[xk zi[lh wu[wl bf[ah
君子無所爭	jy[xk zi[lh wu[ee so[pj vg[dx
君子無眾寡	jy[xk zi[lh wu[ee vs[rr gx[gf
君子無終食之間違仁	jy[xk zi[lh wu[ee vs[sw ui[rl vi[dv jm[mo ww[wz rf[re
君子信而後勞其民	jy[xk zi[lh xb[ry er[ek hz[pk lc[cl qi[cb mb[kv
君子學道則愛人	jy[xk zi[lh xt[xz dc[bz ze[bd ai[au rf[pd
君子學以致其道	jy[xk zi[lh xt[xz yi[sr vi[hw qi[cb dc[bz
君子也	jy[xk zi[lh ye[vu
君子亦黨乎	jy[xk zi[lh yi[wy dh[xk hu[pb
君子易事而難說也	jy[xk zi[lh yi[ob ui[hk er[ek nj[yv uo[yb ye[vu
君子以文會友	jy[xk zi[lh yi[sr wf[wi hv[re yz[uy
君子一言以為知	jy[xk zi[lh yi[hh yj[we yi[sr ww[dl vi[uk
君子義以為上	jy[xk zi[lh yi[di yi[sr ww[dl uh[bh
君子義以為質	jy[xk zi[lh yi[di yi[sr ww[dl vi[pu
君子亦有惡乎	jy[xk zi[lh yi[wy yz[uo ee[hx hu[pb
君子亦有窮乎	jy[xk zi[lh yi[wy yz[uo qs[xl hu[pb
君子憂	jy[xk zi[lh yz[xy
君子有九思	jy[xk zi[lh yz[uo jq[pv si[tx
君子有三變	jy[xk zi[lh yz[uo sj[hh bm[yy
君子有三戒	jy[xk zi[lh yz[uo sj[hh jp[gc
君子有三畏	jy[xk zi[lh yz[uo sj[hh ww[th
君子有勇而無義為亂	jy[xk zi[lh yz[uo ys[sl er[ek wu[ee yi[di ww[dl lr[qv
君子欲訥於言而敏於行	jy[xk zi[lh yu[bd ne[yk yu[eu yj[we er[ek mb[rw yu[eu xk[rh
君子於其所不知	jy[xk zi[lh yu[eu qi[cb so[pj bu[eu vi[uk
君子於其言	jy[xk zi[lh yu[eu qi[cb yj[we
君子喻於義	jy[xk zi[lh yu[kr yu[eu yi[di
君子哉	jy[xk zi[lh zd[tk
君子哉蘧伯玉	jy[xk zi[lh zd[tk qu[ch bo[rb yu[wd
君子哉若人	jy[xk zi[lh zd[tk ro[cu rf[pd
君子者乎	jy[xk zi[lh ve[to hu[pb
君子貞而不諒	jy[xk zi[lh vf[bb er[ek bu[eu ll[yw
君子之道	jy[xk zi[lh vi[dv dc[bz
君子之德風	jy[xk zi[lh vi[dv de[ru fg[ji
君子質而已矣	jy[xk zi[lh vi[pu er[ek yi[kv yi[su
君子之過也	jy[xk zi[lh vi[dv go[cz ye[vu
君子之仕也	jy[xk zi[lh vi[dv ui[ru ye[vu
君子之於天下也	jy[xk zi[lh vi[dv yu[eu tm[hd xx[hb ye[vu
君子之至於斯也	jy[xk zi[lh vi[dv vi[ht yu[eu si[qj ye[vu
君子周而不比	jy[xk zi[lh vz[kt er[ek bu[eu bi[bb
君子周急不繼富	jy[xk zi[lh vz[kt ji[dx bu[eu ji[sm fu[gh
君子尊賢而容眾	jy[xk zi[lh zy[bc xm[ub er[ek rs[xr vs[rr
侃侃如也	kj[rk kj[rk ru[nk ye[vu
康子饋藥	kh[gx zi[lh kv[uv yc[cs
康子曰	kh[gx zi[lh yt[wh
可而為之者與	ke[dk er[ek ww[dl vi[dv ve[to yu[hv
克己復禮為仁	ke[ge ji[kv fu[ro li[uv ww[dl rf[re
可欺也	ke[dk qi[qd ye[vu
可使南面	ke[dk ui[rh nj[uk mm[ew
可使有勇	ke[dk ui[rh yz[uo ys[sl
可使足民	ke[dk ui[rh zu[kv mb[kv
可謂	ke[dk ww[yt
可謂大臣與	ke[dk ww[yt da[hr if[ku yu[hv
可謂好學也已矣	ke[dk ww[yt hc[nz xt[xz ye[vu yi[kv yi[su
可謂具臣矣	ke[dk ww[yt ju[jb if[ku yi[su
可謂明也已矣	ke[dk ww[yt mk[oo ye[vu yi[kv yi[su
可謂仁乎	ke[dk ww[yt rf[re hu[pb
可謂仁矣	ke[dk ww[yt rf[re yi[su
可謂仁之方也已	ke[dk ww[yt rf[re vi[dv fh[dw ye[vu yi[kv
可謂士	ke[dk ww[yt ui[uh
可謂士矣	ke[dk ww[yt ui[uh yi[su
可謂孝矣	ke[dk ww[yt xn[tz yi[su
可謂遠也已矣	ke[dk ww[yt yr[ez ye[vu yi[kv yi[su
可謂知乎	ke[dk ww[yt vi[uk hu[pb
可謂知矣	ke[dk ww[yt vi[uk yi[su
可也	ke[dk ye[vu
可以觀	ke[dk yi[sr gr[yj
可以寄百里之命	ke[dk yi[sr ji[gd bd[eo li[ot vi[dv mk[rh
可以群	ke[dk yi[sr qy[xy
可以託六尺之孤	ke[dk yi[sr to[fp lq[wb ii[ud vi[dv gu[zp
可以為難矣	ke[dk yi[sr ww[dl nj[yv yi[su
可以為仁矣	ke[dk yi[sr ww[dl rf[re yi[su
可以為師矣	ke[dk yi[sr ww[dl ui[uh yi[su
可以為文矣	ke[dk yi[sr ww[dl wf[wi yi[su
可以無大過矣	ke[dk yi[sr wu[ee da[hr go[cz yi[su
可以語上也	ke[dk yi[sr yu[yw uh[bh ye[vu
可以怨	ke[dk yi[sr yr[xx
可與共學	ke[dk yu[hv gs[gb xt[xz
可與立	ke[dk yu[hv li[lh
可與適道	ke[dk yu[hv ui[qz dc[bz
可與言而不與言	ke[dk yu[hv yj[we er[ek bu[eu yu[hv yj[we
可者與之	ke[dk ve[to yu[hv vi[dv
可知也	ke[dk vi[uk ye[vu
鏗爾	kg[ju er[dx
硜硜乎	kg[[ kg[[ hu[pb
硜硜然	kg[[ kg[[ rj[xd
悾悾而不信	ks[[ ks[[ er[ek bu[eu xb[ry
空空如也	ks[xg ks[xg ru[nk ye[vu
孔子不見	ks[zv zi[lh bu[eu jm[ke
孔子辭以疾	ks[zv zi[lh ci[ql yi[sr ji[bu
孔子對曰	ks[zv zi[lh dv[yc yt[wh
孔子過之	ks[zv zi[lh go[cz vi[dv
孔子沐浴而朝	ks[zv zi[lh mu[da yu[db er[ek ic[uo
孔子時其亡也	ks[zv zi[lh ui[oc qi[cb wh[wv ye[vu
孔子退	ks[zv zi[lh tv[gz
孔子謂季氏	ks[zv zi[lh ww[yt ji[hz ui[pq
孔子下	ks[zv zi[lh xx[hb
孔子行	ks[zv zi[lh xk[rh
孔子以其兄之子妻之	ks[zv zi[lh yi[sr qi[cb xs[ke vi[dv zi[lh qi[hn vi[dv
孔子於鄉黨	ks[zv zi[lh yu[eu xl[sp dh[xk
孔子與之坐而問焉	ks[zv zi[lh yu[hv vi[dv zo[rr er[ek wf[mk yj[hh
孔子曰	ks[zv zi[lh yt[wh
叩其脛	kz[ke qi[cb jk[os
膾不厭細	kk[or bu[eu yj[iq xi[st
寬則得眾	kr[gc ze[bd de[ro vs[rr
狂而不直	kl[qw er[ek bu[eu vi[uj
匡人其如予何	kl[kw rf[pd qi[cb ru[nk yu[sv he[rk
狂者進取	kl[qw ve[to jb[ez qu[ey
窺見室家之好	kv[xe jm[ke ui[gh jx[gu vi[dv hc[nz
困而不學	ky[wa er[ek bu[eu xt[xz
困而學之	ky[wa er[ek xt[xz vi[dv
來予與爾言	ld[hm yu[sv yu[hv er[dx yj[we
來者猶可追	ld[hm ve[to yz[qy ke[dk vv[pz
老而不死	lc[tb er[ek bu[eu si[hx
勞而不怨	lc[cl er[ek bu[eu yr[xx
牢曰	lc[gn yt[wh
樂必崩	le[px bi[xp bg[uo
樂道人之善	le[px dc[bz rf[pd vi[dv uj[yk
樂多賢友	le[px do[xx xm[ub yz[uy
樂而不淫	le[px er[ek bu[eu yb[da
樂驕樂	le[px jn[mp le[px
樂其可知也	le[px qi[cb ke[dk vi[uk ye[vu
樂然後笑	le[px rj[xd hz[pk xn[vp
樂宴樂	le[px yj[go le[px
樂以忘憂	le[px yi[sr wh[wx yz[xy
樂佚遊	le[px yi[rp yz[df
樂亦在其中矣	le[px yi[wy zd[ut qi[cb vs[ku yi[su
樂雲樂雲	le[px yy[es le[px yy[es
樂則韶	le[px ze[bd uc[ld
誄曰	lw[yl yt[wh
禮必壞	li[uv bi[xp hk[tb
立不中門	li[lh bu[eu vs[ku mf[du
力不足也	li[vp bu[eu zu[kv ye[vu
力不足者	li[vp bu[eu zu[kv ve[to
禮後乎	li[uv hz[pk hu[pb
犁牛之子騂且角	li[hn nq[pf vi[dv zi[lh xk[[ qp[ke jn[do
鯉趨而過庭	li[yo qu[zd er[ek go[cz tk[gq
里仁第四	li[ot rf[re di[vg si[we
里仁為美	li[ot rf[re ww[dl mw[bw
鯉退	li[yo tv[gz
鯉退而學禮	li[yo tv[gz er[ek xt[xz li[uv
禮也	li[uv ye[vu
鯉也死	li[yo ye[vu si[hx
禮以行之	li[uv yi[sr xk[rh vi[dv
立於禮	li[lh yu[eu li[uv
禮與其奢也	li[uv yu[hv qi[cb ue[dt ye[vu
禮樂不興	li[uv yt[px bu[eu xk[xb
禮雲禮雲	li[uv yy[es li[uv yy[es
立則見其參於前也	li[lh ze[bd jm[ke qi[cb cj[sd yu[eu qm[bo ye[vu
禮之用	li[uv vi[dv ys[ou
臨大節而不可奪也	lb[uv da[hr jp[ce er[ek bu[eu ke[dk do[dc ye[vu
林放問禮之本	lb[aa fh[fw wf[mk li[uv vi[dv bf[ah
臨喪不哀	lb[uv sh[ty bu[eu ai[wk
臨之以莊	lb[uv vi[dv yi[sr vl[gt
六十而耳順	lq[wb ui[hu er[ek er[hu uy[iy
柳下惠為士師	lq[ap xx[hb hv[hx ww[dl ui[uh ui[uh
魯人為長府	lu[yo rf[pd ww[dl vh[ph fu[gr
魯衛之政	lu[yo ww[eh vi[dv vg[hw
路文學	lu[zw wf[wi xt[xz
魯一變	lu[yo yi[hh bm[yy
祿在其中矣	lu[ux zd[ut qi[cb vs[ku yi[su
祿之去公室五世矣	lu[ux vi[dv qu[ts gs[bs ui[gh wu[hu ui[nv yi[su
亂邦不居	lr[qv bh[fe bu[eu ju[ug
亂也	lr[qv ye[vu
論篤是與	ly[yr du[vm ui[op yu[hv
屢空	lv[um ks[xg
慮以下人	lv[hx yi[sr xx[hb rf[pd
馬不進也	ma[vv bu[eu jb[ez ye[vu
麻冕	ma[ga mm[od
慢令致期謂之賊	mj[xo lk[rd vi[hw qi[qo ww[yt vi[dv zw[bg
貌思恭	mc[pb si[tx gs[gx
沒階	mw[dj jp[er
美目盼兮	mw[bw mu[we pj[mf xi[bk
每事問	mw[rm ui[hk wf[mk
門人不敬子路	mf[du rf[pd bu[eu jk[cw zi[lh lu[zw
門人厚葬之	mf[du rf[pd hz[io zh[ch vi[dv
門人惑	mf[du rf[pd ho[gx
門人問曰	mf[du rf[pd wf[mk yt[wh
門人慾厚葬之	mf[du rf[pd yu[bd hz[io zh[ch vi[dv
孟公綽為趙魏老則優	mg[zm gs[bs io[sb ww[dl vc[zi ww[hg lc[tb ze[bd yz[ry
孟敬子問之	mg[zm jk[cw zi[lh wf[mk vi[dv
孟氏使陽膚為士師	mg[zm ui[pq ui[rh yh[eo fu[oe ww[dl ui[uh ui[uh
孟孫問孝於我	mg[zm sy[zx wf[mk xn[tz yu[eu wo[pf
孟武伯問孝	mg[zm wu[hv bo[rb wf[mk xn[tz
孟懿子問孝	mg[zm yi[ud zi[lh wf[mk xn[tz
孟之反不伐	mg[zm vi[dv fj[py bu[eu fa[rg
孟莊子之孝也	mg[zm vl[gt zi[lh vi[dv xn[tz ye[vu
苗而不秀者有矣夫	mn[ct er[ek bu[eu xq[hn ve[to yz[uo yi[su fu[er
民到	mb[kv dc[hd
民到於今受其賜	mb[kv dc[hd yu[eu jb[rd uz[ay qi[cb ci[bo
民德歸厚矣	mb[kv de[ru gv[ux hz[io yi[su
民可使由之	mb[kv ke[dk ui[rh yz[ou vi[dv
民免而無恥	mb[kv mm[dk er[ek wu[ee ii[ev
民散久矣	mb[kv sj[gw jq[xd yi[su
民食喪祭	mb[kv ui[rl sh[ty ji[xe
民斯為下矣	mb[kv si[qj ww[dl xx[hb yi[su
民無得而稱焉	mb[kv wu[ee de[ro er[ek ig[hd yj[hh
民無德而稱焉	mb[kv wu[ee de[ru er[ek ig[hd yj[hh
民無能	mb[kv wu[ee ng[sb
民無信不立	mb[kv wu[ee xb[ry bu[eu li[lh
民鮮久矣	mb[kv xm[yy jq[xd yi[su
民信之矣	mb[kv xb[ry vi[dv yi[su
敏以求之者也	mb[rw yi[sr qq[hu vi[dv ve[to ye[vu
敏於事而慎於言	mb[rw yu[eu ui[hk er[ek uf[xu yu[eu yj[we
敏則有功	mb[rw ze[bd yz[uo gs[gl
民之於仁也	mb[kv vi[dv yu[eu rf[re ye[vu
閔子騫	mb[mw zi[lh qm[gm
閔子騫曰	mb[mw zi[lh qm[gm yt[wh
閔子侍側	mb[mw zi[lh ui[rt ce[rb
名不正	mk[xk bu[eu vg[hv
明日	mk[oo ri[wh
明日遂行	mk[oo ri[wh sv[bz xk[rh
名焉	mk[xk yj[hh
命也	mk[rh ye[vu
命矣夫	mk[rh yi[su fu[er
莫不有文武之道焉	mo[co bu[eu yz[uo wf[wi wu[hv vi[dv dc[bz yj[hh
沒齒無怨言	mo[dj ii[vr wu[ee yr[xx yj[we
莫春者	mo[co iy[so ve[to
磨而不磷	mo[ge er[ek bu[eu lb[em
默而識之	mo[hq er[ek ui[yk vi[dv
莫敢不服	mo[co gj[vw bu[eu fu[oe
莫己知也	mo[co ji[kv vi[uk ye[vu
莫能興	mo[co ng[sb xk[xb
莫我知也夫	mo[co wo[pf vi[uk ye[vu fu[er
莫吾猶人也	mo[co wu[wk yz[qy rf[pd ye[vu
末由也已	mo[ha yz[ou ye[vu yi[kv
莫予違也	mo[co yu[sv ww[wz ye[vu
末之難矣	mo[ha vi[dv nj[yv yi[su
末之也	mo[ha vi[dv ye[vu
某在斯	mz[ga zd[ut si[qj
南宮适出	nj[uk gs[gk ui[qz iu[ck
南宮适問於孔子曰	nj[uk gs[gk ui[qz wf[mk yu[eu ks[zv zi[lh yt[wh
難乎免於今之世矣	nj[yv hu[pb mm[dk yu[eu jb[rd vi[dv ui[nv yi[su
難乎有恆矣	nj[yv hu[pb yz[uo hg[xh yi[su
南人有言曰	nj[uk rf[pd yz[uo yj[we yt[wh
南容三復白圭	nj[uk rs[xr sj[hh fu[ro bd[po gv[tt
難矣哉	nj[yv yi[su zd[tk
難與併為仁矣	nj[yv yu[hv bk[bk ww[dl rf[re yi[su
內省不疚	nw[kr xk[xm bu[eu jq[bx
餒在其中矣	nw[ua zd[ut qi[cb vs[ku yi[su
能惡人	ng[sb ee[hx rf[pd
能竭其力	ng[sb jp[lo qi[cb li[vp
能近取譬	ng[sb jb[jz qu[ey pi[uy
能來也	ng[sb ld[hm ye[vu
能使	ng[sb ui[rh
能使枉者直	ng[sb ui[rh wh[aw ve[to vi[uj
能無從乎	ng[sb wu[ee cs[rr hu[pb
能勿誨乎	ng[sb wu[bp hv[yr hu[pb
能勿勞乎	ng[sb wu[bp lc[cl hu[pb
能無說乎	ng[sb wu[ee uo[yb hu[pb
能行五者於天下為仁矣	ng[sb xk[rh wu[hu ve[to yu[eu tm[hd xx[hb ww[dl rf[re yi[su
能以禮讓為國乎	ng[sb yi[sr li[uv rh[yu ww[dl go[ww hu[pb
能致其身	ng[sb vi[hw qi[cb uf[pu
麑裘	ni[[ qq[hy
年飢	nm[rn ji[uj
年四十而見惡焉	nm[rn si[we ui[hu er[ek jm[ke ee[hx yj[hh
鳥獸不可與同群	nn[nh uz[bh bu[eu ke[dk yu[hv ts[kh qy[xy
鳥之將死	nn[nh vi[dv jl[dx si[hx
涅而不緇	np[do er[ek bu[eu zi[sv
寧固	nk[gd gu[wg
寧儉	nk[gd jm[rr
寧媚於灶	nk[gd mw[nm yu[eu zc[ht
甯戚	nk[gd qi[wu
佞人殆	nk[re rf[pd dd[hs
佞也	nk[re ye[vu
女得人焉耳乎	nv[vp de[ro rf[pd yj[hh er[hu hu[pb
女弗能救與	nv[vp fu[gp ng[sb jq[hw yu[hv
女為君子儒	nv[vp ww[dl jy[xk zi[lh ru[ry
女為周南召南矣乎	nv[vp ww[dl vz[kt nj[uk vc[dk nj[uk yi[su hu[pb
女聞六言六蔽矣乎	nv[vp wf[me lq[wb yj[we lq[wb bi[cb yi[su hu[pb
女奚不曰	nv[vp xi[ay bu[eu yt[wh
女以予為多學而識之者與	nv[vp yi[sr yu[sv ww[dl do[xx xt[xz er[ek ui[yk vi[dv ve[to yu[hv
匏瓜也哉	pc[db gx[ps ye[vu zd[tk
陪臣執國命	pw[el if[ku vi[fj go[ww mk[rh
朋友切切偲偲	pg[oo yz[uy qp[qd qp[qd si[rt si[rt
朋友數	pg[oo yz[uy uu[mw
朋友死	pg[oo yz[uy si[hx
朋友之饋	pg[oo yz[uy vi[dv kv[uv
匹夫不可奪志也	pi[ke fu[er bu[eu ke[dk do[dc vi[ux ye[vu
譬如北辰	pi[uy ru[nk bw[ub if[ie
譬如平地	pi[uy ru[nk pk[hb di[ty
譬如為山	pi[uy ru[nk ww[dl uj[uk
譬之宮牆	pi[uy vi[dv gs[gk ql[tt
譬諸草木	pi[uy vu[yt cc[co mu[ub
譬諸小人	pi[uy vu[yt xn[ub rf[pd
偏其反而	pm[rh qi[cb fj[py er[ek
貧而無諂	pb[fb er[ek wu[ee ij[yd
貧而無怨難	pb[fb er[ek wu[ee yr[xx nj[yv
貧且賤焉	pb[fb qp[ke jm[bj yj[hh
貧與賤	pb[fb yu[hv jm[bj
屏四惡	pk[ub si[we ee[hx
其蔽也蕩	qi[cb bi[cb ye[vu dh[cd
其蔽也絞	qi[cb bi[cb ye[vu jn[sl
其蔽也狂	qi[cb bi[cb ye[vu kl[qw
其蔽也亂	qi[cb bi[cb ye[vu lr[qv
其蔽也愚	qi[cb bi[cb ye[vu yu[ox
其蔽也賊	qi[cb bi[cb ye[vu zw[bg
豈不爾思	qi[uk bu[eu er[dx si[tx
其不改父之臣	qi[cb bu[eu gd[kw fu[bi vi[dv if[ku
其不可者拒之	qi[cb bu[eu ke[dk ve[to ju[fk vi[dv
其不善者惡之	qi[cb bu[eu uj[yk ve[to ee[hx vi[dv
其不善者而改之	qi[cb bu[eu uj[yk ve[to er[ek gd[kw vi[dv
杞不足徵也	qi[ak bu[eu zu[kv vg[rh ye[vu
其次辟地	qi[cb ci[dd pi[ul di[ty
其次辟色	qi[cb ci[dd pi[ul se[db
其次辟言	qi[cb ci[dd pi[ul yj[we
其從之也	qi[cb cs[rr vi[dv ye[vu
其父攘羊	qi[cb fu[bi rh[fw yh[bs
齊何人也	qi[wp he[rk rf[pd ye[vu
其何傷於日月乎	qi[cb he[rk uh[rr yu[eu ri[wh yt[ke hu[pb
其何以行之哉	qi[cb he[rk yi[sr xk[rh vi[dv zd[tk
齊桓公正而不譎	qi[wp hr[ah gs[bs vg[hv er[ek bu[eu jt[yy
其回也與	qi[cb hv[wk ye[vu yu[hv
其或繼周者	qi[cb ho[gk ji[sm vz[kt ve[to
齊景公待孔子曰	qi[wp jk[ow gs[bs dd[rt ks[zv zi[lh yt[wh
齊景公問政於孔子	qi[wp jk[ow gs[bs wf[mk vg[hw yu[eu ks[zv zi[lh
齊景公有馬千駟	qi[wp jk[ow gs[bs yz[uo ma[vv qm[pu si[ms
其可謂至德也已矣	qi[cb ke[dk ww[yt vi[ht de[ru ye[vu yi[kv yi[su
其可已矣	qi[cb ke[dk yi[kv yi[su
期可已矣	qi[qo ke[dk yi[kv yi[su
其門而入	qi[cb mf[du er[ek ru[pd
其鳴也哀	qi[cb mk[kn ye[vu ai[wk
豈其然乎	qi[uk qi[cb rj[xd hu[pb
其親	qi[cb qb[la
其然	qi[cb rj[xd
其然也	qi[cb rj[xd ye[vu
齊人歸女樂	qi[wp rf[pd gv[ux nv[vp yt[px
其如示諸斯乎	qi[cb ru[nk ui[ex vu[yt si[qj hu[pb
豈若從辟世之士哉	qi[uk ro[cu cs[rr pi[ul ui[nv vi[dv ui[uh zd[tk
豈若匹夫匹婦之為諒也	qi[uk ro[cu pi[ke fu[er pi[ke fu[nx vi[dv ww[dl ll[yw ye[vu
其身不正	qi[cb uf[pu bu[eu vg[hv
其身正	qi[cb uf[pu vg[hv
其生也榮	qi[cb ug[pf ye[vu rs[ca
七十而從心所欲	qi[hv ui[hu er[ek cs[rr xb[dv so[pj yu[bd
其事也	qi[cb ui[hk ye[vu
其恕乎	qi[cb uu[nx hu[pb
其舜也與	qi[cb uy[ax ye[vu yu[hv
其斯而已矣	qi[cb si[qj er[ek yi[kv yi[su
其死也哀	qi[cb si[hx ye[vu ai[wk
其斯之謂與	qi[cb si[qj vi[dv ww[yt yu[hv
其他可能也	qi[cb ta[ry ke[dk ng[sb ye[vu
欺天乎	qi[qd tm[hd hu[pb
其未得之也	qi[cb ww[ha de[ro vi[dv ye[vu
其為仁	qi[cb ww[dl rf[re
其為人也	qi[cb ww[dl rf[pd ye[vu
其為人也孝弟	qi[cb ww[dl rf[pd ye[vu xn[tz di[bg
其為仁之本與	qi[cb ww[dl rf[re vi[dv bf[ah yu[hv
其惟聖人乎	qi[cb ww[xv ug[yt rf[pd hu[pb
其心三月不違仁	qi[cb xb[dv sj[hh yt[ke bu[eu ww[wz rf[re
其言不讓	qi[cb yj[we bu[eu rh[yu
其言似不足者	qi[cb yj[we si[rs bu[eu zu[kv ve[to
其言也訒	qi[cb yj[we ye[vu rf[[
其言也善	qi[cb yj[we ye[vu uj[yk
其言之不怍	qi[cb yj[we vi[dv bu[eu zo[xv
齊一變	qi[wp yi[hh bm[yy
期已久矣	qi[qo yi[kv jq[xd yi[su
其猶穿窬之盜也與	qi[cb yz[qy ir[xy yu[xr vi[dv dc[dm ye[vu yu[hv
其有所試矣	qi[cb yz[uo so[pj ui[yq yi[su
其由也與	qi[cb yz[ou ye[vu yu[hv
其猶正牆面而立也與	qi[cb yz[qy vg[hv ql[tt mm[ew er[ek li[lh ye[vu yu[hv
其餘不足觀也已	qi[cb yu[re bu[eu zu[kv gr[yj ye[vu yi[kv
啟予手	qi[hk yu[sv uz[su
其餘則日月至焉而已矣	qi[cb yu[re ze[bd ri[wh yt[ke vi[ht yj[hh er[ek yi[kv yi[su
起予者商也	qi[zk yu[sv ve[to uh[lk ye[vu
啟予足	qi[hk yu[sv zu[kv
其在宗廟朝廷	qi[cb zd[ut zs[ge mn[gy ic[uo tk[qj
其爭也君子	qi[cb vg[dx ye[vu jy[xk zi[lh
器之	qi[kq vi[dv
其至矣乎	qi[cb vi[ht yi[su hu[pb
齊之以禮	qi[wp vi[dv yi[sr li[uv
齊之以刑	qi[wp vi[dv yi[sr xk[kd
其終也已	qi[cb vs[sw ye[vu yi[kv
其諸異乎人之求之與	qi[cb vu[yt yi[kc hu[pb rf[pd vi[dv qq[hu vi[dv yu[hv
千乘之國	qm[pu ug[qb vi[dv go[ww
前言戲之耳	qm[bo yj[we xi[yg vi[dv er[hu
淺則揭	qm[dj ze[bd jp[fo
巧笑倩兮	qn[gk xn[vp qm[rf xi[bk
巧言令色	qn[gk yj[we lk[rd se[db
巧言亂德	qn[gk yj[we lr[qv de[ru
竊比於我老彭	qp[xq bi[bb yu[eu wo[pf lc[tb pg[up
且爾言過矣	qp[ke er[dx yj[we go[cz yi[su
且而與其從辟人之士	qp[ke er[ek yu[hv qi[cb cs[rr pi[ul rf[pd vi[dv ui[uh
切切偲偲	qp[qd qp[qd si[rt si[rt
切問而近思	qp[qd wf[mk er[ek jb[jz si[tx
且予與其死於臣之手也	qp[ke yu[sv yu[hv qi[cb si[hx yu[eu if[ku vi[dv uz[su ye[vu
且予縱	qp[ke yu[sv zs[sr
且在邦域之	qp[ke zd[ut bh[fe yu[tg vi[dv
且知方也	qp[ke vi[uk fh[dw ye[vu
寢不屍	qb[gd bu[eu ui[kp
寢不言	qb[gd bu[eu yj[we
親於其身為不善者	qb[la yu[eu qi[cb uf[pu ww[dl bu[eu uj[yk ve[to
請事斯語矣	qk[yf ui[hk si[qj yu[yw yi[su
請討之	qk[yf tc[yc vi[dv
請問其目	qk[yf wf[mk qi[cb mu[we
請問之	qk[yf wf[mk vi[dv
請學為圃	qk[yf xt[xz ww[dl pu[wf
請益	qk[yf yi[bm
求備焉	qq[hu bw[wt yj[hh
丘不	qq[jh bu[eu
求爾何如	qq[hu er[dx he[rk ru[nk
丘何為是棲棲者與	qq[jh he[rk ww[dl ui[op xi[ax xi[ax ve[to yu[hv
丘陵	qq[jh lk[et
求其志	qq[hu qi[cb vi[ux
求仁而得仁	qq[hu rf[re er[ek de[ro rf[re
求善賈而沽諸	qq[hu uj[yk jx[xb er[ek gu[dg vu[yt
丘未達	qq[jh ww[ha da[dz
求為可知也	qq[hu ww[dl ke[dk vi[uk ye[vu
求無乃爾是過與	qq[hu wu[ee nd[vp er[dx ui[op go[cz yu[hv
求也可使從政也與	qq[hu ye[vu ke[dk ui[rh cs[rr vg[hw ye[vu yu[hv
求也退	qq[hu ye[vu tv[gz
求也為之	qq[hu ye[vu ww[dl vi[dv
求也問聞斯行諸	qq[hu ye[vu wf[mk wf[me si[qj xk[rh vu[yt
丘也聞有國有家者	qq[jh ye[vu wf[me yz[uo go[ww yz[uo jx[gu ve[to
丘也幸	qq[jh ye[vu xk[tb
求也藝	qq[hu ye[vu yi[cv
丘之禱久矣	qq[jh vi[dv dc[uf jq[xd yi[su
求之與	qq[hu vi[dv yu[hv
去兵	qu[ts bk[qb
蘧伯玉使人於孔子	qu[ch bo[rb yu[wd ui[rh rf[pd yu[eu ks[zv zi[lh
趨而闢之	qu[zd er[ek pi[ul vi[dv
曲肱而枕之	qu[ou gs[ou er[ek vf[ag vi[dv
趨進	qu[zd jb[ez
去喪	qu[ts sh[ty
取瑟而歌	qu[ey se[wx er[ek ge[kd
去食	qu[ts ui[rl
區以別矣	qu[ki yi[sr bp[kd yi[su
闕黨童子將命	qt[mn dh[xk ts[lo zi[lh jl[dx mk[rh
群而不黨	qy[xy er[ek bu[eu dh[xk
群居終日	qy[xy ju[ug vs[sw ri[wh
然而未仁	rj[xd er[ek ww[ha rf[re
然非與	rj[xd fw[su yu[hv
然後君子	rj[xd hz[pk jy[xk zi[lh
然後免於父母之懷	rj[xd hz[pk mm[dk yu[eu fu[bi mu[vv vi[dv hk[xb
然後為學	rj[xd hz[pk ww[dl xt[xz
然後樂正	rj[xd hz[pk yt[px vg[hv
然乎	rj[xd hu[pb
冉求曰	rj[kt qq[hu yt[wh
冉求之藝	rj[kt qq[hu vi[dv yi[cv
冉有季	rj[kt yz[uo ji[hz
冉有季路見於孔子曰	rj[kt yz[uo ji[hz lu[zw jm[ke yu[eu ks[zv zi[lh yt[wh
冉有僕	rj[kt yz[uo pu[rb
冉有問	rj[kt yz[uo wf[mk
冉有曰	rj[kt yz[uo yt[wh
冉有子貢侃侃如也	rj[kt yz[uo zi[lh gs[gb kj[rk kj[rk ru[nk ye[vu
然則從之者與	rj[xd ze[bd cs[rr vi[dv ve[to yu[hv
然則管	rj[xd ze[bd gr[vg
然則師愈與	rj[xd ze[bd ui[uh yu[rx yu[hv
冉子退朝	rj[kt zi[lh tv[gz ic[uo
冉子為其母請粟	rj[kt zi[lh ww[dl qi[cb mu[vv qk[yf su[xm
冉子與之粟五秉	rj[kt zi[lh yu[hv vi[dv su[xm wu[hu bk[ph
人必知之	rf[pd bi[xp vi[uk vi[dv
人不	rf[pd bu[eu
人不間於其父母昆弟之言	rf[pd bu[eu jm[mo yu[eu qi[cb fu[bi mu[vv ky[ob di[bg vi[dv yj[we
人不堪其憂	rf[pd bu[eu kj[tq qi[cb yz[xy
仁不能守之	rf[re bu[eu ng[sb uz[gc vi[dv
人不厭其取	rf[pd bu[eu yj[iq qi[cb qu[ey
人不厭其言	rf[pd bu[eu yj[iq qi[cb yj[we
人不知	rf[pd bu[eu vi[uk
人而不仁	rf[pd er[ek bu[eu rf[re
人而不為周南召南	rf[pd er[ek bu[eu ww[dl vz[kt nj[uk vc[dk nj[uk
人而無恆	rf[pd er[ek wu[ee hg[xh
人而無信	rf[pd er[ek wu[ee xb[ry
人將拒我	rf[pd jl[dx ju[fk wo[pf
人潔己以進	rf[pd jp[du ji[kv yi[sr jb[ez
人皆有兄弟	rf[pd jp[bb yz[uo xs[ke di[bg
人能弘道	rf[pd ng[sb hs[gs dc[bz
仁能守之	rf[re ng[sb uz[gc vi[dv
人其舍諸	rf[pd qi[cb ue[rg vu[yt
人雖欲自絕	rf[pd sv[ki yu[bd zi[pm jt[sd
人未有自致者也	rf[pd ww[ha yz[uo zi[pm vi[hw ve[to ye[vu
人無遠慮	rf[pd wu[ee yr[ez lv[hx
人焉廋哉	rf[pd yj[hh sz[[ zd[tk
人也	rf[pd ye[vu
人以為諂也	rf[pd yi[sr ww[dl ij[yd ye[vu
仁以為己任	rf[re yi[sr ww[dl ji[kv rf[rq
仁遠乎哉	rf[re yr[ez hu[pb zd[tk
人曰	rf[pd yt[wh
仁在其中矣	rf[re zd[ut qi[cb vs[ku yi[su
仁則吾不	rf[re ze[bd wu[wk bu[eu
仁者	rf[re ve[to
仁者安仁	rf[re ve[to an[gn rf[re
仁者必有勇	rf[re ve[to bi[xp yz[uo ys[sl
仁者不憂	rf[re ve[to bu[eu yz[xy
仁者靜	rf[re ve[to jk[fd
仁者樂山	rf[re ve[to le[px uj[uk
仁者壽	rf[re ve[to uz[fc
仁者先難而後獲	rf[re ve[to xm[ne nj[yv er[ek hz[pk ho[cq
人之過也	rf[pd vi[dv go[cz ye[vu
人之將死	rf[pd vi[dv jl[dx si[hx
人之生也直	rf[pd vi[dv ug[pf ye[vu vi[uj
人之言曰	rf[pd vi[dv yj[we yt[wh
任重而道遠	rf[rq vs[ph er[ek dc[bz yr[ez
仍舊貫	rg[rn jq[uo gr[mb
日月逝矣	ri[wh yt[ke ui[fz yi[su
日月也	ri[wh yt[ke ye[vu
日知其所亡	ri[wh vi[uk qi[cb so[pj wh[wv
肉雖多	rz[kr sv[ki do[xx
孺悲欲見孔子	ru[zy bw[fx yu[bd jm[ke ks[zv zi[lh
如不祭	ru[nk bu[eu ji[xe
如不可求	ru[nk bu[eu ke[dk qq[hu
如不容	ru[nk bu[eu rs[xr
如不如鄉人之善者好之	ru[nk bu[eu ru[nk xl[sp rf[pd vi[dv uj[yk ve[to hc[nz vi[dv
如不善而莫之違也	ru[nk bu[eu uj[yk er[ek mo[co vi[dv ww[wz ye[vu
如不勝	ru[nk bu[eu ug[op
如得其情	ru[nk de[ro qi[cb qk[xf
如浮雲	ru[nk fu[da yy[es
入公門	ru[pd gs[bs mf[du
如會同	ru[nk hv[re ts[kh
如樂何	ru[nk le[px he[rk
如禮何	ru[nk li[uv he[rk
如臨	ru[nk lb[uv
如履薄冰	ru[nk lv[ur bo[cd bk[du
如其禮樂	ru[nk qi[cb li[uv yt[px
如其仁	ru[nk qi[cb rf[re
如其善而莫之違也	ru[nk qi[cb uj[yk er[ek mo[co vi[dv ww[wz ye[vu
如日月之食焉	ru[nk ri[wh yt[ke vi[dv ui[rl yj[hh
如殺無道	ru[nk ua[ia wu[ee dc[bz
如斯而已乎	ru[nk si[qj er[ek yi[kv hu[pb
入太廟	ru[pd td[dd mn[gy
如五六十	ru[nk wu[hu lq[wb ui[hu
如也	ru[nk ye[vu
如用之	ru[nk ys[ou vi[dv
如有博施於民而能濟眾	ru[nk yz[uo bo[uf ui[fr yu[eu mb[kv er[ek ng[sb ji[dw vs[rr
如有所立卓爾	ru[nk yz[uo so[pj li[lh vo[bo er[dx
如有所譽者	ru[nk yz[uo so[pj yu[xy ve[to
如有王者	ru[nk yz[uo wh[su ve[to
如有用我者	ru[nk yz[uo ys[ou wo[pf ve[to
如有政	ru[nk yz[uo vg[hw
如有周公之才之美	ru[nk yz[uo vz[kt gs[bs vi[dv cd[hu vi[dv mw[bw
如愚	ru[nk yu[ox
入曰	ru[pd yt[wh
入則事父兄	ru[pd ze[bd ui[hk fu[bi xs[ke
如正人何	ru[nk vg[hv rf[pd he[rk
如之何	ru[nk vi[dv he[rk
如之何其徹也	ru[nk vi[dv he[rk qi[cb ie[rq ye[vu
如之何其廢之	ru[nk vi[dv he[rk qi[cb fw[gv vi[dv
如之何其拒人也	ru[nk vi[dv he[rk qi[cb ju[fk rf[pd ye[vu
如之何其可及也	ru[nk vi[dv he[rk qi[cb ke[dk ji[pv ye[vu
如之何其聞斯行之	ru[nk vi[dv he[rk qi[cb wf[me si[qj xk[rh vi[dv
如之何者	ru[nk vi[dv he[rk ve[to
如知為君之難也	ru[nk vi[uk ww[dl jy[xk vi[dv nj[yv ye[vu
如琢如磨	ru[nk vo[wu ru[nk mo[ge
若季氏則吾不能	ro[cu ji[hz ui[pq ze[bd wu[wk bu[eu ng[sb
若聖與仁	ro[cu ug[yt yu[hv rf[re
若由也	ro[cu yz[ou ye[vu
若臧武仲之知	ro[cu zh[wk wu[hv vs[rv vi[dv vi[uk
三黜	sj[hh iu[hi
三代	sj[hh dd[rq
三飯繚適蔡	sj[hh fj[up ln[sd ui[qz cd[cx
三分天下有其二	sj[hh ff[bd tm[hd xx[hb yz[uo qi[cb er[hh
三家者	sj[hh jx[gu ve[to
三軍可奪帥也	sj[hh jy[gi ke[dk do[dc uk[uj ye[vu
三年	sj[hh nm[rn
三年不為樂	sj[hh nm[rn bu[eu ww[dl le[px
三年不言	sj[hh nm[rn bu[eu yj[we
三年無改於父之道	sj[hh nm[rn wu[ee gd[kw yu[eu fu[bi vi[dv dc[bz
三年學	sj[hh nm[rn xt[xz
三年有成	sj[hh nm[rn yz[uo ig[wv
三年之喪	sj[hh nm[rn vi[dv sh[ty
三人行	sj[hh rf[pd xk[rh
三日不朝	sj[hh ri[wh bu[eu ic[uo
三世	sj[hh ui[nv
三十而立	sj[hh ui[hu er[ek li[lh
三嗅而作	sj[hh xq[kz er[ek zo[rv
三以天下讓	sj[hh yi[sr tm[hd xx[hb rh[yu
三月不知肉味	sj[hh yt[ke bu[eu vi[uk rz[kr ww[kh
三子者出	sj[hh zi[lh ve[to iu[ck
喪邦乎	sh[ty bh[fe hu[pb
喪事不敢不勉	sh[ty ui[hk bu[eu gj[vw bu[eu mm[dl
喪思哀	sh[ty si[tx ai[wk
喪與其易也	sh[ty yu[hv qi[cb yi[ob ye[vu
喪致乎哀而止	sh[ty vi[hw hu[pb ai[wk er[ek vi[uh
色勃如也	se[db bo[ul ru[nk ye[vu
色惡	se[db ee[hx
色厲而內荏	se[db li[iw er[ek nw[kr rf[cr
色難	se[db nj[yv
色取仁	se[db qu[ey rf[re
色斯舉矣	se[db si[qj ju[xf yi[su
色思溫	se[db si[tx wf[do
色莊者乎	se[db vl[gt ve[to hu[pb
殺雞為黍而食之	ua[ia ji[yn ww[dl uu[hr er[ek ui[rl vi[dv
山川其舍諸	uj[uk ir[pu qi[cb ue[rg vu[yt
善夫	uj[yk fu[er
善居室	uj[yk ju[ug ui[gh
山樑雌雉	uj[uk ll[da ci[vv vi[uv
善人教民七年	uj[yk rf[pd jn[tw mb[kv qi[hv nm[rn
善人是富	uj[yk rf[pd ui[op fu[gh
善人為邦百年	uj[yk rf[pd ww[dl bh[fe bd[eo nm[rn
善人吾不得而見之矣	uj[yk rf[pd wu[wk bu[eu de[ro er[ek jm[ke vi[dv yi[su
善為我辭焉如有復我者	uj[yk ww[dl wo[pf ci[ql yj[hh ru[nk yz[uo fu[ro wo[pf ve[to
善誘人	uj[yk yz[yh rf[pd
善哉	uj[yk zd[tk
善哉問	uj[yk zd[tk wf[mk
尚德哉若人	uh[xk de[ru zd[tk ro[cu rf[pd
上好禮	uh[bh hc[nz li[uv
上好信	uh[bh hc[nz xb[ry
上好義	uh[bh hc[nz yi[di
傷人乎	uh[rr rf[pd hu[pb
上如揖	uh[bh ru[nk yi[fk
上失其道	uh[bh ui[pe qi[cb dc[bz
商聞之矣	uh[lk wf[me vi[dv yi[su
上下神只	uh[bh xx[hb uf[uo vi[kb
商也不及	uh[lk ye[vu bu[eu ji[pv
上矣	uh[bh yi[su
上者	uh[bh ve[to
少師陽擊磬襄入於海	uc[xp ui[uh yh[eo ji[fk qk[ue xl[wk ru[pd yu[eu hd[dr
少有	uc[xp yz[uo
少之時	uc[xp vi[dv ui[oc
射不主皮	ue[uc bu[eu vu[dw pi[vp
攝乎大國之間	ue[fe hu[pb da[hr go[ww vi[dv jm[mo
攝齊升堂	ue[fe qi[wp ug[pc th[xt
舍瑟而作	ue[rg se[wx er[ek zo[rv
赦小過	ue[tw xn[ub go[cz
奢則不孫	ue[dt ze[bd bu[eu sy[zx
舍之則藏	ue[rg vi[dv ze[bd ch[cw
慎而無禮則葸	uf[xu er[ek wu[ee li[uv ze[bd xi[ct
審法度	uf[go fa[dt du[gn
申申如也	uf[ou uf[ou ru[nk ye[vu
慎行其餘	uf[xu xk[rh qi[cb yu[re
慎言其餘	uf[xu yj[we qi[cb yu[re
甚矣吾衰也	uf[qv yi[su wu[wk uk[wk ye[vu
甚於水火	uf[qv yu[eu uv[uu ho[dp
深淵	uf[dg yr[dp
深則厲	uf[dg ze[bd li[iw
身中清	uf[pu vs[ku qk[df
慎終追遠	uf[xu vs[sw vv[pz yr[ez
升車	ug[pc ie[qu
生而知之者上也	ug[pf er[ek vi[uk vi[dv ve[to uh[bh ye[vu
聖人吾不得而見之矣	ug[yt rf[pd wu[wk bu[eu de[ro er[ek jm[ke vi[dv yi[su
事不成	ui[hk bu[eu ig[wv
士不可以不弘毅	ui[uh bu[eu ke[dk yi[sr bu[eu hs[gs yi[lj
食不厭精	ui[rl bu[eu yj[iq jk[mf
食不語	ui[rl bu[eu yu[yw
是道也	ui[op dc[bz ye[vu
士而懷居	ui[uh er[ek hk[xb ju[ug
仕而優則學	ui[ru er[ek yz[ry ze[bd xt[xz
式負	ui[qg fu[db
食夫稻	ui[rl fu[er dc[ha
事父母	ui[hk fu[bi mu[vv
事父母幾諫	ui[hk fu[bi mu[vv ji[pv jm[yh
弒父與君	ui[iq fu[bi yu[hv jy[xk
是故惡夫佞者	ui[op gu[gw ee[hx fu[er nk[re ve[to
是故哂之	ui[op gu[gw uf[kx vi[dv
士何如斯可謂之達矣	ui[uh he[rk ru[nk si[qj ke[dk ww[yt vi[dv da[dz yi[su
使乎	ui[rh hu[pb
是惑也	ui[op ho[gx ye[vu
士見危致命	ui[uh jm[ke ww[de vi[hw mk[rh
使驕且吝	ui[rh jn[mp qp[ke lb[wk
事君	ui[hk jy[xk
事君盡禮	ui[hk jy[xk jb[ud li[uv
事君敬其事	ui[hk jy[xk jk[cw qi[cb ui[hk
事君數	ui[hk jy[xk uu[mw
是可忍也	ui[op ke[dk rf[dx ye[vu
詩可以興	ui[yt ke[dk yi[sr xk[xb
始可與言詩已矣	ui[ns ke[dk yu[hv yj[we ui[yt yi[kv yi[su
是禮也	ui[op li[uv ye[vu
是魯孔丘與	ui[op lu[yo ks[zv qq[jh yu[hv
是魯孔丘之徒與	ui[op lu[yo ks[zv qq[jh vi[dv tu[rz yu[hv
師冕出	ui[uh mm[od iu[ck
師冕見	ui[uh mm[od jm[ke
使民敬忠以勸	ui[rh mb[kv jk[cw vs[vx yi[sr qr[yl
使民如承大祭	ui[rh mb[kv ru[nk ig[lu da[hr ji[xe
使民以時	ui[rh mb[kv yi[sr ui[oc
使民戰慄	ui[rh mb[kv vj[bg li[xa
是難能也	ui[op nj[yv ng[sb ye[vu
事其大夫之賢者	ui[hk qi[cb dd[hr fu[er vi[dv xm[ub ve[to
視其所以	ui[uj qi[cb so[pj yi[sr
是丘也	ui[op qq[jh ye[vu
失飪	ui[pe rf[uq
失人	ui[pe rf[pd
是人之	ui[op rf[pd vi[dv
是人之所欲也	ui[op rf[pd vi[dv so[pj yu[bd ye[vu
實若虛	ui[gd ro[cu xu[hy
詩三百	ui[yt sj[hh bd[eo
是社稷之臣也	ui[op ue[ut ji[ht vi[dv if[ku ye[vu
十世可知也	ui[hu ui[nv ke[dk vi[uk ye[vu
侍食於君	ui[rt ui[rl yu[eu jy[xk
室是遠而	ui[gh ui[op yr[ez er[ek
世叔討論之	ui[nv uu[uy tc[yc ly[yr vi[dv
詩書執禮	ui[yt uu[vv vi[fj li[uv
是誰之過與	ui[op uv[yv vi[dv go[cz yu[hv
事思	ui[hk si[tx
視思明	ui[uj si[tx mk[oo
是謂過矣	ui[op ww[yt go[cz yi[su
是謂能養	ui[op ww[yt ng[sb yh[yp
是謂棄之	ui[op ww[yt qi[wc vi[dv
是為賊	ui[op ww[dl zw[bg
是聞也	ui[op wf[me ye[vu
是吾憂也	ui[op wu[wk yz[xy ye[vu
是賢乎	ui[op xm[ub hu[pb
失言	ui[pe yj[we
是也	ui[op ye[vu
師也過	ui[uh ye[vu go[cz
師也闢	ui[uh ye[vu pi[ul
食饐而餲	ui[rl yi[[ er[ek ai[[
是以君子不為也	ui[op yi[sr jy[xk zi[lh bu[eu ww[dl ye[vu
是以君子惡居下流	ui[op yi[sr jy[xk zi[lh wu[hx ju[ug xx[hb lq[dw
是亦為政	ui[op yi[wy ww[dl vg[hw
氏亦有反坫	ui[pq yi[wy yz[uo fj[py dm[tb
始有	ui[ns yz[uo
侍於君子有三愆	ui[rt yu[eu jy[xk zi[lh yz[uo sj[hh qm[rx
師與商也孰賢	ui[uh yu[hv uh[lk ye[vu uu[wj xm[ub
使於四方	ui[rh yu[eu si[we fh[dw
施於有政	ui[fr yu[eu yz[uo vg[hw
詩云	ui[yt yy[es
詩云如切如磋	ui[yt yy[es ru[nk qp[qd ru[nk co[ey
時哉時哉	ui[oc zd[tk ui[oc zd[tk
使者出	ui[rh ve[to iu[ck
逝者如斯夫	ui[fz ve[to ru[nk si[qj fu[er
食旨不甘	ui[rl vi[bo bu[eu gj[nh
是知津	ui[op vi[uk jb[dy
是知其不	ui[op vi[uk qi[cb bu[eu
使之聞之	ui[rh vi[dv wf[me vi[dv
是知也	ui[op vi[uk ye[vu
事之以禮	ui[hk vi[dv yi[sr li[uv
士志於道	ui[uh vi[ux yu[eu dc[bz
師摯之始	ui[uh vi[ff vi[dv ui[ns
使子路反見之	ui[rh zi[lh lu[zw fj[py jm[ke vi[dv
使子路問津焉	ui[rh zi[lh lu[zw wf[mk jb[dy yj[hh
始作	ui[ns zo[rv
守死善道	uz[gc si[hx uj[yk dc[bz
授之以政	uz[fa vi[dv yi[sr vg[hw
孰不可忍也	uu[wj bu[eu ke[dk rf[dx ye[vu
孰不知禮	uu[wj bu[eu vi[uk li[uv
述而不作	uu[az er[ek bu[eu zo[rv
述而第七	uu[az er[ek di[vg qi[hv
孰敢不正	uu[wj gj[vw bu[eu vg[hv
孰後倦焉	uu[wj hz[pk jr[rb yj[hh
孰能為之大	uu[wj ng[sb ww[dl vi[dv da[hr
叔孫武叔毀仲尼	uu[uy sy[zx wu[hv uu[uy hv[jj vs[rv ni[ub
叔孫武叔語大夫於朝	uu[uy sy[zx wu[hv uu[uy yu[yw dd[hr fu[er yu[eu ic[uo
孰為夫子	uu[wj ww[dl fu[er zi[lh
孰謂鄹人之子知禮乎	uu[wj ww[yt zz[ee rf[pd vi[dv zi[lh vi[uk li[uv hu[pb
孰先傳焉	uu[wj xm[ne ir[re yj[hh
庶矣哉	uu[gn yi[su zd[tk
書雲	uu[vv yy[es
誰毀誰譽	uv[yv hv[jj uv[yv yu[xy
水火	uv[uu ho[dp
誰能出不由戶	uv[yv ng[sb iu[ck bu[eu yz[ou hu[du
誰為	uv[yv ww[dl
舜亦以命禹	uy[ax yi[wy yi[sr mk[rh yu[pk
舜有臣五人而天下治	uy[ax yz[uo if[ku wu[hu rf[pd er[ek tm[hd xx[hb vi[ds
舜有天下	uy[ax yz[uo tm[hd xx[hb
舜禹之有天下也而不與焉	uy[ax yu[pk vi[dv yz[uo tm[hd xx[hb ye[vu er[ek bu[eu yu[hv yj[hh
說而不繹	uo[yb er[ek bu[eu yi[sy
說也	uo[yb ye[vu
說之不以道	uo[yb vi[dv bu[eu yi[sr dc[bz
說之雖不以道	uo[yb vi[dv sv[ki bu[eu yi[sr dc[bz
駟不及舌	si[ms bu[eu ji[pv ue[qk
似不能言者	si[rs bu[eu ng[sb yj[we ve[to
斯不亦惠而不費乎	si[qj bu[eu yi[wy hv[hx er[ek bu[eu fw[fb hu[pb
斯不亦泰而不驕乎	si[qj bu[eu yi[wy td[su er[ek bu[eu jn[mp hu[pb
斯不亦威而不猛乎	si[qj bu[eu yi[wy ww[wh er[ek bu[eu mg[qz hu[pb
斯出矣	si[qj iu[ck yi[su
私覿	si[hs di[uj
思而不學	si[tx er[ek bu[eu xt[xz
死而後已	si[hx er[ek hz[pk yi[kv
死而無悔者	si[hx er[ek wu[ee hv[xr ve[to
四飯缺適秦	si[we fj[up qt[pv ui[qz qb[sh
四方之政行焉	si[we fh[dw vi[dv vg[hw xk[rh yj[hh
四海困窮	si[we hd[dr ky[wa qs[xl
斯害也已	si[qj hd[gf ye[vu yi[kv
四海之內皆兄弟也	si[we hd[dr vi[dv nw[kr jp[bb xs[ke di[bg ye[vu
斯己而已矣	si[qj ji[kv er[ek yi[kv yi[su
斯近信矣	si[qj jb[jz xb[ry yi[su
斯可矣	si[qj ke[dk yi[su
斯可以從政矣	si[qj ke[dk yi[sr cs[rr vg[hw yi[su
司馬牛問君子	si[vh ma[vv nq[pf wf[mk jy[xk zi[lh
司馬牛問仁	si[vh ma[vv nq[pf wf[mk rf[re
司馬牛憂曰	si[vh ma[vv nq[pf yz[xy yt[wh
斯民也	si[qj mb[kv ye[vu
斯人也而有斯疾也	si[qj rf[pd ye[vu er[ek yz[uo si[qj ji[bu ye[vu
斯仁至矣	si[qj rf[re vi[ht yi[su
斯辱矣	si[qj ru[ic yi[su
死生有命	si[hx ug[pf yz[uo mk[rh
四十而不惑	si[we ui[hu er[ek bu[eu ho[gx
四十五十而無聞焉	si[we ui[hu wu[hu ui[hu er[ek wu[ee wf[me yj[hh
四時行焉	si[we ui[oc xk[rh yj[hh
斯疏矣	si[qj uu[pw yi[su
四體不勤	si[we ti[ra bu[eu qb[nl
斯謂之君子已乎	si[qj ww[yt vi[dv jy[xk zi[lh yi[kv hu[pb
斯謂之仁已乎	si[qj ww[yt vi[dv rf[re yi[kv hu[pb
思無邪	si[tx wu[ee xp[ye
斯亦不足	si[qj yi[wy bu[eu zu[kv
斯遠暴慢矣	si[qj yr[ez bc[og mj[xo yi[su
斯遠鄙倍矣	si[qj yr[ez bi[ke bw[rl yi[su
斯知仁矣	si[qj vi[uk rf[re yi[su
死之日	si[hx vi[dv ri[wh
宋不足徵也	ss[ga bu[eu zu[kv vg[rh ye[vu
誦詩三百	ss[ys ui[yt sj[hh bd[eo
素衣	su[fy yi[wy
素以為絢兮	su[fy yi[sr ww[dl xr[sb xi[bk
雖百世	sv[ki bd[eo ui[nv
歲不我與	sv[ux bu[eu wo[pf yu[hv
雖不吾以	sv[ki bu[eu wu[wk yi[sr
雖車馬	sv[ki ie[qu ma[vv
雖得之	sv[ki de[ro vi[dv
雖多	sv[ki do[xx
雖覆一簣	sv[ki fu[xr yi[hh kv[vv
雖告之曰	sv[ki gc[nk vi[dv yt[wh
歲寒然後知松柏之後凋也	sv[ux hj[gd rj[xd hz[pk vi[uk ss[ab bd[ab vi[dv hz[pk dn[dk ye[vu
雖令不從	sv[ki lk[rd bu[eu cs[rr
雖蠻貊之邦行矣	sv[ki mj[yi mo[pe vi[dv bh[fe xk[rh yi[su
雖賞之不竊	sv[ki uh[xk vi[dv bu[eu qp[xq
雖少	sv[ki uc[xp
遂事不諫	sv[bz ui[hk bu[eu jm[yh
雖疏食菜羹	sv[ki uu[pw ui[rl cd[ca gg[bb
雖違眾	sv[ki ww[wz vs[rr
雖狎	sv[ki xx[qo
雖小道	sv[ki xn[ub dc[bz
雖褻	sv[ki xp[wf
雖有粟	sv[ki yz[uo su[xm
雖有周親	sv[ki yz[uo vz[kt qb[la
雖欲從之	sv[ki yu[bd cs[rr vi[dv
雖欲勿用	sv[ki yu[bd wu[bp ys[ou
雖曰不要君	sv[ki yt[wh bu[eu yc[xn jy[xk
雖曰未學	sv[ki yt[wh ww[ha xt[xz
雖執鞭之士	sv[ki vi[fj bm[gr vi[dv ui[uh
綏之斯來	sv[sa vi[dv si[qj ld[hm
雖之夷狄	sv[ki vi[dv yi[hg di[qh
損矣	sy[fk yi[su
孫以出之	sy[zx yi[sr iu[ck vi[dv
損者三樂	sy[fk ve[to sj[hh le[px
損者三友	sy[fk ve[to sj[hh yz[uy
所惡也	so[pj ee[hx ye[vu
所損益	so[pj sy[fk yi[bm
所謂大臣者	so[pj ww[yt da[hr if[ku ve[to
所謂立之斯立	so[pj ww[yt li[lh vi[dv si[qj li[lh
所重	so[pj vs[ph
他人之賢者	ta[ry rf[pd vi[dv xm[ub ve[to
他日又獨立	ta[ry ri[wh yz[vd du[qi li[lh
泰伯	td[su bo[rb
泰伯第八	td[su bo[rb di[vg ba[pd
泰而不驕	td[su er[ek bu[eu jn[mp
泰也	td[su ye[vu
太宰問於子貢曰	td[dd zd[gl wf[mk yu[eu zi[lh gs[gb yt[wh
太宰知我乎	td[dd zd[gl vi[uk wo[pf hu[pb
唐棣之華	th[gx di[ax vi[dv hx[ru
堂堂乎張也	th[xt th[xt hu[pb vh[gi ye[vu
湯有天下	th[dv yz[uo tm[hd xx[hb
唐虞之際	th[gx yu[hk vi[dv ji[ee
滔滔者	tc[da tc[da ve[to
天何言哉	tm[hd he[rk yj[we zd[tk
天將以夫子為木鐸	tm[hd jl[dx yi[sr fu[er zi[lh ww[dl mu[ub do[jy
天祿永終	tm[hd lu[ux ys[dv vs[sw
天喪予	tm[hd sh[ty yu[sv
天生德於予	tm[hd ug[pf de[ru yu[eu yu[sv
天下	tm[hd xx[hb
天下歸仁焉	tm[hd xx[hb gv[ux rf[re yj[hh
天下皆是也	tm[hd xx[hb jp[bb ui[op ye[vu
天下無道	tm[hd xx[hb wu[ee dc[bz
天下有道	tm[hd xx[hb yz[uo dc[bz
天下有道則見	tm[hd xx[hb yz[uo dc[bz ze[bd jm[ke
天下之惡皆歸焉	tm[hd xx[hb vi[dv ee[hx jp[bb gv[ux yj[hh
天下之通喪也	tm[hd xx[hb vi[dv ts[sz sh[ty ye[vu
天下之無道也久矣	tm[hd xx[hb vi[dv wu[ee dc[bz ye[vu jq[xd yi[su
天厭之	tm[hd yj[iq vi[dv
天之將喪斯文也	tm[hd vi[dv jl[dx sh[ty si[qj wf[wi ye[vu
天之歷數在爾躬	tm[hd vi[dv li[il uu[mw zd[ut er[dx gs[ug
天之未喪斯文也	tm[hd vi[dv ww[ha sh[ty si[qj wf[wi ye[vu
天子穆穆	tm[hd zi[lh mu[hb mu[hb
聽其言也厲	tk[kj qi[cb yj[we ye[vu li[iw
聽思聰	tk[kj si[tx cs[eb
聽訟	tk[kj ss[yb
童子見	ts[lo zi[lh jm[ke
童子六七人	ts[lo zi[lh lq[wb qi[hv rf[pd
退而省其私	tv[gz er[ek ug[xm qi[cb si[hs
拖紳	to[fr uf[so
萬方有罪	wj[hv fh[dw yz[uo zv[sf
枉道而事人	wh[aw dc[bz er[ek ui[hk rf[pd
亡而為有	wh[wv er[ek ww[dl yz[uo
忘其身以及	wh[wx qi[cb uf[pu yi[sr ji[pv
王孫賈問曰	wh[su sy[zx jx[xb wf[mk yt[wh
王孫賈治軍旅	wh[su sy[zx jx[xb vi[ds jy[gi lv[fr
往也	wh[rd ye[vu
往者不可諫	wh[rd ve[to bu[eu ke[dk jm[yh
枉者直	wh[aw ve[to vi[uj
亡之	wh[wv vi[dv
罔之生也幸而免	wh[kb vi[dv ug[pf ye[vu xk[tb er[ek mm[dk
望之儼然	wh[ww vi[dv yj[rh rj[xd
危邦不入	ww[de bh[fe bu[eu ru[pd
未嘗飽也	ww[ha ih[xe bc[ub ye[vu
未嘗至於偃之室也	ww[ha ih[xe vi[ht yu[eu yj[rk vi[dv ui[gh ye[vu
為臣不易	ww[dl if[ku bu[eu yi[ob
未成一簣	ww[ha ig[wv yi[hh kv[vv
唯赤則非邦也與	ww[kv ii[ty ze[bd fw[su bh[fe ye[vu yu[hv
畏大人	ww[th da[hr rf[pd
危而不持	ww[de er[ek bu[eu ii[ft
威而不猛	ww[wh er[ek bu[eu mg[qz
衛公孫朝問於子貢曰	ww[eh gs[bs sy[zx ic[uo wf[mk yu[eu zi[lh gs[gb yt[wh
微管仲	ww[ru gr[vg vs[rv
為國以禮	ww[dl go[ww yi[sr li[uv
唯何甚	ww[kv he[rk uf[qv
未見蹈仁而死者也	ww[ha jm[ke dc[za rf[re er[ek si[hx ve[to ye[vu
未見其人也	ww[ha jm[ke qi[cb rf[pd ye[vu
未見其止也	ww[ha jm[ke qi[cb vi[uh ye[vu
未見顏色而言謂之瞽	ww[ha jm[ke yj[ly ud[db er[ek yj[we ww[yt vi[dv gu[um
唯謹爾	ww[kv jb[yn er[dx
未盡善也	ww[ha jb[ud uj[yk ye[vu
唯酒無量	ww[kv jq[dy wu[ee ll[oh
衛君待子而為政	ww[eh jy[xk dd[rt zi[lh er[ek ww[dl vg[hw
為君難	ww[dl jy[xk nj[yv
未可也	ww[ha ke[dk ye[vu
未可與	ww[ha ke[dk yu[hv
未可與立	ww[ha ke[dk yu[hv li[lh
未可與適道	ww[ha ke[dk yu[hv ui[qz dc[bz
為孔丘	ww[dl ks[zv qq[jh
謂孔子曰	ww[yt ks[zv zi[lh yt[wh
為禮不敬	ww[dl li[uv bu[eu jk[cw
為力不同科	ww[dl li[vp bu[eu ts[kh ke[hd
衛靈公第十五	ww[eh lk[xh gs[bs di[vg ui[hu wu[hu
衛靈公問陳於孔子	ww[eh lk[xh gs[bs wf[mk if[eq yu[eu ks[zv zi[lh
謂柳下惠少連	ww[yt lq[ap xx[hb hv[hx uc[xp lm[iz
謂門弟子曰	ww[yt mf[du di[bg zi[lh yt[wh
為命	ww[dl mk[rh
為難能也	ww[dl nj[yv ng[sb ye[vu
未能事人	ww[ha ng[sb ui[hk rf[pd
唯女子與小人為難養也	ww[kv nv[vp zi[lh yu[hv xn[ub rf[pd ww[dl nj[yv yh[yp ye[vu
唯其言而	ww[kv qi[cb yj[we er[ek
唯求則非邦也與	ww[kv qq[hu ze[bd fw[su bh[fe ye[vu yu[hv
未仁乎	ww[ha rf[re hu[pb
為人謀而不忠乎	ww[dl rf[pd mz[yg er[ek bu[eu vs[vx hu[pb
為仁由己	ww[dl rf[re yz[ou ji[kv
唯仁者能好人	ww[kv rf[re ve[to ng[sb hc[nz rf[pd
未入於室也	ww[ha ru[pd yu[eu ui[gh ye[vu
未若貧而樂	ww[ha ro[cu pb[fb er[ek le[px
未善也	ww[ha uj[yk ye[vu
唯上知與下愚不移	ww[kv uh[bh vi[uk yu[hv xx[hb yu[ox bu[eu yi[hx
微生畝謂孔子曰	ww[ru ug[pf mu[wt ww[yt ks[zv zi[lh yt[wh
畏聖人之言	ww[th ug[yt rf[pd vi[dv yj[we
畏天命	ww[th tm[hd mk[rh
唯天為大	ww[kv tm[hd ww[dl da[hr
為同姓	ww[dl ts[kh xk[np
巍巍乎	ww[uh ww[uh hu[pb
巍巍乎其有成功也	ww[uh ww[uh hu[pb qi[cb yz[uo ig[wv gs[gl ye[vu
未聞好學者也	ww[ha wf[me hc[nz xt[xz ve[to ye[vu
唯我與爾有是夫	ww[kv wo[pf yu[hv er[dx yz[uo ui[op fu[er
謂武	ww[yt wu[hv
未信	ww[ha xb[ry
危行言孫	ww[de xk[rh yj[we sy[zx
危言危行	ww[de yj[we ww[de xk[rh
唯堯則之	ww[kv yc[qh ze[bd vi[dv
謂也	ww[yt ye[vu
未也	ww[ha ye[vu
畏也已	ww[th ye[vu yi[kv
未有小人而仁者也	ww[ha yz[uo xn[ub rf[pd er[ek rf[re ve[to ye[vu
謂虞仲夷逸	ww[yt yu[hk vs[rv yi[hg yi[dz
為政第二	ww[dl vg[hw di[vg er[hh
為政以德	ww[dl vg[hw yi[sr de[ru
為之	ww[dl vi[dv
未之	ww[ha vi[dv
為之難	ww[dl vi[dv nj[yv
未知生	ww[ha vi[uk ug[pf
未之思也	ww[ha vi[dv si[tx ye[vu
謂之吳孟子	ww[yt vi[dv wu[kt mg[zm zi[lh
謂之有司	ww[yt vi[dv yz[uo si[vh
未之有也	ww[ha vi[dv yz[uo ye[vu
為仲由	ww[dl vs[rv yz[ou
未墜於地	ww[ha vv[et yu[eu di[ty
唯子出	ww[kv zi[lh iu[ck
微子第十八	ww[ru zi[lh di[vg ui[hu ba[pd
微子去之	ww[ru zi[lh qu[ts vi[dv
未足與議也	ww[ha zu[kv yu[hv yi[yd ye[vu
文不在茲乎	wf[wi bu[eu zd[ut zi[by hu[pb
溫故而知新	wf[do gu[gw er[ek vi[uk xb[lj
問管仲	wf[mk gr[vg vs[rv
聞樂不樂	wf[me le[px bu[eu le[px
聞禮	wf[me li[uv
問仁	wf[mk rf[re
問人於他邦	wf[mk rf[pd yu[eu ta[ry bh[fe
聞韶	wf[me uc[ld
文勝質則史	wf[wi ug[op vi[pu ze[bd ui[ki
聞詩	wf[me ui[yt
聞斯二者	wf[me si[qj er[hh ve[to
聞斯行之	wf[me si[qj xk[rh vi[dv
聞斯行諸	wf[me si[qj xk[rh vu[yt
文王既沒	wf[wi wh[su ji[gj mw[dj
文武之道	wf[wi wu[hv vi[dv dc[bz
文獻不足故也	wf[wi xm[uq bu[eu zu[kv gu[gw ye[vu
聞絃歌之聲	wf[me xm[gw ge[kd vi[dv ug[um
文行忠信	wf[wi xk[rh vs[vx xb[ry
聞義不能徙	wf[me yi[di bu[eu ng[sb xi[rv
問一得三	wf[mk yi[hh de[ro sj[hh
文猶質也	wf[wi yz[qy vi[pu ye[vu
問於桀溺	wf[mk yu[eu jp[xa ni[dg
問於孔子	wf[mk yu[eu ks[zv zi[lh
問於曾子	wf[mk yu[eu zg[bo zi[lh
問政	wf[mk vg[hw
問知	wf[mk vi[uk
文質彬彬	wf[wi vi[pu bb[aa bb[aa
文之以禮樂	wf[wi vi[dv yi[sr li[uv yt[px
問子西	wf[mk zi[lh xi[hk
我愛其禮	wo[pf ai[au qi[cb li[uv
我待賈者也	wo[pf dd[rt jx[xb ve[to ye[vu
我獨亡	wo[pf du[qi wh[wv
我對曰	wo[pf dv[yc yt[wh
我非生而知之者	wo[pf fw[su ug[pf er[ek vi[uk vi[dv ve[to
我叩其兩端而竭	wo[pf kz[ke qi[cb ll[hk dr[lu er[ek jp[lo
我未見好仁者	wo[pf ww[ha jm[ke hc[nz rf[re ve[to
我未見力不足者	wo[pf ww[ha jm[ke li[vp bu[eu zu[kv ve[to
我未之見也	wo[pf ww[ha vi[dv jm[ke ye[vu
我無能焉	wo[pf wu[ee ng[sb yj[hh
我無是也	wo[pf wu[ee ui[op ye[vu
我欲仁	wo[pf yu[bd rf[re
我則異於是	wo[pf ze[bd yi[kc yu[eu ui[op
我之不賢與	wo[pf vi[dv bu[eu xm[ub yu[hv
我之大賢與	wo[pf vi[dv da[hr xm[ub yu[hv
毋必	wu[vv bi[xp
吾必謂之學矣	wu[wk bi[xp ww[yt vi[dv xt[xz yi[su
吾不如老農	wu[wk bu[eu ru[nk lc[tb ns[gy
吾不如老圃	wu[wk bu[eu ru[nk lc[tb pu[wf
吾不試	wu[wk bu[eu ui[yq
吾不徒行以為之槨	wu[wk bu[eu tu[rz xk[rh yi[sr ww[dl vi[dv go[aw
吾不信也	wu[wk bu[eu xb[ry ye[vu
吾不欲觀之矣	wu[wk bu[eu yu[bd gr[yj vi[dv yi[su
吾不與祭	wu[wk bu[eu yu[hv ji[xe
吾不與也	wu[wk bu[eu yu[hv ye[vu
吾不知之矣	wu[wk bu[eu vi[uk vi[dv yi[su
吾嘗終日不食	wu[wk ih[xe vs[sw ri[wh bu[eu ui[rl
無臣而為有	wu[ee if[ku er[ek ww[dl yz[uo
吾從下	wu[wk cs[rr xx[hb
吾從眾	wu[wk cs[rr vs[rr
吾從周	wu[wk cs[rr vz[kt
吾黨	wu[wk dh[xk
吾黨有直躬者	wu[wk dh[xk yz[uo vi[uj gs[ug ve[to
無道	wu[ee dc[bz
吾道一以貫之	wu[wk dc[bz yi[hh yi[sr gr[mb vi[dv
吾得而食	wu[wk de[ro er[ek ui[rl
無得而逾焉	wu[ee de[ro er[ek yu[rz yj[hh
無惡也	wu[ee ee[hx ye[vu
吾二臣者皆不欲也	wu[wk er[hh if[ku ve[to jp[bb bu[eu yu[bd ye[vu
舞放鄭聲	wu[rx fh[fw vg[be ug[um
吾非斯人之徒與而誰與	wu[wk fw[su si[qj rf[pd vi[dv tu[rz yu[hv er[ek uv[yv yu[hv
無敢慢	wu[ee gj[vw mj[xo
勿攻人之惡	wu[bp gs[gw rf[pd vi[dv ee[hx
毋固	wu[vv gu[wg
五穀不分	wu[hu gu[bk bu[eu ff[bd
吾何以觀之哉	wu[wk he[rk yi[sr gr[yj vi[dv zd[tk
吾何執	wu[wk he[rk vi[fj
嗚呼	wu[kw hu[kp
吾見蹈而死者矣	wu[wk jm[ke dc[za er[ek si[hx ve[to yi[su
吾見其進也	wu[wk jm[ke qi[cb jb[ez ye[vu
吾見其居於位也	wu[wk jm[ke qi[cb ju[ug yu[eu ww[rl ye[vu
吾見其人矣	wu[wk jm[ke qi[cb rf[pd yi[su
無見小利	wu[ee jm[ke xn[ub li[hd
吾將仕矣	wu[wk jl[dx ui[ru yi[su
吾將問之	wu[wk jl[dx wf[mk vi[dv
惡居下流而訕	wu[hx ju[ug xx[hb lq[dw er[ek uj[yu
無倦	wu[ee jr[rb
無可無不可	wu[ee ke[dk wu[ee bu[eu ke[dk
吾恐季孫之憂	wu[wk ks[gx ji[hz sy[zx vi[dv yz[xy
吾老矣	wu[wk lc[tb yi[su
吾力	wu[wk li[vp
巫馬期以告	wu[gr ma[vv qi[qo yi[sr gc[nk
務民之義	wu[wl mb[kv vi[dv yi[di
吾末如之何也已矣	wu[wk mo[ha ru[nk vi[dv he[rk ye[vu yi[kv yi[su
無莫也	wu[ee mo[co ye[vu
無乃大簡乎	wu[ee nd[vp da[hr jm[vm hu[pb
無乃為佞乎	wu[ee nd[vp ww[dl nk[re hu[pb
吾能言之	wu[wk ng[sb yj[we vi[dv
無寧死於二三子之手乎	wu[ee nk[gd si[hx yu[eu er[hh sj[hh zi[lh vi[dv uz[su hu[pb
吾豈	wu[wk qi[uk
吾其被髮左衽矣	wu[wk qi[cb pi[yp fa[vy zo[ug rf[yq yi[su
吾其為東周乎	wu[wk qi[cb ww[dl ds[qx vz[kt hu[pb
勿欺也	wu[bp qi[qd ye[vu
吾其與聞之	wu[wk qi[cb yu[hv wf[me vi[dv
無求備於一人	wu[ee qq[hu bw[wt yu[eu yi[hh rf[pd
無求生以害仁	wu[ee qq[hu ug[pf yi[sr hd[gf rf[re
吾日三省吾身	wu[wk ri[wh sj[hh xk[xm wu[wk uf[pu
武入於漢	wu[hv ru[pd yu[eu hj[dy
吾少也賤	wu[wk uc[xp ye[vu jm[bj
侮聖人之言	wu[rr ug[yt rf[pd vi[dv yj[we
五十而知天命	wu[hu ui[hu er[ek vi[uk tm[hd mk[rh
五世希不失矣	wu[hu ui[nv xi[iu bu[eu ui[pe yi[su
無適也	wu[ee ui[qz ye[vu
五十以學易	wu[hu ui[hu yi[sr xt[xz yi[ob
吾十有五而志於學	wu[wk ui[hu yz[uo wu[hu er[ek vi[ux yu[eu xt[xz
勿施於人	wu[bp ui[fr yu[eu rf[pd
吾誰欺	wu[wk uv[yv qi[qd
無所不佩	wu[ee so[pj bu[eu pw[rj
無所禱也	wu[ee so[pj dc[uf ye[vu
無所苟而已	wu[ee so[pj gz[cb er[ek yi[kv
無所歸	wu[ee so[pj gv[ux
無所用心	wu[ee so[pj ys[ou xb[dv
武王曰	wu[hv wh[su yt[wh
無違	wu[ee ww[wz
吾未嘗不得見也	wu[wk ww[ha ih[xe bu[eu de[ro jm[ke ye[vu
吾未嘗無誨焉	wu[wk ww[ha ih[xe wu[ee hv[yr yj[hh
無為而治者	wu[ee ww[dl er[ek vi[ds ve[to
吾未見好德如好色者也	wu[wk ww[ha jm[ke hc[nz de[ru ru[nk hc[nz se[db ve[to ye[vu
無為小人儒	wu[ee ww[dl xn[ub rf[pd ru[ry
吾聞君子不黨	wu[wk wf[me jy[xk zi[lh bu[eu dh[xk
吾聞其語矣	wu[wk wf[me qi[cb yu[yw yi[su
吾聞之也	wu[wk wf[me vi[dv ye[vu
吾聞諸夫子	wu[wk wf[me vu[yt fu[er zi[lh
毋我	wu[vv wo[pf
吾無間然矣	wu[wk wu[ee jm[mo rj[xd yi[su
吾無行而不與二三子者	wu[wk wu[ee xk[rh er[ek bu[eu yu[hv er[hh sj[hh zi[lh ve[to
毋吾以也	wu[vv wu[wk yi[sr ye[vu
吾無隱乎爾	wu[wk wu[ee yb[ed hu[pb er[dx
無小大	wu[ee xn[ub da[hr
無益	wu[ee yi[bm
毋意	wu[vv yi[lx
無以立	wu[ee yi[sr li[lh
無以立也	wu[ee yi[sr li[lh ye[vu
吾以女為死矣	wu[wk yi[sr nv[vp ww[dl si[hx yi[su
無以尚之	wu[ee yi[sr uh[xk vi[dv
無以萬方	wu[ee yi[sr wj[hv fh[dw
無以為君子也	wu[ee yi[sr ww[dl jy[xk zi[lh ye[vu
無以為也	wu[ee yi[sr ww[dl ye[vu
吾亦為之	wu[wk yi[wy ww[dl vi[dv
無以言	wu[ee yi[sr yj[we
吾已矣夫	wu[wk yi[kv yi[su fu[er
無以知人也	wu[ee yi[sr vi[uk rf[pd ye[vu
吾以子為異之問	wu[wk yi[sr zi[lh ww[dl yi[kc vi[dv wf[mk
無勇也	wu[ee ys[sl ye[vu
無友不如己者	wu[ee yz[uy bu[eu ru[nk ji[kv ve[to
毋友不如己者	wu[vv yz[uy bu[eu ru[nk ji[kv ve[to
吾猶不足	wu[wk yz[qy bu[eu zu[kv
吾友嘗從事於斯矣	wu[wk yz[uy ih[xe cs[rr ui[hk yu[eu si[qj yi[su
吾猶及史之闕文也	wu[wk yz[qy ji[pv ui[ki vi[dv qt[mn wf[wi ye[vu
吾猶人也	wu[wk yz[qy rf[pd ye[vu
吾友張也	wu[wk yz[uy vh[gi ye[vu
吾有知乎哉	wu[wk yz[uo vi[uk hu[pb zd[tk
吾與點也	wu[wk yu[hv dm[bd ye[vu
吾與回言終日	wu[wk yu[hv hv[wk yj[we vs[sw ri[wh
無慾速	wu[ee yu[bd su[hz
吾知免夫小子	wu[wk vi[uk mm[dk fu[er xn[ub zi[lh
吾止也	wu[wk vi[uh ye[vu
無知也	wu[ee vi[uk ye[vu
吾之於人也	wu[wk vi[dv yu[eu rf[pd ye[vu
吾執御矣	wu[wk vi[fj yu[rw yi[su
毋自辱焉	wu[vv zi[pm ru[ic yj[hh
吾自衛反魯	wu[wk zi[pm ww[eh fj[py lu[yo
希不失矣	xi[iu bu[eu ui[pe yi[su
席不正	xi[gn bu[eu vg[hv
奚而不喪	xi[ay er[ek bu[eu sh[ty
惜乎	xi[xg hu[pb
奚其喪	xi[ay qi[cb sh[ty
奚其為為政	xi[ay qi[cb ww[dl ww[dl vg[hw
奚其正	xi[ay qi[cb vg[hv
奚取於三家之堂	xi[ay qu[ey yu[eu sj[hh jx[gu vi[dv th[xt
翕如也	xi[rx ru[nk ye[vu
夕死可矣	xi[xd si[hx ke[dk yi[su
奚為於丘之門	xi[ay ww[dl yu[eu qq[jh vi[dv mf[du
習相遠也	xi[vd xl[am yr[ez ye[vu
席也	xi[gn ye[vu
徙義	xi[rv yi[di
昔者	xi[go ve[to
昔者先王以為東蒙主	xi[go ve[to xm[ne wh[su yi[sr ww[dl ds[qx mg[ch vu[dw
昔者偃也聞諸夫子曰	xi[go ve[to yj[rk ye[vu wf[me vu[yt fu[er zi[lh yt[wh
昔者由也聞諸夫子曰	xi[go ve[to yz[ou ye[vu wf[me vu[yt fu[er zi[lh yt[wh
奚自	xi[ay zi[pm
狎大人	xx[qo da[hr rf[pd
下而飲	xx[hb er[ek yb[ud
夏后氏以松	xx[ew hz[pk ui[pq yi[sr ss[ab
夏禮	xx[ew li[uv
下如授	xx[hb ru[nk uz[fa
下學而上達	xx[hb xt[xz er[ek uh[bh da[dz
先飯	xm[ne fj[up
賢乎哉	xm[ub hu[pb zd[tk
先進第十一	xm[ne jb[ez di[vg ui[hu yi[hh
先進於禮樂	xm[ne jb[ez yu[eu li[uv yt[px
先生並行也	xm[ne ug[pf bk[bk xk[rh ye[vu
先生饌	xm[ne ug[pf vr[uk
先事後得	xm[ne ui[hk hz[pk de[ro
先王之道斯為美	xm[ne wh[su vi[dv dc[bz si[qj ww[dl mw[bw
憲問恥	xm[gn wf[mk ii[ev
憲問第十四	xm[gn wf[mk di[vg ui[hu si[we
賢賢易色	xm[ub xm[ub yi[ob se[db
先行其言	xm[ne xk[rh qi[cb yj[we
鮮矣	xm[yy yi[su
鮮矣仁	xm[yy yi[su rf[re
先有司	xm[ne yz[uo si[vh
賢哉回也	xm[ub zd[tk hv[wk ye[vu
賢者辟世	xm[ub ve[to pi[ul ui[nv
賢者識其大者	xm[ub ve[to ui[yk qi[cb da[hr ve[to
先之勞之	xm[ne vi[dv lc[cl vi[dv
鄉黨稱弟焉	xl[sp dh[xk ig[hd di[bg yj[hh
鄉黨第十	xl[sp dh[xk di[vg ui[hu
翔而後集	xl[yx er[ek hz[pk ji[va
相夫子	xl[am fu[er zi[lh
享禮	xl[wz li[uv
鄉人皆惡之	xl[sp rf[pd jp[bb ee[hx vi[dv
鄉人皆好之	xl[sp rf[pd jp[bb hc[nz vi[dv
鄉人儺	xl[sp rf[pd no[ry
鄉人飲酒	xl[sp rf[pd yb[ud jq[dy
相維闢公	xl[am ww[sv pi[ul gs[bs
鄉也吾見於夫子而問知	xl[sp ye[vu wu[wk jm[ke yu[eu fu[er zi[lh er[ek wf[mk vi[uk
鄉原	xl[sp yr[ib
小不忍則亂大謀	xn[ub bu[eu rf[dx ze[bd lr[qv da[hr mz[yg
小車無軏	xn[ub ie[qu wu[ee yt[[
孝慈	xn[tz ci[bx
小大由之	xn[ub da[hr yz[ou vi[dv
小德出入可也	xn[ub de[ru iu[ck ru[pd ke[dk ye[vu
孝弟也者	xn[tz di[bg ye[vu ve[to
孝乎	xn[tz hu[pb
孝乎惟孝	xn[tz hu[pb ww[xv xn[tz
小人比而不周	xn[ub rf[pd bi[bb er[ek bu[eu vz[kt
小人不可大受	xn[ub rf[pd bu[eu ke[dk da[hr uz[ay
小人不知天命而不畏也	xn[ub rf[pd bu[eu vi[uk tm[hd mk[rh er[ek bu[eu ww[th ye[vu
小人長慼慼	xn[ub rf[pd ih[ph qi[wu qi[wu
小人反是	xn[ub rf[pd fj[py ui[op
小人懷惠	xn[ub rf[pd hk[xb hv[hx
小人懷土	xn[ub rf[pd hk[xb tu[uh
小人驕而不泰	xn[ub rf[pd jn[mp er[ek bu[eu td[su
小人難事而易說也	xn[ub rf[pd nj[yv ui[hk er[ek yi[ob uo[yb ye[vu
小人窮斯濫矣	xn[ub rf[pd qs[xl si[qj lj[du yi[su
小人求諸人	xn[ub rf[pd qq[hu vu[yt rf[pd
小人同而不和	xn[ub rf[pd ts[kh er[ek bu[eu he[hk
小人下達	xn[ub rf[pd xx[hb da[dz
小人學道則易使	xn[ub rf[pd xt[xz dc[bz ze[bd yi[ob ui[rh
小人有勇而無義為盜	xn[ub rf[pd yz[uo ys[sl er[ek wu[ee yi[di ww[dl dc[dm
小人喻於利	xn[ub rf[pd yu[kr yu[eu li[hd
小人哉	xn[ub rf[pd zd[tk
小人之德草	xn[ub rf[pd vi[dv de[ru cc[co
小人之過也	xn[ub rf[pd vi[dv go[cz ye[vu
孝哉	xn[tz zd[tk
小子何莫學夫詩	xn[ub zi[lh he[rk mo[co xt[xz fu[er ui[yt
小子鳴鼓而	xn[ub zi[lh mk[kn gu[uu er[ek
褻裘長	xp[wf qq[hy ih[ph
信道不篤	xb[ry dc[bz bu[eu du[vm
信而好古	xb[ry er[ek hc[nz gu[uk
信而後諫	xb[ry er[ek hz[pk jm[yh
新谷既升	xb[lj gu[bk ji[gj ug[pc
信乎	xb[ry hu[pb
信近於義	xb[ry jb[jz yu[eu yi[di
信如君不君臣不臣父不父子不子	xb[ry ru[nk jy[xk bu[eu jy[xk if[ku bu[eu if[ku fu[bi bu[eu fu[bi zi[lh dy[eu zi[lh
信以成之	xb[ry yi[sr ig[wv vi[dv
信則民任焉	xb[ry ze[bd mb[kv rf[rq yj[hh
信則人任焉	xb[ry ze[bd rf[pd rf[rq yj[hh
行必果	xk[rh bi[xp go[oa
行不篤	xk[rh bu[eu du[vm
行不履閾	xk[rh bu[eu lv[ur yu[mg
行不由徑	xk[rh bu[eu yz[ou jk[rs
行篤敬	xk[rh du[vm jk[cw
刑罰不中	xk[kd fa[sy bu[eu vs[ku
行寡悔	xk[rh gx[gf hv[xr
行己有恥	xk[rh ji[kv yz[uo ii[ev
興滅國	xk[xb mp[hh go[ww
行其義也	xk[rh qi[cb yi[di ye[vu
行人子羽修飾之	xk[rh rf[pd zi[lh yu[xx xq[ru ui[ur vi[dv
行夏之時	xk[rh xx[ew vi[dv ui[oc
性相近也	xk[xp xl[am jb[jz ye[vu
行行如也	xk[rh xk[rh ru[nk ye[vu
行義以達其道	xk[rh yi[di yi[sr da[dz qi[cb dc[bz
行有餘力	xk[rh yz[uo yu[ur li[vp
興於詩	xk[xb yu[eu ui[yt
行之以忠	xk[rh vi[dv yi[sr vs[vx
行中慮	xk[rh vs[ku lv[hx
兄弟也	xs[ke di[bg ye[vu
兄弟怡怡	xs[ke di[bg yi[xs yi[xs
凶服者式之	xs[ik fu[oe ve[to ui[qg vi[dv
秀而不實者有矣夫	xq[hn er[ek bu[eu ui[gd ve[to yz[uo yi[su fu[er
修廢官	xq[ru fw[gv gr[gu
修己以安百姓	xq[ru ji[kv yi[sr an[gn bd[eo xk[np
修己以安人	xq[ru ji[kv yi[sr an[gn rf[pd
修己以敬	xq[ru ji[kv yi[sr jk[cw
修慝	xq[ru te[kx
虛而為盈	xu[hy er[ek ww[dl yk[nm
選於眾	xr[nz yu[eu vs[rr
學而不思	xt[xz er[ek bu[eu si[tx
學而不厭	xt[xz er[ek bu[eu yj[iq
學而第一	xt[xz er[ek di[vg yi[hh
學而時習之	xt[xz er[ek ui[oc xi[vd vi[dv
學而優則仕	xt[xz er[ek yz[ry ze[bd ui[ru
學而知之者次也	xt[xz er[ek vi[uk vi[dv ve[to ci[dd ye[vu
學禮乎	xt[xz li[uv hu[pb
血氣方剛	xt[pm qi[rh fh[dw gh[kd
血氣既衰	xt[pm qi[rh ji[gj uk[wk
血氣未定	xt[pm qi[rh ww[ha dk[gp
學如不及	xt[xz ru[nk bu[eu ji[pv
學詩乎	xt[xz ui[yt hu[pb
學也	xt[xz ye[vu
學則不固	xt[xz ze[bd bu[eu gu[wg
學之不講	xt[xz vi[dv bu[eu jl[ye
迅雷風烈必變	xy[vz lw[yt fg[ji lp[hd bi[xp bm[yy
恂恂如也	xy[xb xy[xb ru[nk ye[vu
巽與之言	xy[kg yu[hv vi[dv yj[we
亞飯幹適楚	ya[hy fj[up gj[hu ui[qz iu[ap
雅頌各得其所	ya[yv ss[by ge[wk de[ro qi[cb so[pj
言必信	yj[we bi[xp xb[ry
言必有中	yj[we bi[xp yz[uo vs[ku
言不及義	yj[we bu[eu ji[pv yi[di
言不可不慎也夫子之不可及	yj[we bu[eu ke[dk bu[eu uf[xu ye[vu fu[er zi[lh vi[dv bu[eu ke[dk ji[pv
言不可以若是其幾也	yj[we bu[eu ke[dk yi[sr ro[cu ui[op qi[cb ji[pv ye[vu
言不順	yj[we bu[eu uy[iy
言不忠信	yj[we bu[eu vs[vx xb[ry
焉得儉	yj[hh de[ro jm[rr
焉得知	yj[hh de[ro vi[uk
言而有信	yj[we er[ek yz[uo xb[ry
言寡尤	yj[we gx[gf yz[yd
言乎	yj[we hu[pb
言及之而不言謂之隱	yj[we ji[pv vi[dv er[ek bu[eu yj[we ww[yt vi[dv yb[ed
言可復也	yj[we ke[dk fu[ro ye[vu
焉可誣也	yj[hh ke[dk wu[yg ye[vu
顏路請子之車以為之槨	yj[ly lu[zw qk[yf zi[lh vi[dv ie[qu yi[sr ww[dl vi[dv go[aw
焉能事鬼	yj[hh ng[sb ui[hk gv[be
焉能為亡	yj[hh ng[sb ww[dl wh[wv
焉能為有	yj[hh ng[sb ww[dl yz[uo
焉能繫而不食	yj[hh ng[sb xi[py er[ek bu[eu ui[rl
厭其笑	yj[iq qi[cb xn[vp
儼然人望而畏之	yj[rh rj[xd rf[pd wh[ww er[ek ww[th vi[dv
言思忠	yj[we si[tx vs[vx
焉往	yj[hh wh[rd
言未及之而言謂之躁	yj[we ww[ha ji[pv vi[dv er[ek yj[we ww[yt vi[dv zc[zk
焉用稼	yj[hh ys[ou jx[hg
焉用殺	yj[hh ys[ou ua[ia
言遊過矣	yj[we yz[df go[cz yi[su
言語	yj[we yu[yw
顏淵第十二	yj[ly yr[dp di[vg ui[hu er[hh
顏淵後	yj[ly yr[dp hz[pk
顏淵喟然嘆曰	yj[ly yr[dp kv[kt rj[xd tj[ky yt[wh
顏淵閔子騫冉伯牛仲弓	yj[ly yr[dp mb[mw zi[lh qm[gm rj[kt bo[rb nq[pf vs[rv gs[kv
顏淵死	yj[ly yr[dp si[hx
顏淵問仁	yj[ly yr[dp wf[mk rf[re
顏淵問為邦	yj[ly yr[dp wf[mk ww[dl bh[fe
顏淵曰	yj[ly yr[dp yt[wh
言之必可行也	yj[we vi[dv bi[xp ke[dk xk[rh ye[vu
言之得無訒乎	yj[we vi[dv de[ro wu[ee rf[[ hu[pb
焉知來者之不如今也	yj[hh vi[uk ld[hm ve[to vi[dv bu[eu ru[nk jb[rd ye[vu
焉知死	yj[hh vi[uk si[hx
焉知賢才而舉之	yj[hh vi[uk xm[ub cd[hu er[ek ju[xf vi[dv
偃之言是也	yj[rk vi[dv yj[we ui[op ye[vu
言中倫	yj[we vs[ku ly[rr
言忠信	yj[we vs[vx xb[ry
陽貨第十七	yh[eo ho[rb di[vg ui[hu qi[hv
陽貨欲見孔子	yh[eo ho[rb yu[bd jm[ke ks[zv zi[lh
洋洋乎盈耳哉	yh[dy yh[dy hu[pb yk[nm er[hu zd[tk
仰之彌高	yh[rp vi[dv mi[gd gc[wk
堯舜其猶病	yc[qh uy[ax qi[cb yz[qy bk[bh
堯舜其猶病諸	yc[qh uy[ax qi[cb yz[qy bk[bh vu[yt
夭夭如也	yc[pd yc[pd ru[nk ye[vu
堯曰	yc[qh yt[wh
堯曰第二十	yc[qh yt[wh di[vg er[hh ui[hu
葉公問孔子於子路	ye[ku gs[bs wf[mk ks[zv zi[lh yu[eu zi[lh lu[zw
葉公問政	ye[ku gs[bs wf[mk vg[hw
葉公語孔子曰	ye[ku gs[bs yu[yw ks[zv zi[lh yt[wh
野人也	ye[oy rf[pd ye[vu
野哉	ye[oy zd[tk
異邦人稱之亦曰君夫人	yi[kc bh[fe rf[pd ig[hd vi[dv yi[wy yt[wh jy[xk fu[er rf[pd
衣敝縕袍	yi[wy bi[bw yy[so pc[yb
以別乎	yi[sr bp[kd hu[pb
亦不從也	yi[wy bu[eu cs[rr ye[vu
以不教民戰	yi[sr bu[eu jn[tw mb[kv vj[bg
亦不可行也	yi[wy bu[eu ke[dk xk[rh ye[vu
亦不入於室	yi[wy bu[eu ru[pd yu[eu ui[gh
弋不射宿	yi[qd bu[eu ue[uc su[gr
亦不失言	yi[wy bu[eu ui[pe yj[we
以成	yi[sr ig[wv
一簞食	yi[hh dj[vb ui[rl
以道事君	yi[sr dc[bz ui[hk jy[xk
以德報德	yi[sr de[ru bc[fe de[ru
以德報怨	yi[sr de[ru bc[fe yr[xx
夷狄之有君	yi[hg di[qh vi[dv yz[uo jy[xk
以多問於寡	yi[sr do[xx wf[mk yu[eu gx[gf
已而已而	yi[kv er[ek yi[kv er[ek
儀封人請見	yi[rd fg[tc rf[pd qk[yf jm[ke
衣夫錦	yi[wy fu[er jb[jb
以服事殷	yi[sr fu[oe ui[hk yb[pj
以告者過也	yi[sr gc[nk ve[to go[cz ye[vu
亦各言其志也	yi[wy ge[wk yj[we qi[cb vi[ux ye[vu
亦各言其志也已矣	yi[wy ge[wk yj[we qi[cb vi[ux ye[vu yi[kv yi[su
亦各言其子也	yi[wy ge[wk yj[we qi[cb zi[lh ye[vu
異乎三子者之撰	yi[kc hu[pb sj[hh zi[lh ve[to vi[dv vr[fk
異乎吾所聞	yi[kc hu[pb wu[wk so[pj wf[me
以季孟之間待之	yi[sr ji[hz mg[zm vi[dv jm[mo dd[rt vi[dv
以就有道	yi[sr jq[wy yz[uo dc[bz
亦可	yi[wy ke[dk
亦可以弗畔矣夫	yi[wy ke[dk yi[sr fu[gp pj[tb yi[su fu[er
亦可以即戎矣	yi[wy ke[dk yi[sr ji[ge rs[gu yi[su
亦可以勝殘去殺矣	yi[wy ke[dk yi[sr ug[op cj[hj qu[ts ua[ia yi[su
亦可以為成人矣	yi[wy ke[dk yi[sr ww[dl ig[wv rf[pd yi[su
一匡天下	yi[hh kl[kw tm[hd xx[hb
以蒞之	yi[sr li[cr vi[dv
以臨其民	yi[sr lb[uv qi[cb mb[kv
逸民	yi[dz mb[kv
抑末也	yi[fp mo[ha ye[vu
以能問於不能	yi[sr ng[sb wf[mk yu[eu bu[eu ng[sb
一瓢飲	yi[hh pn[xp yb[ud
衣前後	yi[wy qm[bo hz[pk
衣輕裘	yi[wy qk[is qq[hy
義然後取	yi[di rj[xd hz[pk qu[ey
揖讓而升	yi[fk rh[yu er[ek ug[pc
一日克己復禮	yi[hh ri[wh ke[ge ji[kv fu[ro li[uv
繹如也	yi[sy ru[nk ye[vu
翼如也	yi[xt ru[nk ye[vu
羿善射	yi[xc uj[yk ue[uc
以思	yi[sr si[tx
以俟君子	yi[sr si[rs jy[xk zi[lh
疑思問	yi[bs si[tx wf[mk
揖所與立	yi[fk so[pj yu[hv li[lh
以為謗己也	yi[sr ww[dl bh[yl ji[kv ye[vu
抑為之不厭	yi[fp ww[dl vi[dv bu[eu yj[iq
以吾從大夫之後	yi[sr wu[wk cs[rr da[hr fu[er vi[dv hz[pk
揖巫馬期而進之	yi[fk wu[gr ma[vv qi[qo er[ek jb[ez vi[dv
以吾一日長乎爾	yi[sr wu[wk yi[hh ri[wh ih[ph hu[pb er[dx
亦奚以為	yi[wy xi[ay yi[sr ww[dl
一言而可以興邦	yi[hh yj[we er[ek ke[dk yi[sr xk[xb bh[fe
一言而喪邦	yi[hh yj[we er[ek sh[ty bh[fe
一言以蔽之	yi[hh yj[we yi[sr bi[cb vi[dv
一言以為不知	yi[hh yj[we yi[sr ww[dl bu[eu vi[uk
益矣	yi[bm yi[su
已矣乎	yi[kv yi[su hu[pb
抑亦可以為	yi[fp yi[wy ke[dk yi[sr ww[dl
怡怡如也	yi[xs yi[xs ru[nk ye[vu
抑亦先覺者	yi[fp yi[wy xm[ne jt[xj ve[to
以雍徹	yi[sr ys[ws ie[rq
亦有惡乎	yi[wy yz[uo ee[hx hu[pb
以友輔仁	yi[sr yz[uy fu[if rf[re
以與爾鄰里鄉黨乎	yi[sr yu[hv er[dx lb[re li[ot xl[sp dh[xk hu[pb
依於仁	yi[ry yu[eu rf[re
抑與之與	yi[fp yu[hv vi[dv yu[hv
以約失之者鮮矣	yi[sr yt[sb ui[pe vi[dv ve[to xm[yy yi[su
億則屢中	yi[rv ze[bd lv[um vs[ku
一則以懼	yi[hh ze[bd yi[sr ju[xj
一則以喜	yi[hh ze[bd yi[sr xi[uk
以杖	yi[sr vh[ah
以杖荷	yi[sr vh[ah he[cr
一朝之忿	yi[hh vc[uo vi[dv ff[fx
益者三樂	yi[bm ve[to sj[hh le[px
益者三友	yi[bm ve[to sj[hh yz[uy
益者與	yi[bm ve[to yu[hv
以直報怨	yi[sr vi[uj bc[fe yr[xx
繹之為貴	yi[sy vi[dv ww[dl gv[vb
亦只以異	yi[wy vi[kb yi[sr yi[kc
義之與比	yi[di vi[dv yu[hv bi[bb
已知之矣	yi[kv vi[uk vi[dv yi[su
以忠	yi[sr vs[vx
亦足以發	yi[wy zu[kv yi[sr fa[vy
因不失其親	yb[wd bu[eu ui[pe qi[cb qb[la
隱居放言	yb[ed ju[ug fh[fw yj[we
隱居以	yb[ed ju[ug yi[sr
殷禮	yb[pj li[uv
因民之所利而利之	yb[wd mb[kv vi[dv so[pj li[hd er[ek li[hd vi[dv
殷人以柏	yb[pj rf[pd yi[sr bd[ab
飲水	yb[ud uv[uu
誾誾如也	yb[[ yb[[ ru[nk ye[vu
殷因於夏禮	yb[pj yb[wd yu[eu xx[ew li[uv
殷有三仁焉	yb[pj yz[uo sj[hh rf[re yj[hh
隱者也	yb[ed ve[to ye[vu
因之以饑饉	yb[wd vi[dv yi[sr ji[uj jb[un
用不臧	ys[ou bu[eu zh[wk
用不足	ys[ou bu[eu zu[kv
詠而歸	ys[kd er[ek gv[ux
勇而無禮則亂	ys[sl er[ek wu[ee li[uv ze[bd lr[qv
雍雖不敏	ys[ws sv[ki bu[eu mb[rw
雍也	ys[ws ye[vu
雍也第六	ys[ws ye[vu di[vg lq[wb
勇者不必有仁	ys[sl ve[to bu[eu bi[xp yz[uo rf[re
勇者不懼	ys[sl ve[to bu[eu ju[xj
雍之言然	ys[ws vi[dv yj[we rj[xd
用之則行	ys[ou vi[dv ze[bd xk[rh
有鄙夫問於我	yz[uo bi[ke fu[er wf[mk yu[eu wo[pf
遊必有方	yz[df bi[xp yz[uo fh[dw
友便辟	yz[uy bm[rh pi[ul
有恥且格	yz[uo ii[ev qp[ke ge[aw
有德者必有言	yz[uo de[ru ve[to bi[xp yz[uo yj[we
又多能也	yz[vd do[xx ng[sb ye[vu
友多聞	yz[uy do[xx wf[me
有惡	yz[uo ee[hx
耰而不輟	yz[[ er[ek bu[eu io[iy
幼而不孫弟	yz[yl er[ek bu[eu sy[zx di[bg
有反坫	yz[uo fj[py dm[tb
有婦人焉	yz[uo fu[nx rf[pd yj[hh
有父兄在	yz[uo fu[bi xs[ke zd[ut
有棺而無槨	yz[uo gr[ag er[ek wu[ee go[aw
又何加焉	yz[vd he[rk jx[lk yj[hh
有荷蕢而過孔氏之門者	yz[uo he[cr kk[cv er[ek go[cz ks[zv ui[pq vi[dv mf[du ve[to
又何怨	yz[vd he[rk yr[xx
有教無類	yz[uo jn[tw wu[ee lw[md
又盡善也	yz[vd jb[ud uj[yk ye[vu
又敬不違	yz[vd jk[cw bu[eu ww[wz
有酒食	yz[uo jq[dy ui[rl
猶可逾也	yz[qy ke[dk yu[rz ye[vu
猶恐失之	yz[qy ks[gx ui[pe vi[dv
友諒	yz[uy ll[yw
有馬者	yz[uo ma[vv ve[to
有美玉於斯	yz[uo mw[bw yu[wd yu[eu si[qj
有民人焉	yz[uo mb[kv rf[pd yj[hh
猶能肆諸市朝	yz[qy ng[sb si[iy vu[yt ui[wj ic[uo
有能一日用其力於仁矣乎	yz[uo ng[sb yi[hh ri[wh ys[ou qi[cb li[vp yu[eu rf[re yi[su hu[pb
有朋自遠方來	yz[uo pg[oo zi[pm yr[ez fh[dw ld[hm
有便佞	yz[uo pm[rh nk[re
又其次也	yz[vd qi[cb ci[dd ye[vu
友其士之仁者	yz[uy qi[cb ui[uh vi[dv rf[re ve[to
有容色	yz[uo rs[xr se[db
有若對曰	yz[uo ro[cu dv[yc yt[wh
有若無	yz[uo ro[cu wu[ee
有殺身以成仁	yz[uo ua[ia uf[pu yi[sr ig[wv rf[re
友善柔	yz[uy uj[yk rz[ya
有社稷	yz[uo ue[ut ji[ht
有盛饌	yz[uo ug[wm vr[uk
有事	yz[uo ui[hk
有是言也	yz[uo ui[op yj[we ye[vu
有始有卒者	yz[uo ui[ns yz[uo zu[wr ve[to
有是哉	yz[uo ui[op zd[tk
又誰怨	yz[vd uv[yv yr[xx
有所不行	yz[uo so[pj bu[eu xk[rh
有澹臺滅明者	yz[uo tj[dd td[sk mp[hh mk[oo ve[to
猶天之不可階而升也	yz[qy tm[hd vi[dv bu[eu ke[dk jp[er er[ek ug[pc ye[vu
有慟乎	yz[uo ts[xe hu[pb
又聞君子之遠其子也	yz[vd wf[me jy[xk zi[lh vi[dv yr[ez qi[cb zi[lh ye[vu
猶賢乎已	yz[qy xm[ub hu[pb yi[kv
又相之	yz[vd xl[am vi[dv
有心哉	yz[uo xb[dv zd[tk
有顏回者好學	yz[uo yj[ly hv[wk ve[to hc[nz xt[xz
又焉貪	yz[vd yj[hh tj[rb
有言者不必有德	yz[uo yj[we ve[to bu[eu bi[xp yz[uo de[ru
由也	yz[ou ye[vu
由也果	yz[ou ye[vu go[oa
由也兼人	yz[ou ye[vu jm[bh rf[pd
由也升堂矣	yz[ou ye[vu ug[pc th[xt yi[su
由也為之	yz[ou ye[vu ww[dl vi[dv
由也問聞斯行諸	yz[ou ye[vu wf[mk wf[me si[qj xk[rh vu[yt
由也喭	yz[ou ye[vu yj[[
有一言而可以終身行之者乎	yz[uo yi[hh yj[we er[ek ke[dk yi[sr vs[sw uf[pu xk[rh vi[dv ve[to hu[pb
又欲其死	yz[vd yu[bd qi[cb si[hx
友于兄弟	yz[uy yu[eu xs[ke di[bg
遊於藝	yz[df yu[eu yi[cv
有政	yz[uo vg[hw
友直	yz[uy vi[uj
有之	yz[uo vi[dv
由之瑟	yz[ou vi[dv se[wx
由之行詐也	yz[ou vi[dv xk[rh va[yv ye[vu
猶之與人也	yz[qy vi[dv yu[hv rf[pd ye[vu
有諸	yz[uo vu[yt
有子曰	yz[uo zi[lh yt[wh
有罪不敢赦	yz[uo zv[sf bu[eu gj[vw ue[tw
欲罷不能	yu[bd ba[st bu[eu ng[sb
玉帛云乎哉	yu[wd bo[bj yy[es hu[pb zd[tk
予不得視猶子也	yu[sv bu[eu de[ro ui[uj yz[qy zi[lh ye[vu
於從政乎何有	yu[eu cs[rr vg[hw hu[pb he[rk yz[uo
欲而不貪	yu[bd er[ek bu[eu tj[rb
與父	yu[hv fu[bi
欲寡其過而未能也	yu[bd gx[gf qi[cb go[cz er[ek ww[ha ng[sb ye[vu
浴乎沂	yu[db hu[pb yi[dj
禹稷躬稼而有天	yu[pk ji[ht gs[ug jx[hg er[ek yz[uo tm[hd
欲潔其身	yu[bd jp[du qi[cb uf[pu
於今稱之	yu[eu jb[rd ig[hd vi[dv
與君子人也	yu[hv jy[xk zi[lh rf[pd ye[vu
魚餒而肉敗	yu[dt nw[ua er[ek rz[kr bd[bw
於女安乎	yu[eu nv[vp an[gn hu[pb
與朋友交	yu[hv pg[oo yz[uy jn[li
與朋友交而不信乎	yu[hv pg[oo yz[uy jn[li er[ek bu[eu xb[ry hu[pb
與其不孫也	yu[hv qi[cb bu[eu sy[zx ye[vu
與其潔也	yu[hv qi[cb jp[du ye[vu
與其進也	yu[hv qi[cb jb[ez ye[vu
與其媚於奧	yu[hv qi[cb mw[nm yu[eu ao[pd
與求之問	yu[hv qq[hu vi[dv wf[mk
欲仁而得仁	yu[bd rf[re er[ek de[ro rf[re
與人恭而有禮	yu[hv rf[pd gs[gx er[ek yz[uo li[uv
於人何所不容	yu[eu rf[pd he[rk so[pj bu[eu rs[xr
與人忠	yu[hv rf[pd vs[vx
與如也	yu[hv ru[nk ye[vu
與上大夫言	yu[hv uh[bh da[hr fu[er yj[we
與師言之道與	yu[hv ui[uh yj[we vi[dv dc[bz yu[hv
於斯二者何先	yu[eu si[qj er[hh ve[to he[rk xm[ne
於斯三者何先	yu[eu si[qj sj[hh ve[to he[rk xm[ne
於斯為盛	yu[eu si[qj ww[dl ug[wm
於斯文也	yu[eu si[qj wf[wi ye[vu
予死於道路乎	yu[sv si[hx yu[eu dc[bz lu[zw hu[pb
欲速成者也	yu[bd su[hz ig[wv ve[to ye[vu
欲速則不達	yu[bd su[hz ze[bd bu[eu da[dz
予所否者	yu[sv so[pj fz[bk ve[to
與文子同升諸公	yu[hv wf[wi zi[lh ts[kh ug[pc vu[yt gs[bs
於我	yu[eu wo[pf
於我殯	yu[eu wo[pf bb[hg
予無樂乎為君	yu[sv wu[ee le[px hu[pb ww[dl jy[xk
於吾言無所不說	yu[eu wu[wk yj[we wu[ee so[pj bu[eu uo[yb
與下大夫言	yu[hv xx[hb dd[hr fu[er yj[we
予小子履	yu[sv xn[ub zi[lh lv[ur
予也有三年之愛於其父母乎	yu[sv ye[vu yz[uo sj[hh nm[rn vi[dv ai[au yu[eu qi[cb fu[bi mu[vv hu[pb
與衣狐貉者立	yu[hv yi[wy hu[qp he[pw ve[to li[lh
與易也	yu[hv yi[ob ye[vu
予一以貫之	yu[sv yi[hh yi[sr gr[mb vi[dv
予有亂臣十人	yu[sv yz[uo lr[qv if[ku ui[hu rf[pd
鬱郁乎文哉	yu[ue yu[ue hu[pb wf[wi zd[tk
愉愉如也	yu[xr yu[xr ru[nk ye[vu
予欲無言	yu[sv yu[bd wu[ee yj[we
欲與之言	yu[bd yu[hv vi[dv yj[we
遇丈人	yu[oz vh[hi rf[pd
予之不仁也	yu[sv vi[dv bu[eu rf[re ye[vu
語之而不惰者	yu[yw vi[dv er[ek bu[eu do[xu ve[to
與之釜	yu[hv vi[dv fu[bw
與之粟九百	yu[hv vi[dv su[xm jq[pv bd[eo
與之庾	yu[hv vi[dv yu[gj
遇諸途	yu[oz vu[yt tu[rz
遠恥辱也	yr[ez ii[ev ru[ic ye[vu
怨乎	yr[xx hu[pb
遠佞人	yr[ez nk[re rf[pd
原壤夷俟	yr[ib rh[tw yi[hg si[rs
遠人不服	yr[ez rf[pd bu[eu fu[oe
原思為之宰	yr[ib si[tx ww[dl vi[dv zd[gl
願為小相焉	yr[ix ww[dl xn[ub xl[am yj[hh
願學焉	yr[ix xt[xz yj[hh
遠者來	yr[ez ve[to ld[hm
遠之事君	yr[ez vi[dv ui[hk jy[xk
遠之有	yr[ez vi[dv yz[uo
遠之則怨	yr[ez vi[dv ze[bd yr[xx
約而為泰	yt[sb er[ek ww[dl td[su
樂節禮樂	yt[px jp[ce li[uv yt[px
約我以禮	yt[sb wo[pf yi[sr li[uv
月無忘其所能	yt[ke wu[ee wh[wx qi[cb so[pj ng[sb
約之以禮	yt[sb vi[dv yi[sr li[uv
韞櫝而藏諸	yy[wo du[au er[ek ch[cw vu[yt
允執其中	yy[se vi[fj qi[cb vs[ku
再拜而送之	zd[hk bd[fh er[ek ss[bz vi[dv
在邦必達	zd[ut bh[fe bi[xp da[dz
在邦必聞	zd[ut bh[fe bi[xp wf[me
在邦無怨	zd[ut bh[fe wu[ee yr[xx
在陳絕糧	zd[ut if[eq jt[sd ll[ml
在家必達	zd[ut jx[gu bi[xp da[dz
在家必聞	zd[ut jx[gu bi[xp wf[me
在家無怨	zd[ut jx[gu wu[ee yr[xx
在陋巷	zd[ut lz[eh xl[gk
在人	zd[ut rf[pd
宰我出	zd[gl wo[pf iu[ck
宰我對曰	zd[gl wo[pf dv[yc yt[wh
宰我問	zd[gl wo[pf wf[mk
宰我問曰	zd[gl wo[pf wf[mk yt[wh
宰我子貢	zd[gl wo[pf zi[lh gs[gb
在輿	zd[ut yu[pb
在予一人	zd[ut yu[sv yi[hh rf[pd
臧文仲其竊位者與	zh[wk wf[wi vs[rv qi[cb qp[xq ww[rl ve[to yu[hv
臧武仲以防求為後於魯	zh[wk wu[hv vs[rv yi[sr fh[ef qq[hu ww[dl hz[pk yu[eu lu[yo
葬之以禮	zh[ch vi[dv yi[sr li[uv
造次必於是	zc[nz ci[dd bi[xp yu[eu ui[op
則哀矜而勿喜	ze[bd ai[wk jb[yr er[ek wu[bp xi[uk
則安之	ze[bd an[gn vi[dv
擇不處仁	ze[fy bu[eu iu[wb rf[re
則不復也	ze[bd bu[eu fu[ro ye[vu
則不歌	ze[bd bu[eu ge[kd
則不棄	ze[bd bu[eu qi[wc
則不威	ze[bd bu[eu ww[wh
則嘗聞之矣	ze[bd ih[xe wf[me vi[dv yi[su
則殆	ze[bd dd[hs
則寡悔	ze[bd gx[gf hv[xr
則寡尤	ze[bd gx[gf yz[yd
則何以哉	ze[bd he[rk yi[sr zd[tk
則見其倚于衡也	ze[bd jm[ke qi[cb yi[rd yu[eu hg[rd ye[vu
則將焉用彼相矣	ze[bd jl[dx yj[hh ys[ou bi[rp xl[am yi[su
則敬	ze[bd jk[cw
擇可勞而勞之	ze[fy ke[dk lc[cl er[ek lc[cl vi[dv
則可謂云爾已矣	ze[bd ke[dk ww[yt yy[es er[dx yi[kv yi[su
則可矣	ze[bd ke[dk yi[su
則禮樂不興	ze[bd li[uv yt[px bu[eu xk[xb
則禮樂征伐自天子出	ze[bd li[uv yt[px vg[rh fa[rg zi[pm tm[hd zi[lh iu[ck
則禮樂征伐自諸侯	ze[bd li[uv yt[px vg[rh fa[rg zi[pm vu[yt hz[rv
則民	ze[bd mb[kv
則民不敬	ze[bd mb[kv bu[eu jk[cw
則民不偷	ze[bd mb[kv bu[eu tz[rr
則民服	ze[bd mb[kv fu[oe
則民莫敢不敬	ze[bd mb[kv mo[co gj[vw bu[eu jk[cw
則民莫敢不用情	ze[bd mb[kv mo[co gj[vw bu[eu ys[ou qk[xf
則民無所錯手足	ze[bd mb[kv wu[ee so[pj co[jg uz[su zu[kv
則民興於仁	ze[bd mb[kv xk[xb yu[eu rf[re
則民易使也	ze[bd mb[kv yi[ob ui[rh ye[vu
擇其善者而從之	ze[fy qi[cb uj[yk ve[to er[ek cs[rr vi[dv
則勸	ze[bd qr[yl
則誰與	ze[bd uw[yv yu[hv
則事不成	ze[bd ui[hk bu[eu ig[wv
則庶人不議	ze[bd uu[gn rf[pd bu[eu yi[yd
則四方之民襁負其子而至矣	ze[bd si[we fh[dw vi[dv mb[kv ql[yg fu[db qi[cb zi[lh er[ek vi[ht yi[su
則罔	ze[bd wh[kb
則為之	ze[bd ww[dl vi[dv
則為之也難	ze[bd ww[dl vi[dv ye[vu nj[yv
則吾必在汶	ze[bd wu[wk bi[xp zd[ut wf[dw
則吾從先進	ze[bd wu[wk cs[rr xm[ne jb[ez
則吾豈敢	ze[bd wu[wk qi[uk gj[vw
則吾未之有得	ze[bd wu[wk ww[ha vi[dv yz[uo de[ro
則小子何述焉	ze[bd xn[ub zi[lh he[rk uu[az yj[hh
則刑罰不中	ze[bd xk[kd fa[sy bu[eu vs[ku
則修文德以來之	ze[bd xq[ru wf[wi de[ru yi[sr ld[hm vi[dv
則言不順	ze[bd yj[we bu[eu uy[iy
則以為厲己也	ze[bd yi[sr ww[dl li[iw ji[kv ye[vu
則以學文	ze[bd yi[sr xt[xz wf[wi
則隱	ze[bd yb[ed
則有司存	ze[bd yz[uo si[vh cy[uz
則遠怨矣	ze[bd yr[ez yr[xx yi[su
則政不在大夫	ze[bd vg[hw bu[eu zd[ut dd[hr fu[er
則忠	ze[bd vs[vx
賊夫人之子	zw[bg fu[er rf[pd vi[dv zi[lh
曾子言曰	zg[bo zi[lh yj[we yt[wh
曾子有疾	zg[bo zi[lh yz[uo ji[bu
曾子曰	zg[bo zi[lh yt[wh
齋戰疾	vd[we vj[bg ji[bu
戰戰兢兢	vj[bg vj[bg jk[gg jk[gg
瞻之在前	vj[md vi[dv zd[ut qm[bo
丈人曰	vh[hi rf[pd yt[wh
長幼之節	vh[ph yz[yl vi[dv jp[ce
杖者出	vh[ah ve[to iu[ck
昭公知禮乎	vc[od gs[bs vi[uk li[uv hu[pb
召忽死之	vc[dk hu[bx si[hx vi[dv
召門弟子曰	vc[dk mf[du di[bg zi[lh yt[wh
朝聞道	vc[uo wf[me dc[bz
袗絺綌	vf[[ ii[[ xi[[
朕躬有罪	vf[ob gs[ug yz[uo zv[sf
政逮於大夫四世矣	vg[hw dd[xz yu[eu dd[hr fu[er si[we ui[nv yi[su
正其衣冠	vg[hv qi[cb yi[wy gr[ge
鄭聲淫	vg[be ug[um yb[da
政事	vg[hw ui[hk
正唯弟子不能學也	vg[hv ww[kv di[bg zi[lh bu[eu ng[sb xt[xz ye[vu
正顏色	vg[hv yj[ly ud[db
正也	vg[hv ye[vu
政者	vg[hw ve[to
治賓客	vi[ds bb[gq ke[gw
直道而事人	vi[uj dc[bz er[ek ui[hk rf[pd
執德不弘	vi[fj de[ru bu[eu hs[gs
知德者鮮矣	vi[uk de[ru ve[to xm[yy yi[su
直而無禮則絞	vi[uj er[ek wu[ee li[uv ze[bd jn[sl
執圭	vi[fj gv[tt
知和	vi[uk he[hk
知及之	vi[uk ji[pv vi[dv
知禮	vi[uk li[uv
知柳下惠之賢	vi[uk lq[ap xx[hb hv[hx vi[dv xm[ub
之民歸心焉	vi[dv mb[kv gv[ux xb[dv yj[hh
知其說者之於天下也	vi[uk qi[cb uo[yb ve[to vi[dv yu[eu tm[hd xx[hb ye[vu
指其掌	vi[fb qi[cb vh[xf
植其杖而芸	vi[au qi[cb vh[ah er[ek yy[ce
知人	vi[uk rf[pd
之三子告	vi[dv sj[hh zi[lh gc[nk
執射乎	vi[fj ue[uc hu[pb
質勝文則野	vi[pu ug[op wf[wi ze[bd ye[oy
執事敬	vi[fj ui[hk jk[cw
志士仁人	vi[ux ui[uh rf[re rf[pd
之所以直道而行也	vi[dv so[pj yi[sr vi[uj dc[bz er[ek xk[rh ye[vu
知我者其天乎	vi[uk wo[pf ve[to qi[cb tm[hd hu[pb
知也	vi[uk ye[vu
質猶文也	vi[pu yz[qy wf[wi ye[vu
至於道	vi[ht yu[eu dc[bz
志於道	vi[ux yu[eu dc[bz
執御乎	vi[fj yu[rw hu[pb
至於魯	vi[ht yu[eu lu[yo
至於犬馬	vi[ht yu[eu qr[dd ma[vv
致遠恐泥	vi[hw yr[ez ks[gx ni[du
直在其中矣	vi[uj zd[ut qi[cb vs[ku yi[su
直哉史魚	vi[uj zd[tk ui[ki yu[dt
直則民不服	vi[uj ze[bd mb[kv bu[eu fu[oe
至則行矣	vi[ht ze[bd xk[rh yi[su
知者不惑	vi[uk ve[to bu[eu ho[gx
知者不失人	vi[uk ve[to bu[eu ui[pe rf[pd
知者動	vi[uk ve[to ds[el
知者樂	vi[uk ve[to le[px
知者樂水	vi[uk ve[to le[px uv[uu
知者利仁	vi[uk ve[to li[hd rf[re
之政	vi[dv vg[hw
知之次也	vi[uk vi[dv ci[dd ye[vu
質直而好義	vi[pu vi[uj er[ek hc[nz yi[di
知之為知之	vi[uk vi[dv ww[dl vi[uk vi[dv
知之者	vi[uk vi[dv ve[to
之直者異於是	vi[dv vi[uj ve[to yi[kc yu[eu ui[op
止子路宿	vi[uh zi[lh lu[zw su[gr
中道而廢	vs[ku dc[bz er[ek fw[gv
眾惡之	vs[rr ee[hx vi[dv
忠告而善道之	vs[vx gc[nk er[ek uj[yk dc[bz vi[dv
仲弓為季氏宰	vs[rv gs[kv ww[dl ji[hz ui[pq zd[gl
仲弓問仁	vs[rv gs[kv wf[mk rf[re
仲弓問子桑伯子	vs[rv gs[kv wf[mk zi[lh sh[ya bo[rb zi[lh
仲弓曰	vs[rv gs[kv yt[wh
鐘鼓云乎哉	vs[jv gu[uu yy[es hu[pb zd[tk
眾好之	vs[rr hc[nz vi[dv
仲尼	vs[rv ni[ub
仲尼不可毀也	vs[rv ni[ub bu[eu ke[dk hv[jj ye[vu
仲尼豈賢於子乎	vs[rv ni[ub qi[uk xm[ub yu[eu zi[lh hu[pb
仲尼焉學	vs[rv ni[ub yj[hh xt[xz
中人以上	vs[ku rf[pd yi[sr uh[bh
中人以下	vs[ku rf[pd yi[sr xx[hb
忠恕而已矣	vs[vx uu[nx er[ek yi[kv yi[su
仲叔圉	vs[rv uu[uy yu[wt
仲相桓公	vs[rv xl[am hr[ah gs[bs
忠焉	vs[vx yj[hh
終夜不寢	vs[sw ye[wr bu[eu qb[gd
中矣	vs[ku yi[su
中庸之為德也	vs[ku ys[gx vi[dv ww[dl de[ru ye[vu
仲由可使從政也與	vs[rv yz[ou ke[dk ui[rh cs[rr vg[hw ye[vu yu[hv
仲由冉求	vs[rv yz[ou rj[kt qq[hu
仲知禮乎	vs[rv vi[uk li[uv hu[pb
周公謂魯公曰	vz[kt gs[bs ww[yt lu[yo gs[bs yt[wh
周監於二代	vz[kt jm[um yu[eu er[hh dd[rq
周人以慄	vz[kt rf[pd yi[sr li[xa
周任有言曰	vz[kt rf[rq yz[uo yj[we yt[wh
周因於	vz[kt yb[wd yu[eu
周有八士	vz[kt yz[uo ba[pd ui[uh
周有大賚	vz[kt yz[uo da[hr ld[lb
紂之不善	vz[sc vi[dv bu[eu uj[yk
周之德	vz[kt vi[dv de[ru
諸片言可以折獄者	vu[yt pm[pu yj[we ke[dk yi[sr ve[fj yu[qy ve[to
祝鮀治宗廟	vu[uk to[[ vi[ds zs[ge mn[gy
主忠信	vu[dw vs[vx xb[ry
莊以蒞之	vl[gt yi[sr li[cr vi[dv
子不語怪力亂神	zi[lh bu[eu yu[yw gk[xy li[vp lr[qv uf[uo
自大夫出	zi[pm da[hr fu[er iu[ck
子釣而不綱	zi[lh dn[jb er[ek bu[eu gh[sk
子篤於親	zi[lh du[vm yu[eu qb[la
諮爾舜	zi[dk er[dx uy[ax
子服景伯以告	zi[lh fu[oe jk[ow bo[rb yi[sr gc[nk
子服景伯以告子貢	zi[lh fu[oe jk[ow bo[rb yi[sr gc[nk zi[lh gs[gb
子告之曰	zi[lh gc[nk vi[dv yt[wh
子貢	zi[lh gs[gb
子貢方人	zi[lh gs[gb fh[dw rf[pd
子貢問	zi[lh gs[gb wf[mk
子貢問君子	zi[lh gs[gb wf[mk jy[xk zi[lh
子貢問為仁	zi[lh gs[gb wf[mk ww[dl rf[re
子貢問友	zi[lh gs[gb wf[mk yz[uy
子貢問曰	zi[lh gs[gb wf[mk yt[wh
子貢問政	zi[lh gs[gb wf[mk vg[hw
子貢賢於仲尼	zi[lh gs[gb xm[ub yu[eu vs[rv ni[ub
子貢欲去告朔之餼羊	zi[lh gs[gb yu[bd qu[ts gc[nk uo[no vi[dv xi[uq yh[bs
子貢曰	zi[lh gs[gb yt[wh
自古皆有死	zi[pm gu[uk jp[bb yz[uo si[hx
子固窮	zi[lh gu[wg qs[xl
子罕第九	zi[lh hj[gg di[vg jq[pv
子罕言利與命與仁	zi[lh hj[gg yj[we li[hd yu[hv mk[rh yu[hv rf[re
子華使於齊	zi[lh hx[ru ui[rh yu[eu qi[wp
子疾病	zi[lh ji[bu bk[bh
子擊磬於衛	zi[lh ji[fk qk[ue yu[eu ww[eh
子見夫子乎	zi[lh jm[ke fu[er zi[lh hu[pb
子見南子	zi[lh jm[ke nj[uk zi[lh
子見齊衰者冕衣裳者與瞽者	zi[lh jm[ke qi[wp uk[wk ve[to mm[od yi[wy uh[xy ve[to yu[hv gu[um ve[to
子將奚先	zi[lh jl[dx xi[ay xm[ne
自經於溝瀆而莫之知也	zi[pm jk[ss yu[eu gz[db du[du er[ek mo[co vi[dv vi[uk ye[vu
子絕四	zi[lh jt[sd si[we
自孔氏	zi[pm ks[zv ui[pq
子哭之慟	zi[lh ku[kq vi[dv ts[xe
子樂	zi[lh le[px
子路	zi[lh lu[zw
子路不對	zi[lh lu[zw bu[eu dv[yc
子路不說	zi[lh lu[zw bu[eu uo[yb
子路曾皙冉有公西華侍坐	zi[lh lu[zw cg[bo xi[ab rj[kt yz[uo gs[bs xi[hk hx[ru ui[rt zo[rr
子路從而後	zi[lh lu[zw cs[rr er[ek hz[pk
子路第十三	zi[lh lu[zw di[vg ui[hu sj[hh
子路對曰	zi[lh lu[zw dv[yc yt[wh
子路拱而立	zi[lh lu[zw gs[fg er[ek li[lh
子路共之	zi[lh lu[zw gs[gb vi[dv
子路請禱	zi[lh lu[zw qk[yf dc[uf
子路使門人為臣	zi[lh lu[zw ui[rh mf[du rf[pd ww[dl if[ku
子路使子羔為費宰	zi[lh lu[zw ui[rh zi[lh gc[bd ww[dl fw[fb zd[gl
子路率爾而對曰	zi[lh lu[zw uk[wu er[dx er[ek dv[yc yt[wh
子路宿於石門	zi[lh lu[zw su[gr yu[eu ui[ek mf[du
子路問	zi[lh lu[zw wf[mk
子路問成人	zi[lh lu[zw wf[mk ig[wv rf[pd
子路問君子	zi[lh lu[zw wf[mk jy[xk zi[lh
子路問事君	zi[lh lu[zw wf[mk ui[hk jy[xk
子路問曰	zi[lh lu[zw wf[mk yt[wh
子路問政	zi[lh lu[zw wf[mk vg[hw
子路無宿諾	zi[lh lu[zw wu[ee su[gr no[yc
子路行以告	zi[lh lu[zw xk[rh yi[sr gc[nk
子路曰	zi[lh lu[zw yt[wh
子路慍見曰	zi[lh lu[zw yy[xo jm[ke yt[wh
子路終身誦之	zi[lh lu[zw vs[sw uf[pu ss[ys vi[dv
子禽問於子貢曰	zi[lh qb[rw wf[mk yu[eu zi[lh gs[gb yt[wh
子如不言	zi[lh ru[nk bu[eu yj[we
子入太廟	zi[lh ru[pd td[dd mn[gy
子生三年	zi[lh ug[pf sj[hh nm[rn
子適衛	zi[lh ui[qz ww[eh
子食於有喪者之側	zi[lh ui[rl yu[eu yz[uo sh[ty ve[to vi[dv ce[rb
子帥以正	zi[lh uk[uj yi[sr vg[hv
子所雅言	zi[lh so[pj ya[yv yj[we
子慟矣	zi[lh ts[xe yi[su
子退朝	zi[lh tv[gz ic[uo
子謂伯魚曰	zi[lh ww[yt bo[rb yu[dt yt[wh
子為父隱	zi[lh ww[dl fu[bi yb[ed
子為恭也	zi[lh ww[dl gs[gx ye[vu
子未可以去乎	zi[lh ww[ha ke[dk yi[sr qu[ts hu[pb
子謂冉有曰	zi[lh ww[yt rj[kt yz[uo yt[wh
子謂韶	zi[lh ww[yt uc[ld
子為誰	zi[lh ww[dl uv[yv
子謂衛公子荊	zi[lh ww[yt ww[eh gs[bs zi[lh jk[cd
子謂顏淵曰	zi[lh ww[yt yj[ly yr[dp yt[wh
子畏於匡	zi[lh ww[th yu[eu kl[kw
子為政	zi[lh ww[dl vg[hw
子謂仲弓曰	zi[lh ww[yt vs[rv gs[kv yt[wh
子謂子夏曰	zi[lh ww[yt zi[lh xx[ew yt[wh
子溫而厲	zi[lh wf[do er[ek li[iw
子問公叔文子於公明賈曰	zi[lh wf[mk gs[bs uu[uy wf[wi zi[lh yu[eu gs[bs mk[oo jx[xb yt[wh
子問之	zi[lh wf[mk vi[dv
子聞之	zi[lh wf[me vi[dv
子聞之曰	zi[lh wf[me vi[dv yt[wh
子奚不為政	zi[lh xi[ay bu[eu ww[dl vg[hw
子夏為莒父宰	zi[lh xx[ew ww[dl ju[ck fu[bi zd[gl
子夏問孝	zi[lh xx[ew wf[mk xn[tz
子夏問曰	zi[lh xx[ew wf[mk yt[wh
子夏聞之	zi[lh xx[ew wf[me vi[dv
子夏曰	zi[lh xx[ew yt[wh
子夏云何	zi[lh xx[ew yy[es he[rk
子夏之門人問交於子張	zi[lh xx[ew vi[dv mf[du rf[pd wf[mk jn[li yu[eu zi[lh vh[gi
子夏之門人小子	zi[lh xx[ew vi[dv mf[du rf[pd xn[ub zi[lh
子行三軍	zi[lh xk[rh sj[hh jy[gi
自行束脩以上	zi[pm xk[rh uu[hk xq[ru yi[sr uh[bh
子言衛靈公之無道也	zi[lh yj[we ww[eh lk[xh gs[bs vi[dv wu[ee dc[bz ye[vu
子也	zi[lh ye[vu
緇衣	zi[sv yi[wy
子以四教	zi[lh yi[sr si[we jn[tw
子亦有異聞乎	zi[lh yi[wy yz[uo yi[kc wf[me hu[pb
子游對曰	zi[lh yz[df dv[yc yt[wh
子游為武城宰	zi[lh yz[df ww[dl wu[hv ig[tw zd[gl
子游問孝	zi[lh yz[df wf[mk xn[tz
子游曰	zi[lh yz[df yt[wh
自牖執其手	zi[pm yz[ph vi[fj qi[cb uz[su
子游子夏	zi[lh yz[df zi[lh xx[ew
子欲居九夷	zi[lh yu[bd ju[ug jq[pv yi[hg
子語魯大師樂	zi[lh yu[yw lu[yo da[hr ui[uh le[px
子與人歌而善	zi[lh yu[hv rf[pd ge[kd er[ek uj[yk
子欲善而民善矣	zi[lh yu[bd uj[yk er[ek mb[kv uj[yk yi[su
子於是日哭	zi[lh yu[eu ui[op ri[wh ku[kq
子欲往	zi[lh yu[bd wh[rd
子曰	zi[lh yt[wh
子云	zi[lh yy[es
子在	zi[lh zd[ut
子在川上曰	zi[lh zd[ut ir[pu uh[bh yt[wh
子在齊	zi[lh zd[ut qi[wp
子張第十九	zi[lh vh[gi di[vg ui[hu jq[pv
子張對曰	zi[lh vh[gi dv[yc yt[wh
子張書諸紳	zi[lh vh[gi uu[vv vu[yt uf[so
子張問	zi[lh vh[gi wf[mk
子張問崇德辨惑	zi[lh vh[gi wf[mk is[ug de[ru bm[ld ho[gx
子張問明	zi[lh vh[gi wf[mk mk[oo
子張問仁於孔子	zi[lh vh[gi wf[mk rf[re yu[eu ks[zv zi[lh
子張問善人之道	zi[lh vh[gi wf[mk uj[yk rf[pd vi[dv dc[bz
子張問行	zi[lh vh[gi wf[mk xk[rh
子張問於孔子曰	zi[lh vh[gi wf[mk yu[eu ks[zv zi[lh yt[wh
子張問曰	zi[lh vh[gi wf[mk yt[wh
子張問政	zi[lh vh[gi wf[mk vg[hw
子張學幹祿	zi[lh vh[gi xt[xz gj[hu lu[ux
子張曰	zi[lh vh[gi yt[wh
子之居喪	zi[lh vi[dv ju[ug sh[ty
子之所慎	zi[lh vi[dv so[pj uf[xu
子之往也	zi[lh vi[dv wh[rd ye[vu
子之武城	zi[lh vi[dv wu[hv ig[tw
子之燕居	zi[lh vi[dv yj[nk ju[ug
子之迂也	zi[lh vi[dv yu[ez ye[vu
自諸侯出	zi[pm vu[yt hz[rv iu[ck
宗廟會同	zs[ge mn[gy hv[re ts[kh
宗廟之事	zs[ge mn[gy vi[dv ui[hk
宗也	zs[ge ye[vu
宗族稱孝焉	zs[ge zu[fr ig[hd xn[tz yj[hh
足兵	zu[kv bk[qb
俎豆之事	zu[rq dz[hk vi[dv ui[hk
足躩	zu[kv jt[[
足躩如也	zu[kv jt[[ ru[nk ye[vu
足食	zu[kv ui[rl
足蹜如有循	zu[kv su[[ ru[nk yz[uo xy[rp
足則吾能徵之矣	zu[kv ze[bd wu[wk ng[sb vg[rh vi[dv yi[su
鑽燧改火	zr[jb sv[hb gd[kw ho[dp
鑽之彌堅	zr[jb vi[dv mi[gd jm[ut
罪在朕躬	zv[sf zd[ut vf[ob gs[ug
尊其瞻視	zy[bc qi[cb vj[md ui[uj
尊五美	zy[bc wu[hu mw[bw
左右手	zo[ug yz[uk uz[su
作者七人矣	zo[rv ve[to qi[hv rf[pd yi[su
