安期生	an[gn qi[qo ug[pf
八卦	ba[pd gx[tb
八節齋	ba[pd jp[ce vd[we
八石	ba[pd ui[ek
八仙宮	ba[pd xm[ru gs[gk
白石生	bd[po ui[ek ug[pf
白玉蟾	bd[po yu[wd ij[id
白雲觀	bd[po yy[es gr[yj
白雲霽	bd[po yy[es ji[yw
白晝飛昇	bd[po vz[uo fw[vp ug[pc
百字碑	bd[eo zi[gz bw[eb
鮑靚	bc[yb ll[fj
苞凝元神	bc[cb nk[db yr[ee uf[uo
抱朴子	bc[fb pu[ab zi[lh
保生大帝	bc[rk ug[pf da[hr di[lj
寶文統錄	bc[gw wf[wi ts[sw lu[xu
北斗真君	bw[ub dz[du vf[uj jy[xk
北天師道	bw[ub tm[hd ui[uh dc[bz
北嶽大帝	bw[ub yt[qu da[hr di[lj
碧洞宗	bi[we ds[dk zs[ge
辟穀	bi[ul gu[bk
碧霞元君	bi[we xx[yk yr[ee jy[xk
畢元帥	bi[bu yr[ee uk[uj
裨灶	bi[yb zc[ht
丙辰	bk[hk if[ie
丙丁龜鑑	bk[hk dk[hu gv[do jm[uj
炳靈公	bk[hh lk[xh gs[bs
丙申	bk[hk uf[ou
丙午	bk[hk wu[ru
丙戌	bk[hk xu[wh
兵要望江南	bk[qb yc[xn wh[ww jl[dg nj[uk
丙寅	bk[hk yb[gh
丙子	bk[hk zi[lh
帛和	bo[bj he[hk
帛家道	bo[bj jx[gu dc[bz
步罡踏斗	bu[vu gh[sh ta[zu dz[du
卜林	bu[ud lb[aa
布氣	bu[uj qi[rh
卜筮書	bu[ud ui[vg uu[vv
步熊	bu[vu xs[sd
卜珝	bu[ud xu[[
卜葬書	bu[ud zh[ch uu[vv
蔡元定	cd[cx yr[ee dk[gp
曹國舅	cc[ho go[ww jq[jt
曹文逸	cc[ho wf[wi yi[dz
曾慥	cg[bo zc[[
奼女	ia[ng nv[vp
柴通玄	id[va ts[sz xr[wy
產藥	ij[lp yc[cs
闡真	ij[mb vf[uj
長春觀	ih[ph iy[so gr[yj
長春子磻溪集	ih[ph iy[so zi[lh bo[[ xi[da ji[va
萇弘	ih[ci hs[gs
昌容	ih[oo rs[xr
朝板	ic[uo bj[ap
朝天宮	ic[uo tm[hd gs[gk
陳崇政	if[eq is[ug vg[hw
陳景元	if[eq jk[ow yr[ee
陳可復	if[eq ke[dk fu[ro
陳楠	if[eq nj[au
陳清覺	if[eq qk[df jt[xj
陳摶	if[eq tr[fe
陳先生內丹訣	if[eq xm[ne ug[pf nw[kr dj[kw jt[yv
陳訓	if[eq xy[yi
陳攖寧	if[eq yk[fb nk[gd
陳致虛	if[eq vi[hw xu[hy
晨鐘暮鼓	if[oi vs[jv mu[co gu[uu
承負	ig[lu fu[db
成公興	ig[wv gs[bs xk[xb
城隍神	ig[tw hl[eb uf[uo
乘蹻	ig[qb jn[[
承天效法後土皇地祗	ig[lu tm[hd xn[lw fa[dt hz[ry tu[uh hl[bw di[ty vi[uu
成玄英	ig[wv xr[wy yk[ck
赤城山	ii[ty ig[tw uj[uk
赤松子	ii[ty ss[ab zi[lh
重樓	is[ph lz[am
衝氣以為和	is[dv qi[rh yi[sr ww[dl he[hk
沖虛真經	is[dv xu[hy vf[uj jk[ss
重陽宮	is[ph yh[eo gs[gk
重陽宮碑林	is[ph yh[eo gs[gk bw[eb lb[aa
重陽立教十五論	is[ph yh[eo li[lh jn[tw ui[hu wu[hu ly[yr
重陽全真集	is[ph yh[eo qr[rw vf[uj ji[va
重陽真人	is[ph yh[eo vf[uj rf[pd
抽鉛添汞	iz[fy qm[jj tm[dt gs[gu
抽添	iz[fy tm[dt
出家傳度儀	iu[ck jx[gu ir[re du[gn yi[rd
初入道儀	iu[yd ru[pd dc[bz yi[rd
初真十戒	iu[yd vf[uj ui[hu jp[gc
楚芝蘭	iu[ap vi[cv lj[bs
廚主	iu[id vu[dw
淳于智	iy[dw yu[eu vi[uo
從此三氣各生	cs[rr ci[vb sj[hh qi[rh ge[wk ug[pf
攢簇陰陽五行	cr[fn cu[vf yb[eo yh[eo wu[hu xk[rh
崔府君	cv[uv fu[gr jy[xk
催官篇	cv[ru gr[gu pm[vh
翠虛篇	cv[xw xu[hy pm[vh
存神	cy[uz uf[uo
存神固氣論	cy[uz uf[uo gu[wg qi[rh ly[yr
存思	cy[uz si[tx
大赤天	da[hr ii[ty tm[hd
大丹直指	da[hr dj[kw vi[uj vi[fb
大滌洞天記	da[hr di[dw ds[dk tm[hd ji[yk
大洞玉經	da[hr ds[dk yu[wd jk[ss
大金玄都寶藏	da[hr jb[rw xr[wy du[te bc[gw ch[cw
大羅生玄元始三氣	da[hr lo[sx ug[pf xr[wy yr[ee ui[ns sj[hh qi[rh
大羅天	da[hr lo[sx tm[hd
大宋天宮寶藏	da[hr ss[ga tm[hd gs[gk bc[gw zh[cw
大同	da[hr ts[kh
大衍之數	da[hr yj[rd vi[dv uu[mw
大藥	da[hr yc[cs
大周天	da[hr vz[kt tm[hd
大足道教石刻	da[hr zu[kv dc[bz jn[tw ui[ek ke[wd
戴洋	dd[tt yh[dy
丹鼎派	dj[kw dk[mv pd[dp
丹房奧論	dj[kw fh[hf ao[pd ly[yr
丹房鑑源	dj[kw fh[hf jm[uj yr[di
丹房須知	dj[kw fh[hf xu[py vi[uk
丹功	dj[kw gs[gl
丹井	dj[kw jk[ep
丹客	dj[kw ke[gw
丹書墨篆	dj[kw uu[vv mo[ht vr[vv
丹田	dj[kw tm[wu
丹頭	dj[kw tz[dd
丹藥	dj[kw yc[cs
道德經	dc[bz de[ru jk[ss
道德天尊	dc[bz de[ru tm[hd zy[bc
道典論	dc[bz dm[kb ly[yr
道法會元	dc[bz fa[dt hv[re yr[ee
道法心傳	dc[bz fa[dt xb[dv ir[re
道法自然	dc[bz fa[dt zi[pm rj[xd
道服	dc[bz fu[oe
道貫真源	dc[bz gr[mb vf[uj yr[di
道化	dc[bz hx[rq
道教靈驗記	dc[bz jn[tw lk[xh yj[mr ji[yk
道教義樞	dc[bz jn[tw yi[di uu[ak
道門語要	dc[bz mf[du yu[yw yc[xn
道生天地	dc[bz ug[pf tm[hd di[ty
道術	dc[bz uu[ad
道樞	dc[bz uu[ak
導引	dc[kc yb[gu
導引圖	dc[kc yb[gu tu[ww
道藏	dc[bz zh[cw
道藏經目錄	dc[bz zh[cw jk[ss mu[we lu[xu
道藏目錄詳註	dc[bz zh[cw mu[we lu[xu xl[yy vu[dd
道藏闕經目錄	dc[bz zh[cw qt[mn jk[ss mu[we lu[xu
德雲觀	de[ru yy[es gr[yj
鄧元帥	dg[ye yr[ee uk[uj
登真隱訣	dg[dd vf[uj yb[ed jt[yv
地法天	di[ty fa[dt tm[hd
地風升	di[ty fg[ji ug[pc
地火明夷	di[ty ho[dp mk[oo yi[hg
地雷復	di[ty lw[yt fu[ro
地理大全	di[ty li[wo da[hr qr[rw
地理總括	di[ty li[wo zs[bx ko[fq
地水師	di[ty uv[uu ui[uh
地天泰	di[ty tm[hd td[su
地仙	di[ty xm[ru
地澤臨	di[ty ze[dy lb[uv
點化	dm[bd hx[rq
殿主	dm[uj vu[dw
丁丑	dk[hu iz[vu
定觀	dk[gp gr[yj
丁亥	dk[hu hd[wp
丁令威	dk[hu lk[rd ww[wh
鼎爐	dk[mv lu[hh
丁卯	dk[hu mc[pe
丁少微	dk[hu uc[xp ww[ru
丁巳	dk[hu si[kv
丁未	dk[hu ww[ha
丁酉	dk[hu yz[xh
東郭延年	ds[qx go[we yj[pj nm[rn
東華帝君	ds[qx hx[ru di[lj jy[xk
東華派	ds[qx hx[ru pd[dp
洞靈真經	ds[dk lk[xh vf[uj jk[ss
洞天福地	ds[dk tm[hd fu[uh di[ty
東王公	ds[qx wh[su gs[bs
洞仙傳	ds[dk xm[ru ir[re
洞霄宮	ds[dk xn[yx gs[gk
洞玄本行經	ds[dk xr[wy bf[ah hh[rh jk[ss
東嶽大帝	ds[qx yt[qu da[hr di[lj
洞真大洞真經	ds[dk vf[uj da[hr ds[dk vf[uj jk[ss
東周璽印卦畫	ds[qx vz[kt xi[dw yb[pe gx[tb hx[ht
竇圌山	dz[xu ir[[ uj[uk
竇圌山飛天藏	dz[xu ir[[ uj[uk fw[vp tm[hd ch[cw
鬥姆元君	dz[du mu[nm yr[ee jy[xk
杜不愆	du[at bu[eu qm[rx
杜光庭	du[at gl[xe tk[gq
度人經	du[gn rf[pd jk[ss
杜子恭	du[at zi[lh gs[gx
段翳	dr[pj yi[kx
兌為澤	dv[bk ww[dl ze[dy
敦煌道教佚經	dy[ww hl[hb dc[bz jn[tw yi[rp jk[ss
遁甲符應經	dy[pz jx[ou fu[vr yk[gx jk[ss
遁甲演義	dy[pz jx[ou yj[dg yi[di
二八兩弦	er[hh ba[pd ll[hk xm[gw
二郎神	er[hh lh[le uf[uo
二日禹余天上清境	er[hh ri[wh yu[pk yu[re tm[hd uh[bh qk[df jk[tl
二十八宿	er[hh ui[hu ba[pd xq[gr
二十四治	er[hh ui[hu si[we vi[ds
二徐真君	er[hh xu[rr vf[uj jy[xk
爾朱洞	er[dx vu[ph ds[dk
發病書	fa[vy bk[bh uu[vv
發微論	fa[vy ww[ru ly[yr
法主公	fa[dt vu[dw gs[bs
範豺	fj[cd id[pc
範長生	fj[cd ih[ph ug[pf
返樸歸真	fj[pz pu[ab gv[ux vf[uj
範圍數	fj[cd ww[ww uu[mw
樊英	fj[ad yk[ck
方術	fh[dw uu[ad
方仙道	fh[dw xm[ru dc[bz
飛昇	fw[vp ug[pc
費孝先	fw[fb xn[tz xm[ne
費直	fw[fb vi[uj
風地觀	fg[ji di[ty gr[yj
豐都大帝	fg[su du[te da[hr di[lj
風雷益	fg[ji lw[yt yi[bm
封爐	fg[tc lu[hh
風山漸	fg[ji uj[uk jm[di
風水渙	fg[ji uv[uu hr[dd
風天小畜	fg[ji tm[hd xn[ub iu[wt
奉仙觀	fg[sf xm[ru gr[yj
風澤中孚	fg[ji ze[dy vs[ku fu[az
傅金銓	fu[rf jb[rw qr[jr
符籙	fu[vr lu[vx
符籙派	fu[vr lu[vx pd[dp
服氣精義論	fu[oe qi[rh jk[mf yi[di ly[yr
阜陽漢簡周易	fu[pu yh[eo hj[dy jm[vm vz[kt yi[ob
甘始	gj[nh ui[ns
甘水仙源錄	gj[nh uv[uu xm[ru yr[di lu[xu
高功	gc[wk gs[gl
高獲	gc[wk ho[cq
葛洪	ge[co hs[dg
葛玄	ge[co xr[wy
葛由	ge[co yz[ou
閣皁山	ge[mw zc[bq uj[uk
閣皁宗	ge[mw zc[bq zs[ge
艮為山	gf[xv ww[dl uj[uk
庚辰	gg[gx if[ie
庚申	gg[gx uf[ou
庚午	gg[gx wu[ru
庚戌	gg[gx xu[wh
庚寅	gg[gx yb[gh
庚子	gg[gx zi[lh
公沙穆	gs[bs ua[dx mu[hb
公孫卿	gs[bs sy[zx qk[pg
勾陳南極大帝	gz[bs if[eq nj[uk ji[aj da[hr di[lj
勾陳上宮天皇大帝	gz[bs if[eq uh[bh gs[gk tm[hd hl[bw da[hr di[lj
勾漏洞	gz[bs lz[du ds[dk
姑布子卿	gu[ng bu[uj zi[lh qk[pg
顧歡	gu[iy hr[yd
穀神	gu[bk uf[uo
古微書	gu[uk ww[ru uu[vv
古文龍虎上經	gu[uk wf[wi ls[yp hu[hj uh[bh jk[ss
管公明卜要訣	gr[vg gs[bs mk[oo bu[ud yc[xn jt[yv
管歸真	gr[vg gv[ux vf[uj
關聖帝君	gr[bt ug[yt di[lj jy[xk
關尹	gr[bt yb[xp
關尹子	gr[bt yb[xp zi[lh
廣成子	gl[di ig[wv zi[lh
廣成子解	gl[di ig[wv zi[lh jp[dd
廣澤尊王	gl[di ze[dy zy[bc wh[su
癸丑	gv[dt iz[vu
鬼谷先生	gv[be gu[bk xm[ne ug[pf
癸亥	gv[dt hd[wp
癸卯	gv[dt mc[pe
鬼容區	gv[be rs[xr qu[ki
貴柔	gv[vb rz[ya
龜蛇二將	gv[do ue[ig er[hh jl[dx
癸巳	gv[dt si[kv
癸未	gv[dt ww[ha
鬼仙	gv[be xm[ru
癸酉	gv[dt yz[xh
果老星宗	go[oa lc[tb xk[op zs[ge
郭休	go[we xq[ra
亥牝	hd[wp pb[nb
撼龍經	hj[fw ls[yp jk[ss
漢天師世家	hj[dy tm[hd ui[uh ui[nv jx[gu
韓顯符	hj[uw xm[oy fu[vr
韓湘子	hj[uw xl[da zi[lh
漢鍾離	hj[dy vs[jv li[wk
郝大通	hc[te da[hr ts[sz
郝孟節	hc[te mg[zm jp[ce
河車	he[dk ie[qu
河車初動	he[dk ie[qu iu[yd ds[el
和合四象	he[hk he[rh si[we xl[dk
何九師	he[rk jq[pv ui[uh
賀蘭棲真	he[lb lj[bs qi[ax vf[uj
鶴鳴山	he[gn mk[kn uj[uk
河上公	he[dk uh[bh gs[bs
何仙姑	he[rk xm[ru gu[ng
鴻寶枕中書	hs[dn bc[gw vf[ag vs[ku uu[vv
鴻鈞道人	hs[dn jy[jb dc[bz rf[pd
鴻濛	hs[dn mg[dc
洪崖先生	hs[dg ya[ui xm[ne ug[pf
后土	hz[pk tu[uh
喉息	hz[kr xi[zx
護法四元帥	hu[fh fa[dt si[we yr[ee uk[uj
胡孚琛	hu[go fu[az if[wg
狐剛子	hu[qp gh[kd zi[lh
壺公	hu[uy gs[bs
呼子先	hu[kp zi[lh xm[ne
華光大帝	hx[ru gl[xe da[hr di[lj
華山派	hx[ru uj[uk pd[dp
淮南鴻寶萬畢	hk[dv nj[uk hs[dn bc[gw wj[hv bi[bu
淮南子	hk[dv nj[uk zi[lh
還丹覆命篇	hr[bz dj[kw fu[ro mk[rh pm[vh
還原篇	hr[bz yr[ib pm[vh
黃白朮	hl[gy bd[po uu[ad
黃大仙	hl[gy da[hr xm[ru
黃帝長柳占夢	hl[gy di[lj ih[ph lq[ap vj[bk mg[ax
黃帝九鼎神丹經訣	hl[gy di[lj jq[pv dk[mv uf[uo dj[kw jk[ss jt[yv
皇帝陰符經	hl[bw di[lj yb[eo fu[vr jk[ss
黃帝陰符經疏	hl[gy di[lj yb[eo fu[vr jk[ss uu[pw
皇甫玉	hl[bw fu[uo yu[wd
皇極經世書	hl[bw ji[aj jk[ss ui[nv uu[vv
黃老道	hl[gy lc[tb dc[bz
黃籙齋	hl[gy lu[vx vd[we
黃石公	hl[gy ui[ek gs[bs
黃守中	hl[gy uz[gc vs[ku
黃庭遁甲緣身經	hl[gy tk[gq dy[pz jx[ou yr[sv uf[pu jk[ss
黃庭經	hl[gy tk[gq jk[ss
黃庭內景經	hl[gy tk[gq nw[kr jk[ow jk[ss
黃萬戶	hl[gy wj[hv hu[du
黃芽	hl[gy ya[cy
黃元吉	hl[gy yr[ee ji[uk
混洞太無元	hy[do ds[dk td[dd wu[ee yr[ee
混俗和光	hy[do su[rb he[hk gl[xe
混俗頤生錄	hy[do su[rb yi[ky ug[pf lu[xu
混元聖紀	hy[do yr[ee ug[yt ji[sk
火地晉	ho[dp di[ty jb[ho
火記	ho[dp ji[yk
火居	ho[dp ju[ug
火雷噬磕	ho[dp lw[yt ui[kv ke[et
火山旅	ho[dp uj[uk lv[fr
火水未濟	ho[dp uv[uu ww[ha ji[dw
火天大有	ho[dp tm[hd da[hr yz[uo
火澤睽	ho[dp ze[dy kv[md
火珠林	ho[dp vu[wp lb[aa
活子時	ho[dq zi[lh ui[oc
己丑	ji[kv iz[vu
濟度齋	ji[dw du[gn vd[we
己亥	ji[kv hd[wp
己卯	ji[kv mc[pe
紀夢要覽	ji[sk mg[ax yc[xn lj[uj
己巳	ji[kv si[kv
寄胎母氏	ji[gd td[os mu[vv ui[pq
己未	ji[kv ww[ha
濟一子道書	ji[dw yi[hh zi[lh dc[bz uu[vv
己酉	ji[kv yz[xh
甲辰	jx[ou if[ie
夾脊	jx[hb ji[uo
甲申	jx[ou uf[ou
甲午	jx[ou wu[ru
甲戌	jx[ou xu[wh
甲寅	jx[ou yb[gh
甲子	jx[ou zi[lh
間丘方遠	jm[mo qq[jh fh[dw yr[ez
劍仙	jm[rd xm[ru
姜撫	jl[bn fu[fe
絳宮	jl[sw gs[gk
蔣子文	jl[cd zi[lh wf[wi
交梨火棗	jn[li li[ha ho[dp zc[cd
交泰	jn[li td[su
焦延壽	jn[vd yj[pj uz[fc
結化含秀	jp[su hx[rq hj[rk xq[hn
節食齋	jp[ce ui[rl vd[we
介象	jp[rp xl[dk
金丹大要	jb[rw dj[kw da[hr yc[xn
金丹要訣	jb[rw dj[kw yc[xn jt[yv
金鼎	jb[rw dk[mv
金蓮正宗記	jb[rw lm[ci vg[hv zs[ge ji[yk
金梁鳳	jb[rw ll[da fg[jy
金籙齋	jb[rw lu[vx vd[we
金山派	jb[rw uj[uk pd[dp
禁神	jb[ae uf[uo
金鎖流珠引	jb[rw so[jx lq[dw vu[wp yb[gu
金液還丹	jb[rw ye[dw hr[bz dj[kw
金映流真	jb[rw yk[ok lq[dw vf[uj
京房易飛候	jk[wk fh[hf yi[ob fw[vp hz[ru
京房易妖佔	jk[wk fh[hf yi[ob yc[np vj[bk
京房易傳	jk[wk fh[hf yi[ob vr[re
淨明道	jk[dd mk[oo dc[bz
經師	jk[ss ui[uh
經主	jk[ss vu[dw
九鼎丹法	jq[pv dk[mv dj[kw fa[dt
九宮	jq[pv gs[gk
九宮真人	jq[pv gs[gk vf[uj rf[pd
九還	jq[pv hd[bz
九慶之紫煙	jq[pv qk[gd vi[dv zi[vy yj[hw
九聖	jq[pv ug[yt
九食法	jq[pv ui[rl fa[dt
九守	jq[pv uz[gc
九天九地	jq[pv tm[hd jq[pv di[ty
九天玄妙課	jq[pv tm[hd xr[wy mn[nx ke[yo
九天玄女	jq[pv tm[hd xr[wy nv[vp
九天應元雷聲普化天尊	jq[pv tm[hd yk[gx yr[ee lw[yt ug[um pu[bo hx[rq tm[hd zy[bc
九仙	jq[pv xm[ru
九霄萬福宮	jq[pv xn[yx wj[hv fu[uh gs[gk
九星穴法	jq[pv xk[op xt[gb fa[dt
九真	jq[pv vf[uj
九轉金丹	jq[pv vr[ie jb[rw dj[kw
軍佔雜事	jy[gi vj[bk za[ja ui[hk
開元道藏	kd[hc yr[ee dc[bz zh[cw
開漳聖王	kd[hc vh[dl ug[yt wh[su
坎離	kj[td li[wk
坎離顛倒	kj[td li[wk dm[uy dc[rh
坎離交媾	kj[td li[wk jn[li gz[ng
坎為水	kj[td ww[dl uv[uu
坎中起火	kj[td vs[ku qi[zk ho[dp
亢倉子	kh[wj ch[re zi[lh
寇謙之	kz[ge qm[yb vi[dv
匡裕	kl[kw yu[yb
魁星	kv[gd xk[op
坤為地	ky[to ww[dl di[ty
來和	ld[hm he[hk
蘭採和	lj[bs cd[aa he[hk
老聃	lc[tb dj[ek
老君臺陳摶手書	lc[tb jy[xk td[sk if[eq tr[fe uz[su uu[vv
老君五戒	lc[tb jy[xk wu[hu jp[gc
老君音誦誡經	lc[tb jy[xk yb[lo ss[ys jp[yg jk[ss
嶗山太清宮	lc[uc uj[uk td[dd qk[df gs[gk
老子成玄英疏	lc[tb zi[lh ig[wv xr[wy yk[ck uu[pw
老子化胡經	lc[tb zi[lh hx[rq hu[go jk[ss
老子李榮注	lc[tb zi[lh li[az rs[ca vu[dd
老子想爾注	lc[tb zi[lh xl[ax er[dx vu[dd
樂育堂語錄	le[px yu[wo th[xt yu[yw lu[xu
雷地豫	lw[yt di[ty yu[yd
雷風恆	lw[yt fg[ji hg[xh
雷火豐	lw[yt ho[dp fg[su
雷山小過	lw[yt uj[uk xn[ub go[cz
雷水解	lw[yt uv[uu jp[dd
雷思齊	lw[yt si[tx qi[wp
雷天大壯	lw[yt tm[hd da[hr vl[du
雷澤歸妹	lw[yt ze[dy gv[ux mw[nh
冷壽光	lg[dr uz[fc gl[xe
李炳通	li[az bk[hh ts[sz
歷代神仙通鑑	li[il dd[rq uf[uo xm[ru ts[sz jm[uj
李道純	li[az dc[bz iy[st
李道謙	li[az dc[bz qm[yb
李含光	li[az hj[rk gl[xe
李漢軍	li[az hj[dy jy[gi
李涵虛	li[az hj[dl xu[hy
李合	li[az he[rh
李弘	li[az hs[gs
李家道	li[az jx[gu dc[bz
李筌	li[az qr[vr
李榮	li[az rs[ca
驪山老母	li[mh uj[uk lc[tb mu[vv
李少翁	li[az uc[xp wg[bx
歷世真仙體道通鑑	li[il ui[nv vf[uj xm[ru ti[ra dc[bz ts[sz jm[uj
李鐵柺	li[az tp[jp gk[fk
離為火	li[wk ww[dl ho[dp
李虛中	li[az xu[hy vs[ku
李虛中命書	li[az xu[hy vs[ku mk[rh uu[vv
李志常	li[az vi[ux ih[xk
煉丹	lm[hq dj[kw
煉己築基	lm[hq ji[kv vu[vg ji[qt
煉精化氣	lm[hq jk[mf hx[rq qi[rh
煉精化炁	lm[hq jk[mf hx[rq qi[[
煉氣	lm[hq qi[rh
煉氣化神	lm[hq qi[rh hx[rq uf[uo
煉炁化神	lm[hq qi[[ hx[rq uf[uo
煉神返虛	lm[hq uf[uo fj[pz xu[hy
煉神還虛	lm[hq uf[uo hd[bz xu[hy
簾幃	lm[xj ww[jw
煉形	lm[hq xk[kp
煉虛合道	lm[hq xu[hy he[rh dc[bz
煉藥	lm[hq yc[cs
梁丘賀	ll[da qq[jh he[lb
寮房	ln[gd fh[hf
廖扶	ln[gx fu[fe
列仙傳	lp[hd xm[ru vr[re
列子	lp[hd zi[lh
林靈素	lb[aa lk[xh su[fy
臨孝恭	lb[uv xn[tz gs[gx
靈寶略記	lk[xh bc[gw lt[tw ji[yk
靈寶派	lk[xh bc[gw pd[dp
靈寶十二齋	lk[xh bc[gw ui[hu er[hh vd[we
靈寶天尊	lk[xh bc[gw tm[hd zy[bc
靈寶玉鑑	lk[xh bc[gw yu[wd jm[uj
靈城精義	lk[xh ig[tw jk[mf yi[di
靈飛經	lk[xh fw[vp jk[ss
靈棋經	lk[xh qi[aq jk[ss
劉焯	lq[wd ic[hb
劉處玄	lq[wd iu[wb xr[wy
劉道合	lq[wd dc[bz he[rh
劉德仁	lq[wd de[ru rf[re
六丁六甲	lq[wb dk[hu lq[wb jx[ou
劉惇	lq[wd dy[xw
劉根	lq[wd gf[ag
劉海蟾	lq[wd hd[dr ij[id
柳華陽	lq[ap hx[ru yh[eo
六極	lq[wb ji[aj
六甲	lq[wb jx[ou
劉靈助	lq[wd lk[xh vu[ql
劉名瑞	lq[wd mk[xk rv[wu
六氣	lq[wb qi[rh
六壬畢法賦	lq[wb rf[qh bi[bu fa[dt fu[bw
六壬大全	lq[wb rf[qh da[hr qr[rw
六壬大佔	lq[wb rf[qh da[hr vj[bk
六壬心鏡要	lq[wb rf[qh xb[dv jk[jl yc[xn
六十元辰	lq[wb ui[hu yr[ee if[ie
劉玄靖	lq[wd xr[wy jk[lf
劉一明	lq[wd yi[hh mk[oo
劉永年	lq[wd ys[dv nm[rn
劉玉	lq[wd yu[wd
劉淵然	lq[wd yr[dp rj[xd
劉元帥	lq[wd yr[ee uk[uj
劉知常	lq[wd vi[uk ih[xk
柳莊相法	lq[ap vl[gt xl[am fa[dt
龍虎還丹訣	ls[yp hu[hj hr[bz dj[kw jt[yv
龍虎交媾	ls[yp hu[hj jn[li gz[ng
龍虎山	ls[yp hu[hj uj[uk
龍虎山上清宮	ls[yp hu[hj uj[uk uh[bh qk[df gs[gk
龍虎相會	ls[yp hu[hj xl[am hv[re
龍門派	ls[yp mf[du pd[dp
龍瑞宮記	ls[yp rv[wu gs[gk ji[yk
龍山石窟	ls[yp uj[uk ui[ek ku[xu
龍章鳳文	ls[yp vh[lo fg[jy wf[wi
樓觀	lz[am gr[yj
樓觀派	lz[am gr[yj pd[dp
婁近坦	lz[mn jb[jz tj[to
陸靜修	lu[ef jk[fd xq[ru
轤轆關	lu[ib lu[ig gr[bt
盧生	lu[bu ug[pf
陸西星	lu[ef xi[hk xk[op
陸修靜	lu[ef xq[ru jk[fd
欒大	lr[ya da[hr
羅浮山	lo[sx fu[da uj[uk
羅思遠	lo[sx si[tx yr[ez
洛陽上清宮	lo[dw yh[eo uh[bh qk[df gs[gk
呂才	lv[kk cd[hu
呂純陽	lv[kk iy[st yh[eo
呂洞賓	lv[kk ds[dk bb[gq
呂嵒	lv[kk yj[[
呂祖百字碑	lv[kk zu[uq bd[eo zi[gz bw[eb
馬丹陽	ma[vv dj[kw yh[eo
麻姑	ma[ga gu[ng
馬韶	ma[vv uc[ld
麻衣道者	ma[ga yi[wy dc[bz ve[to
麻衣相法	ma[ga yi[wy xl[am fa[dt
馬鈺	ma[vv yu[jw
馬祖師	ma[vv zu[uq ui[uh
茅濛	mc[cy mg[dc
茅山宗	mc[cy uj[uk zs[ge
茅盈	mc[cy yk[nm
夢林元解	mg[ax lb[aa yr[ee jp[dd
孟氏易	mg[zm ui[pq yi[ob
夢佔逸旨	mg[ax vj[bk yi[dz vi[bo
祕記	mi[hx ji[yk
苗守信	mn[ct uz[gc xb[ry
苗訓	mn[ct xy[yi
閔小艮	mb[mw xn[ub gf[xv
明崇儼	mk[oo is[ug yj[rh
命受仙氣	mk[rh uz[ay xm[ru qi[rh
明真齋	mk[oo vf[uj vd[we
墨子五行記	mo[ht zi[lh wu[hu xk[rh ji[yk
沐浴	mu[da yu[db
南無派	na[uk mo[ee pd[dp
南鬥星君	nj[uk dz[du xk[op jy[xk
南華真經	nj[uk hx[ru vf[uj jk[ss
南極長生大帝	nj[uk ji[aj ih[ph ug[pf da[hr di[lj
南極仙翁	nj[uk ji[aj xm[ru wg[bx
南樵子	nj[uk qn[av zi[lh
南天師道	nj[uk tm[hd ui[uh dc[bz
南嶽大帝	nj[uk yt[qu da[hr di[lj
內丹	nw[kr dj[kw
內功圖說	nw[kr gs[gl tu[ww uo[yb
鳥情雜佔	nn[nh qk[xf za[ja vj[bk
寧封子	nk[gd fg[tc zi[lh
女丹法	nv[vp dj[kw fa[dt
女幾	nv[vp ji[pv
盤古真人	pj[vm gu[uk vf[uj rf[pd
潘師正	pj[dp ui[uh vg[hv
龐元帥	ph[gy yr[ee uk[uj
彭矯	pg[up jn[up
彭琚	pg[up ju[wu
彭耜	pg[up si[lu
彭曉	pg[up xn[oq
彭質	pg[up vi[pu
彭宗	pg[up zs[ge
披肝露膽經	pi[fp gj[og lu[yz dj[oo jk[ss
破迷正道歌	po[ep mi[mz vg[hv dc[bz ge[kd
七報	qi[hv bc[fe
岐伯	qi[uu bo[rb
氣海	qi[rh hd[dr
七門	qi[hv mf[du
奇門遁甲	qi[dk mf[du dy[pz jx[ou
奇門遁甲賦	qi[dk mf[du dy[pz jx[ou fu[bw
七魄	qi[hv po[bg
七破論	qi[hv po[ep ly[yr
其氣始青	qi[cb qi[rh ui[ns qk[fo
七傷	qi[hv uh[rr
七神	qi[hv uf[uo
七十二地煞	qi[hv ui[hu er[hh di[ty ua[dd
七十二福地	qi[hv ui[hu er[hh fu[uh di[ty
七星人命屬法	qi[hv xk[op rf[pd mk[rh uu[up fa[dt
炁穴	qi[[ xt[gb
七曜歷日	qi[hv yc[ox li[il ri[wh
七曜星官	qi[hv yc[ox xk[op gr[gu
鉛汞	qm[jj gs[gu
鈐訣	qm[jr jt[yv
乾坤會合	qm[ur ky[to hv[re he[rh
乾為天	qm[ur ww[dl tm[hd
籤易	qm[vr yi[ob
敲爻歌	qn[wb yc[ii ge[kd
琴心三疊	qb[wr xb[dv sj[hh dp[yq
青城山	qk[fo ig[tw uj[uk
青城山上清官	qk[fo ig[tw uj[uk uh[bh qk[df gr[gu
清靜經	qk[df jk[fd jk[ss
清靜派	qk[df jk[fd pd[dp
青囊奧語	qk[fo nh[hk ao[pd yu[yw
清水道	qk[df uv[uu dc[bz
清水祖師	qk[df uv[uu zu[uq ui[uh
清微丹訣	qk[df ww[ru dj[kw jt[yv
清微派	qk[df ww[ru pd[dp
清微天	qk[df ww[ru tm[hd
清微天玉清境	qk[df ww[ru tm[hd yu[wd qk[df jk[tl
青烏公	qk[fo wu[bv gs[bs
青烏子	qk[fo wu[bv zi[lh
青羊宮	qk[fo yh[bs gs[gk
青羊宮銅羊	qk[fo yh[bs gs[gk ts[jk yh[bs
青衣神	qk[fo yi[wy uf[uo
邱處機	qq[qe iu[wb ji[aj
丘處機	qq[jh iu[wb ji[aj
秋石	qq[hh ui[ek
全真道	qr[rw vf[uj dc[bz
全真道北七真派	qr[rw vf[uj dc[bz bw[ub qi[hv vf[uj pd[dp
泉州老君造像	qr[bu vz[dp lc[tb jy[xk zc[nz xl[rd
卻穀食氣篇	qt[te gu[bk ui[rl qi[rh pm[vh
壬辰	rf[qh if[ie
任督	rf[rq du[um
人法地	rf[pd fa[dt di[ty
人倫大統賦	rf[pd ly[rr da[hr ts[sw fu[bw
壬申	rf[qh uf[ou
任文公	rf[rq wf[wi gs[bs
壬午	rf[qh wu[ru
人仙	rf[pd xm[ru
壬戌	rf[qh xu[wh
壬寅	rf[qh yb[gh
壬子	rf[qh zi[lh
日魂月魄	ri[wh hy[eg yt[ke po[bg
日書	ri[wh uu[vv
容成公	rs[xr ig[wv gs[bs
容成陰道	rs[xr ig[wv yb[eo dc[bz
入靜	ru[pd jk[fd
入魔	ru[pd mo[gg
入藥鏡	ru[pd yc[cs jk[jl
薩真人	sa[ce vf[uj rf[pd
三寶	sj[hh bc[gw
三才	sj[hh cd[hu
三車	sj[hh ie[qu
三洞	sj[hh ds[dk
三洞法服科戒文	sj[hh ds[dk fa[dt fu[oe ke[hd jp[gc wf[wi
三洞瓊綱	sj[hh ds[dk qs[ww gh[sk
三洞群仙錄	sj[hh ds[dk qy[xy xm[ru lu[xu
三洞神符記	sj[hh ds[dk uf[uo fu[vr ji[yk
三洞珠囊	sj[hh ds[dk vu[wp nh[hk
三都	sj[hh du[te
三關	sj[hh gr[bt
三官大帝	sj[hh gr[gu da[hr di[lj
三花聚頂	sj[hh hx[cr ju[ep dk[dy
三華聚頂	sj[hh hx[ru ju[ep dk[dy
三皇經	sj[hh hl[bw jk[ss
三皇文	sj[hh hl[bw wf[wi
三魂	sj[hh hy[eg
三家相見	sj[hh jx[gu xl[am jm[ke
三教搜神大全	sj[hh jn[tw sz[fj uf[uo da[hr qr[rw
三界	sj[hh jp[tr
三茅真君	sj[hh mc[cy vf[uj jy[xk
三命指迷賦	sj[hh mk[rh vi[fb mi[mz fu[bw
三品戒	sj[hh pb[kk jp[gc
三清	sj[hh qk[df
三清境	sj[hh qk[df jk[tl
三神山	sj[hh uf[uo uj[uk
三尸	sj[hh ui[kp
三十二天	sj[hh ui[hu er[hh tm[hd
三十六洞天	sj[hh ui[hu lq[wb ds[dk tm[hd
三十六天	sj[hh ui[hu lq[wb tm[hd
三十六天將	sj[hh ui[hu lq[wb tm[hd jl[dx
三尸神	sj[hh ui[kp uf[uo
三素雲	sj[hh su[fy yy[es
三天易髓	sj[hh tm[hd yi[ob sv[gu
散仙	sj[gw xm[ru
三元八會	sj[hh yr[ee ba[pd hv[re
三元延壽參贊書	sj[hh yr[ee yj[pj uz[fc cj[sd zj[nb uu[vv
三元齋	sj[hh yr[ee vd[we
三曰大赤天太清境	sj[hh yt[wh da[hr ii[ty tm[hd td[dd qk[df jk[tl
桑道茂	sh[ya dc[bz mc[cw
莎衣道人	ua[cd yi[wy dc[bz rf[pd
山地剝	uj[uk di[ty bo[xd
閃電娘娘	uj[mr dm[ov nl[nl nl[nl
山法全書	uj[uk fa[dt qr[rw uu[vv
山風蠱	uj[uk fg[ji gu[im
山火賁	uj[uk ho[dp bf[ub
山雷頤	uj[uk lw[yt yi[ky
山水蒙	uj[uk uv[uu mg[ch
山天大畜	uj[uk tm[hd da[hr iu[wt
山澤損	uj[uk ze[dy sy[fk
上清大洞真經	uh[bh qk[df da[hr ds[dk vf[uj jk[ss
上清靈寶大法	uh[bh qk[df lk[xh bc[gw da[hr fa[dt
上清派	uh[bh qk[df pd[dp
上清握中訣	uh[bh qk[df wo[fu vs[ku jt[yv
上天梯	uh[bh tm[hd ti[ab
上下經卦變歌	uh[bh xx[hb jk[ss gx[tb bm[yy ge[kd
尚獻甫	uh[xk xm[uq fu[uo
少翁	uc[xp wg[bx
邵元節	uc[de yr[ee jp[ce
設供齋	ue[yj gs[rg vd[we
攝生三要	ue[fe ug[pf sj[hh yc[xn
攝生要義	ue[fe ug[pf yc[xn yi[di
攝生纂錄	ue[fe ug[pf zr[vm lu[xu
攝養枕中方	ue[fe yh[yp vf[ag vs[ku fh[dw
神機相字法	uf[uo ji[aj xl[am zi[gz fa[dt
神闕	uf[uo qt[mn
神水華池	uf[uo uv[uu hx[ru ii[dy
沈羲	uf[dg xi[bh
神仙傳	uf[uo xm[ru ir[re
神仙丹訣	uf[uo xm[ru dj[kw jt[yv
神仙可學論	uf[uo xm[ru ke[dk xt[xz ly[yr
神相金較剪	uf[uo xl[am jb[rw jn[il jm[bd
神相鐵關刀	uf[uo xl[am tp[jp gr[bt dc[vp
神霄派	uf[uo xn[yx pd[dp
瀋陽太清宮	uf[dg yh[eo td[dd qk[df gs[gk
神遊	uf[uo yz[df
生道合一	ug[pf dc[bz he[rh yi[hh
聖胎	ug[yt td[os
十八頭	ui[hu ba[pd tz[dd
十大洞天	ui[hu da[hr ds[dk tm[hd
十二重樓	ui[hu er[hh is[ph lz[am
十二類	ui[hu er[hh lw[md
十方叢林	ui[hu fh[dw cs[rh lb[aa
釋泓	ui[py hs[dg
十戒	ui[hu jp[gc
始氣所成	ui[ns qi[rh so[pj ig[wv
十七願念	ui[hu qi[hv yr[ix nm[rx
石泉	ui[ek qr[bu
十三虛無	ui[hu sj[hh xu[hy wu[ee
識神	ui[yk uf[uo
石泰	ui[ek td[su
史序	ui[ki xu[gy
石藥爾雅	ui[ek yc[cs er[dx ya[yv
十洲三島	ui[hu vz[dd sj[hh dc[nu
守庚申	uz[gc gg[gx uf[ou
守三一	uz[gc sj[hh yi[hh
叔服	uu[uy fu[oe
黍米	uu[hr mi[ba
水地比	uv[uu di[ty bi[bb
水風井	uv[uu fg[ji jk[ep
水雷屯	uv[uu lw[yt ty[hk
水山蹇	uv[uu uj[uk jm[gz
水天需	uv[uu tm[hd xu[ye
水澤節	uv[uu ze[dy jp[ce
順逆	uy[iy ni[nz
四輔	si[we fu[if
司馬承禎	si[vh ma[vv ig[lu vf[ub
司馬季主	si[vh ma[vv ji[hz vu[dw
思微定志	si[tx ww[ru dk[gp vi[ux
四御	si[we yu[rw
四值功曹	si[we vi[ru gs[gl cc[ho
宋德方	ss[ga de[ru fh[dw
宋倫	ss[ga ly[rr
宋毋忌	ss[ga wu[vv ji[kx
蘇澄隱	su[cl ig[dd yb[ed
素女經	su[fy nv[vp jk[ss
蘇元朗	su[cl yr[ee lh[lo
隨山派	sv[eu uj[uk pd[dp
孫不二	sy[zx bu[eu er[hh
孫恩	sy[zx en[wx
孫汝忠	sy[zx ru[dn vs[vx
孫守榮	sy[zx uz[gc rs[ca
孫思邈	sy[zx si[tx mn[pz
孫玄清	sy[zx xr[wy qk[df
孫智諒	sy[zx vi[uo ll[yw
索紞	so[uy dj[[
太白金星	td[dd bd[po jb[rw xk[op
臺產	td[sk ij[lp
太和山	td[dd he[hk uj[uk
太極	td[dd ji[aj
太平道	td[dd pk[hb dc[bz
太平洞經	td[dd pk[hb ds[dk jk[ss
太清導引養生經	td[dd qk[df dc[kc yb[gu yh[yp ug[pf jk[ss
太清宮	td[dd qk[df gs[gk
太清神鑑	td[dd qk[df uf[uo jm[uj
太清石壁記	td[dd qk[df ui[ek bi[ut ji[yk
太清調氣經	td[dd qk[df tn[yk qi[rh jk[ss
太清中黃真經	td[dd qk[df vs[ku hl[gy vf[uj jk[ss
太上洞淵神咒經	td[dd uh[bh ds[dk yr[dp uf[uo vz[kj jk[ss
太上感應篇	td[dd uh[bh gj[wx yk[gx pm[vh
太上九要心印妙經	td[dd uh[bh jq[pv yc[xn xb[dv yb[pe mn[nx jk[ss
太上老君	td[dd uh[bh lc[tb jy[xk
太上三洞神咒	td[dd uh[bh sj[hh ds[dk uf[uo vz[kj
太上養生胎息氣經	td[dd uh[bh yh[yp ug[pf td[os xi[zx qi[rh jk[ss
太素脈法	td[dd su[fy md[od fa[dt
太霄琅書經	td[dd xn[yx lh[wl uu[vv jk[ss
太一	td[dd yi[hh
太乙	td[dd yi[vv
太一道	td[dd yi[hh dc[bz
太乙含真	td[dd yi[vv hj[rk vf[uj
太乙金鏡式經	td[dd yi[vv jb[rw jk[jl ui[qg jk[ss
譚處端	tj[yx iu[wb dr[lu
譚峭	tj[yx qn[ux
唐舉	th[gx ju[xf
唐檀	th[gx tj[aw
唐葉真人傳	th[gx ye[ku vf[uj rf[pd ir[re
陶宏景	tc[eb hs[gu jk[ow
陶弘景	tc[eb hs[gs jk[ow
陶仲文	tc[eb vs[rv wf[wi
天道助弱	tm[hd dc[bz vu[ql ro[gg
天地否	tm[hd di[ty fz[bk
天法道	tm[hd fa[dt dc[bz
天風垢	tm[hd fg[ji gz[tp
天宮道藏	tm[hd gs[gk dc[bz zh[cw
天火同人	tm[hd ho[dp ts[kh rf[pd
天老神光經	tm[hd lc[tb uf[uo gl[xe jk[ss
天雷無妄	tm[hd lw[yt wu[ee wh[wn
天門三將軍	tm[hd mf[du sj[hh jl[dx jy[gi
天目山	tm[hd mu[we uj[uk
天山遁	tm[hd uj[uk dy[pz
天師道	tm[hd ui[uh dc[bz
天師洞	tm[hd ui[uh ds[dk
天書	tm[hd uu[vv
天水訟	tm[hd uv[uu ss[yb
天仙金丹心法	tm[hd xm[ru jb[rw dj[kw xb[dv fa[dt
天仙直理真論	tm[hd xm[ru vi[uj li[wo vf[uj ly[yr
天心	tm[hd xb[dv
天心派	tm[hd xb[dv pd[dp
天乙真慶宮	tm[hd yi[vv vf[uj qk[gd gs[gk
天隱子	tm[hd yb[ed zi[lh
天隱子養生書	tm[hd yb[ed zi[lh yh[yp ug[pf uu[vv
天澤履	tm[hd ze[dy lv[ur
天尊	tm[hd zy[bc
調藥	tn[yk yc[cs
鐵柺李	tp[jp gk[fk li[az
桐柏宮	ts[ak bd[ab gs[gk
銅牌記	ts[jk pd[pb ji[yk
通玄	ts[sz xr[wy
通玄真經	ts[sz xr[wy vf[uj jk[ss
仝寅	ts[rg yb[gh
吐納	tu[kt na[sk
圖緯	tu[ww ww[sw
推九宮行年法	tv[fv jq[pv gs[gk xk[rh nm[rn fa[dt
橐龠	to[he yt[rh
橐籥	to[he yt[[
外丹	wd[xb dj[kw
萬曆續道藏	wj[hv li[il xu[su dc[bz ch[cw
萬壽道藏	wj[hv uz[fc dc[bz zh[cw
萬物負陰而抱陽	wj[hv wu[nb fu[db yb[eo er[ek bc[fb yh[eo
王常月	wh[su ih[xk yt[ke
王重陽	wh[su is[ph yh[eo
王處訥	wh[su iu[wb ne[yk
王處一	wh[su iu[wb yi[hh
汪東亭	wh[dw ds[qx tk[wd
王浮	wh[su fu[da
王嘉	wh[su jx[ul
王老志	wh[su lc[tb vi[ux
王靈官	wh[su lk[xh gr[gu
王喬	wh[su qn[pp
王屋山	wh[su wu[uh uj[uk
王希夷	wh[su xi[iu yi[hg
王玄甫	wh[su xr[wy fu[uo
王玄覽	wh[su xr[wy lj[uj
王遠知	wh[su yr[ez vi[uk
王仔昔	wh[su zd[rz xi[go
王早	wh[su zc[ou
王喆	wh[su ve[uu
王志謹	wh[su vi[ux jb[yn
魏伯陽	ww[hg bo[rb yh[eo
魏漢津	ww[hg hj[dy jb[dy
魏華存	ww[hg hx[ru cy[uz
尾閭關	ww[um lv[mk gr[bt
文昌帝君	wf[wi ih[oo di[lj jy[xk
溫瓊元帥	wf[do qs[ww yr[ee uk[uj
文史真經	wf[wi ui[ki vf[uj jk[ss
翁葆光	wg[bx bc[cr gl[xe
戊辰	wu[iv if[ie
伍沖虛	wu[rw is[dv xu[hy
武當道	wu[hv dh[xx dc[bz
武當山	wu[hv dh[xx uj[uk
五道	wu[hu dc[bz
悟道	wu[xw dc[bz
五道將軍	wu[hu dc[bz jl[dx jy[gi
五斗米道	wu[hu dz[du mi[ba dc[bz
五遁	wu[hu dy[pz
五方六國	wu[hu fh[dw lq[wb go[ww
五漸門	wu[hu jm[di mf[du
吳筠	wu[kt jy[vt
吳猛	wu[kt mg[qz
五難	wu[hu nj[yv
五氣朝元	wu[hu qi[rh ic[uo yr[ee
無上元君	wu[ee uh[bh yr[ee jy[xk
戊申	wu[iv uf[ou
五屍	wu[hu ui[kp
烏兔	wu[bv tu[dk
戊午	wu[iv wu[ru
五行	wu[hu xk[rh
五行顛倒	wu[hu xk[rh dm[uy dc[rh
伍胥	wu[rw xu[po
戊戌	wu[iv xu[wh
五芽	wu[hu ya[cy
巫炎	wu[gr yj[hh
戊寅	wu[iv yb[gh
五嶽大帝	wu[hu yt[qu da[hr di[lj
五嶽真形圖	wu[hu yt[qu vf[uj xk[kp tu[ww
武則天投龍簡	wu[hv ze[bd tm[hd tz[fj ls[yp jm[vm
悟真篇	wu[xw vf[uj pm[vh
五主	wu[hu vu[dw
戊子	wu[iv zi[lh
五祖派	wu[hu zu[uq pd[dp
郄儉	xi[ie jm[rr
西門君惠	xi[hk mf[du jy[xk hv[hx
西山群仙會真記	xi[hk uj[uk qy[xy xm[ru hv[re vf[uj ji[yk
西升經	xi[hk ug[pc jk[ss
析疑指迷論	xi[aj yi[bs vi[fb mi[mz ly[yr
西嶽大帝	xi[hk yt[qu da[hr di[lj
仙經	xm[ru jk[ss
仙品	xm[ru pb[kk
先天真一之氣	xm[ne tm[hd vf[uj yi[hh vi[dv qi[rh
仙苑編珠	xm[ru yr[cx bm[sh vu[wp
襄楷	xl[wk kd[ab
相理衡真	xl[am li[wo hg[rd vf[uj
象言	xl[dk yj[we
相掌金龜卦	xl[am vh[xf jb[rw gv[do gx[tb
相冢書	xl[am vs[gu uu[vv
蕭抱珍	xn[cx bc[fb vf[wr
蕭吉	xn[cx ji[uk
蕭廷芝	xn[cx tk[qj vi[cv
小周天	xn[ub vz[kt tm[hd
協紀辨方書	xp[ul ji[sk bm[ld fh[dw uu[vv
謝夷吾	xp[yu yi[hg wu[wk
辛丑	xb[lu iz[vu
心傳述證錄	xb[dv ir[re uu[az vg[yh lu[xu
新訂指明心法	xb[lj dk[yd vi[fb mk[oo xb[dv fa[dt
辛亥	xb[lu hd[wp
辛卯	xb[lu mc[pe
辛巳	xb[lu si[kv
辛未	xb[lu ww[ha
心息相依	xb[dv xi[zx xl[am yi[ry
心相篇	xb[dv xl[am pm[vh
心印經	xb[dv yb[pe jk[ss
辛酉	xb[lu yz[xh
辛元帥	xb[lu yr[ee uk[uj
心齋	xb[dv vd[we
性光	xk[xp gl[xe
星曆考原	xk[op li[il kc[tk yr[ib
幸靈	xk[tb lk[xh
性命圭旨	xk[xp mk[rh gv[tt vi[bo
性命雙修	xk[xp mk[rh ul[yy xq[ru
星命溯源	xk[op mk[rh su[dn yr[di
星平會海	xk[op pk[hb hv[re hd[dr
行氣	xk[rh qi[rh
形神俱妙	xk[kp uf[uo ju[rj mn[nx
星學大成	xk[op xt[xz da[hr ig[wv
修真精義雜論	xq[ru vf[uj jk[mf yi[di za[ja ly[yr
修真十書	xq[ru vf[uj ui[hu uu[vv
修真圖	xq[ru vf[uj tu[ww
許負	xu[yw fu[db
徐福	xu[rr fu[uh
虛極靜篤	xu[hy ji[aj jk[fd du[vm
許邁	xu[yw md[wz
許曼	xu[yw mj[os
徐頌堯	xu[rr ss[by yc[qh
續仙傳	xu[su xm[ru ir[re
許遜	xu[yw xy[zz
許楊	xu[yw yh[av
許元長	xu[yw yr[ee ih[ph
徐子平	xu[rr zi[lh pk[hb
許遵	xu[yw zy[bz
玄德	xr[wy de[ru
玄都寶藏	xr[wy du[te bc[gw ch[cw
玄綱論	xr[wy gh[sk ly[yr
玄關	xr[wy gr[bt
玄關一竅	xr[wy gr[bt yi[hh qn[xg
玄覽	xr[wy lj[uj
玄妙觀	xr[wy mn[nx gr[yj
玄女經	xr[wy nv[vp jk[ss
玄品錄	xr[wy pb[kk lu[xu
玄牝之門	xr[wy pb[nb vi[dv mf[du
玄氣所成	xr[wy qi[rh so[pj ig[wv
玄竅	xr[wy qn[xg
玄壇趙元帥	xr[wy tj[te vc[zi yr[ee uk[uj
玄之又玄	xr[wy vi[dv yz[vd xr[wy
玄珠	xr[wy vu[wp
玄珠錄	xr[wy vu[wp lu[xu
薛道光	xt[cp dc[bz gl[xe
巽為風	xy[kg ww[dl fg[ji
薰蒸	xy[cp vg[cl
鴉經	ya[yn jk[ss
顏惡頭	yj[ly ee[hx tz[dd
衍極	yj[rd ji[aj
嚴君平	yj[hy jy[xk pk[hb
演禽通纂	yj[dg qb[rw ts[sz zr[vm
嚴善思	yj[hy uj[yk si[tx
嚴遵	yj[hy zy[bz
陽符	yh[eo fu[vr
陽光三現	yh[eo gl[xe sj[hh xm[wj
陽火	yh[eo ho[dp
陽平治	yh[eo pk[hb vi[ds
陽神	yh[eo uf[uo
養生方導引法	yh[yp ug[pf fh[dw dc[kc yb[gu fa[dt
養生要集	yh[yp ug[pf yc[xn ji[va
養生月覽	yh[yp ug[pf yt[ke lj[uj
楊羲	yh[av xi[bh
楊希孟	yh[av xi[iu mg[zm
羊欣	yh[bs xb[jd
養性延命錄	yh[yp xk[xp yj[pj mk[rh lu[xu
羊愔	yh[bs yb[[
養鄞鄂	yh[yp yb[ne ee[ke
楊由	yh[av yz[ou
楊元慎	yh[av yr[ee uf[xu
窈冥	yc[xy mk[go
藥王山石刻	yc[cs wh[su uj[uk ui[ek ke[wd
窈窈冥冥	yc[xy yc[xy mk[go mk[go
業報經	ye[ub bc[fe jk[ss
耶律乙不哥	ye[ee lv[ry yi[vv bu[eu ge[kk
乙丑	yi[vv iz[vu
乙弗弘禮	yi[vv fu[gp hs[gs li[uv
義高	yi[di gc[wk
繹宮	yi[sy gs[gk
乙亥	yi[vv hd[wp
易漢學	yi[ob hj[dy xt[xz
易林	yi[ob lb[aa
疑龍經	yi[bs ls[yp jk[ss
乙卯	yi[vv mc[pe
易數鉤隱圖	yi[ob uu[mw gz[jb yb[ed tu[ww
乙巳	yi[vv si[kv
易圖通變	yi[ob tu[ww ts[sz bm[yy
易外別傳	yi[ob wd[xb bp[kd vr[re
乙未	yi[vv ww[ha
易心瑩	yi[ob xb[dv yk[cw
一陽來複	yi[hh yh[eo ld[hm fu[ro
一陽生	yi[hh yh[eo ug[pf
乙酉	yi[vv yz[xh
一曰清微天玉清境	yi[hh yt[wh qk[df ww[ru tm[hd yu[wd qk[df jk[tl
陰長生	yb[eo ih[ph ug[pf
尹澄	yb[xp ig[dd
陰符	yb[eo fu[vr
陰符經	yb[eo fu[vr jk[ss
陰蹺	yb[eo qn[zq
殷紹	yb[pj uc[sd
陰神	yb[eo uf[uo
引書	yb[gu uu[vv
陰陽	yb[eo yh[eo
陰陽書	yb[eo yh[eo uu[vv
尹真人	yb[xp vf[uj rf[pd
尹志平	yb[xp vi[ux pk[hb
應化經	yk[gx hx[rq jk[ss
櫻寧	yk[ab nk[gd
應物	yk[gx wu[nb
盈虛	yk[nm xu[hy
墉城集仙錄	ys[tg ig[tw ji[va xm[ru lu[xu
永樂宮	ys[dv le[px gs[gk
酉陽雜俎	yz[xh yh[eo za[ja zu[rq
禹步	yu[pk bu[vu
玉晨之精氣	yu[wd if[oi vi[dv jk[mf qi[rh
玉池	yu[wd ii[dy
庾道集	yu[gj dc[bz ji[va
玉牒金書	yu[wd dp[pn jb[rw uu[vv
玉管照神局	yu[wd gr[vg vc[od uf[uo ju[uv
玉暉煥耀	yu[wd hv[og hr[hd yc[xx
于吉	yu[eu ji[uk
庾季才	yu[gj ji[hz cd[hu
於君道	yu[eu jy[xk dc[bz
鬱壘	yu[ue lw[st
俞靈璝	yu[rh lk[xh gv[[
玉隆萬壽宮	yu[wd ls[ew wj[hv uz[fc gs[gk
御女損益篇	yu[rw nv[vp sy[fk yi[bm pm[vh
玉女隱微	yu[wd nv[vp yb[ed ww[ru
玉清元始天尊	yu[wd qk[df yr[ee ui[ns tm[hd zy[bc
嵛山派	yu[ur uj[uk pd[dp
雨師	yu[hk ui[uh
遇仙派	yu[oz xm[ru pd[dp
俞琰	yu[rh yj[wh
禹余天	yu[pk yu[re tm[hd
玉照定真經	yu[wd vc[od dk[gp vf[uj jk[ss
玉枕關	yu[wd vf[ag gr[bt
元符宮	yr[ee fu[vr gs[gk
袁珙	yr[tk gs[wg
元關	yr[ee gr[bt
元和	yr[ee he[hk
元君	yr[ee jy[xk
袁客師	yr[tk ke[gw ui[uh
元牝	yr[ee pb[nb
元氣	yr[ee qi[rh
元氣所成	yr[ee qi[rh so[pj ig[wv
元神	yr[ee uf[uo
元始天尊	yr[ee ui[ns tm[hd zy[bc
原始天尊	yr[ib ui[ns tm[hd zy[bc
袁天綱	yr[tk tm[hd gh[sk
袁忠徹	yr[tk vs[vx ie[rq
月波洞中記	yt[ke bo[dp ds[dk vs[ku ji[yk
雲簋七籖	yy[es gv[vg qi[hv qm[[
雲笈七籤	yy[es ji[vj qi[hv qm[vr
雲蒸雨降	yy[es vg[cl yu[hk jl[ew
雲篆	yy[es vr[vv
雜齋法	za[ja vd[we fa[dt
葬法倒杖	zh[ch fa[dt dc[rh vh[ah
葬經	zh[ch jk[ss
葬書注	zh[ch uu[vv vu[dd
澤火革	ze[dy ho[dp ge[nk
澤山鹹	ze[dy uj[uk xm[wh
澤水困	ze[dy uv[uu ky[wa
澤天夬	ze[dy tm[hd gk[vd
齋法	vd[we fa[dt
宅經	vd[gp jk[ss
占卜書	vj[bk bu[ud uu[vv
占夢經	vj[bk mg[ax jk[ss
占夢書	vj[bk mg[ax uu[vv
佔命書	vj[bk mk[rh uu[vv
張寶	vh[gi bc[gw
張伯端	vh[gi bo[rb dr[lu
張道陵	vh[gi dc[bz lk[et
張恩溥	vh[gi en[wx pu[df
張果老	vh[gi go[oa lc[tb
張國祥	vh[gi go[ww xl[uy
張衡	vh[gi hg[rd
張角	vh[gi jn[do
張憬藏	vh[gi jk[xo ch[cw
張君房	vh[gi jy[xk fh[hf
張梁	vh[gi ll[da
張陵	vh[gi lk[et
張留孫	vh[gi lq[pt sy[zx
張魯	vh[gi lu[yo
張起隆	vh[gi qi[zk ls[ew
張清夜	vh[gi qk[df ye[wr
張仁晸	vh[gi rf[re vg[[
張三丰	vh[gi sj[hh fg[su
張盛	vh[gi ug[wm
張嗣成	vh[gi si[kv ig[wv
張無夢	vh[gi wu[ee mg[ax
張行成	vh[gi xk[rh ig[wv
張修	vh[gi xq[ru
張與材	vh[gi yu[hv cd[ac
張宇初	vh[gi yu[ge iu[yd
張與棣	vh[gi yu[hv di[ax
張正常	vh[gi vg[hv ih[xk
張正隨	vh[gi vg[hv sv[eu
張志和	vh[gi vi[ux he[hk
張紫陽	vh[gi zi[vy yh[eo
張宗演	vh[gi zs[ge yj[dg
趙避塵	vc[zi bi[uz if[xt
趙炳	vc[zi bk[hh
趙初暘	vc[zi iu[yd yh[ov
趙輔和	vc[zi fu[if he[hk
趙歸真	vc[zi gv[ux vf[uj
趙修己	vc[zi xq[ru ji[kv
趙直	vc[zi vi[uj
真常	vf[uj ih[xk
真大道	vf[uj da[hr dc[bz
真道升聖境	vf[uj dc[bz ug[pc ug[yt jk[tl
真誥	vf[uj gc[yn
真靈位業圖	vf[uj lk[xh ww[rl ye[ub tu[ww
真龍虎九仙經	vf[uj ls[yp hu[hj jq[pv xm[ru jk[ss
真氣	vf[uj qi[rh
真仙直指語錄	vf[uj xm[ru vi[uj vi[fb yu[yw lu[xu
真性	vf[uj xk[xp
真陽	vf[uj yh[eo
真一金丹訣	vf[uj yi[hh jb[rw dj[kw jt[yv
真陰	vf[uj yb[eo
真元妙道要略	vf[uj yr[ee mn[nx dc[bz yc[xn lt[tw
枕中方	vf[ag vs[ku fh[dw
枕中記	vf[ag vs[ku ji[yk
拯道齋	vg[fl dc[bz vd[we
正統道藏	vg[hv ts[sw dc[bz zh[cw
正一道	vg[hv yi[hh dc[bz
正一經	vg[hv yi[hh jk[ss
正一盟威道	vg[hv yi[hh mg[om ww[wh dc[bz
正一威儀經	vg[hv yi[hh ww[wh yi[rd jk[ss
鄭隱	vg[be yb[ed
正子時	vg[hv zi[lh ui[oc
止念	vi[uh nm[rx
智緣	vi[uo yr[sv
中丹田	vs[ku dj[kw tm[wu
中道	vs[ku dc[bz
中宮	vs[ku gs[gk
中和集	vs[ku he[hk ji[va
中黃直透	vs[ku hl[gy vi[uj tz[hz
鍾離權	vs[jv li[wk qr[ay
鍾呂傳道集	vs[jv lv[kk ir[re dc[bz ji[va
終南山	vs[sw nj[uk uj[uk
眾術類	vs[rr uu[ad lw[md
踵息	vs[zp xi[zx
重玄	vs[ph xr[wy
重玄學派	vs[ph xr[wy xt[xz pd[dp
中嶽大帝	vs[ku yt[qu da[hr di[lj
中嶽廟	vs[ku yt[qu mn[gy
周顛仙	vz[kt dm[uy xm[ru
周公卜法	vz[kt gs[bs bu[ud fa[dt
周公解夢書	vz[kt gs[bs jp[dd mg[ax uu[vv
肘後神經大全	vz[oc hz[pk uf[uo jk[ss da[hr qr[rw
周克明	vz[kt ke[ge mk[oo
周亮	vz[kt ll[wj
周易參同契	vz[kt yi[ob cj[sd ts[kh qi[fd
築基煉己	vu[vg ji[qt lm[hq ji[kv
朱建平	vu[ph jm[yj pk[hb
硃砂	vu[ph ua[ex
諸真內丹集要	vu[yt vf[uj nw[kr dj[kw ji[va yc[xn
諸真玄奧集成	vu[yt vf[uj xr[wy ao[pd ji[va ig[wv
莊子	vl[gt zi[lh
紫清真人	zi[vy qk[df vf[uj rf[pd
自然齋	zi[pm rj[xd vd[we
梓慎	zi[al uf[xu
子孫叢林	zi[lh sy[zx cs[rh lb[aa
子孫廟	zi[lh sy[zx mn[gy
紫團丹經	zi[vy tr[wc dj[kw jk[ss
紫微北極大帝	zi[vy ww[ru bw[ub ji[aj da[hr di[lj
紫微斗數	zi[vy ww[ru dz[du uu[mw
紫霄宮	zi[vy xn[yx gs[gk
走火	zz[tv ho[dp
遵生八箋	zy[bz ug[pf ba[pd jm[vj
左慈	zo[ug ci[bx
坐忘	zo[rr wh[wx
坐忘論	zo[rr wh[wx ly[yr
